CATACTTGTTTCAAGCTGCTTTAG -> ATACTTGTTTCAAGCTGCTTTAGC
AGCTGCTTTAGCCCCGGGGCTACG -> GCTGCTTTAGCCCCGGGGCTACGG
GCAACACCAACAGATGGGCCCCGG -> CAACACCAACAGATGGGCCCCGGC
TAAGAGCTGCCGTATACCTGCAAG -> AAGAGCTGCCGTATACCTGCAAGT
TTTCGACTGTTAGTCAAATGATGG -> TTCGACTGTTAGTCAAATGATGGA
TTGTGCCCTGTCTACCGGGCTACG -> TGTGCCCTGTCTACCGGGCTACGA
GGGTGCGAAACGACTGCGATCCGC -> GGTGCGAAACGACTGCGATCCGCA
GACAAATGAATCCCGGAGTCACCC -> ACAAATGAATCCCGGAGTCACCCC
ATGACATAGAGCATTGTCTTGTGC -> TGACATAGAGCATTGTCTTGTGCC
GAAGATTTCTATCACGGAGCCGGG -> AAGATTTCTATCACGGAGCCGGGC
CCACCCACAGGCAGTTGGGACTTC -> CACCCACAGGCAGTTGGGACTTCG
GCAGACGCGCTAGGATTTCAACGG -> CAGACGCGCTAGGATTTCAACGGC
CACCTGATGGTGCGGGCTGGGGTG -> ACCTGATGGTGCGGGCTGGGGTGC
CCGGGCGTTTCGACTGTTAGTCAA -> CGGGCGTTTCGACTGTTAGTCAAA
ACAATGTCAGCGCCGTCACCAATG -> CAATGTCAGCGCCGTCACCAATGC
TGGGCCCCGGCGGGGAGATGCTGC -> GGGCCCCGGCGGGGAGATGCTGCT
GCGTTCCTCAAAGTTGAGGGGAGT -> CGTTCCTCAAAGTTGAGGGGAGTA
ACAGAGAAGCCCACCTGATGGTGC -> CAGAGAAGCCCACCTGATGGTGCG
ATGTCAGCGCCGTCACCAATGCGT -> TGTCAGCGCCGTCACCAATGCGTG
GTCAAATGATGGATCCTATAGGAC -> TCAAATGATGGATCCTATAGGACA
ACGTGCTACATGGCATAAGAGCTG -> CGTGCTACATGGCATAAGAGCTGC
CAATTTTCCAGTTGGGAGTCGTAA -> AATTTTCCAGTTGGGAGTCGTAAC
CCTCACGAAAGACACGTTTCCGCT -> CTCACGAAAGACACGTTTCCGCTG
AACAATATCCCCAAATATGAGTGG -> ACAATATCCCCAAATATGAGTGGG
TGGACATAATGGTTTCGATAGCGG -> GGACATAATGGTTTCGATAGCGGC
ATCACGGAGCCGGGCGTTTCGACT -> TCACGGAGCCGGGCGTTTCGACTG
CTCCACAATCTATACAAGTAACAT -> TCCACAATCTATACAAGTAACATG
TTAAACCTTGTGTTGTCCGCTAAA -> TAAACCTTGTGTTGTCCGCTAAAC
ACGTGTAGTGCAGACGTGTCCTTA -> CGTGTAGTGCAGACGTGTCCTTAC
AACGACCGTGCGACTCGTGTGGCA -> ACGACCGTGCGACTCGTGTGGCAG
CCAACAATATCCCCAAATATGAGT -> CAACAATATCCCCAAATATGAGTG
TATTTCCCATATGCAGCGTTCGCG -> ATTTCCCATATGCAGCGTTCGCGA
AAACCTTGTGTTGTCCGCTAAACT -> AACCTTGTGTTGTCCGCTAAACTT
GTTTCGATAGCGGCTCTACGACGT -> TTTCGATAGCGGCTCTACGACGTG
GCTCTACGACGTGCTACATGGCAT -> CTCTACGACGTGCTACATGGCATA
ATAGGACACGCGGAGCCTCTGGCT -> TAGGACACGCGGAGCCTCTGGCTA
GTGGTACATGGACCCTTTTCGAAG -> TGGTACATGGACCCTTTTCGAAGG
CCGGGGCCCGGTTGTAATATGATC -> CGGGGCCCGGTTGTAATATGATCA
GCCAAGGCGTTTTAACTCATGACA -> CCAAGGCGTTTTAACTCATGACAA
CCCACAAGTTGCTTTTATCTAGGA -> CCACAAGTTGCTTTTATCTAGGAC
TTATCTAGGACCCCTAGCCTGCGC -> TATCTAGGACCCCTAGCCTGCGCC
TAAAGTAGGGAGCACGTCCTCCCA -> AAAGTAGGGAGCACGTCCTCCCAG
AGCATTCAAAGGGGACGCGCCACT -> GCATTCAAAGGGGACGCGCCACTT
GCAGTTGGGACTTCGTAGACGGAG -> CAGTTGGGACTTCGTAGACGGAGC
AGTGGGCTTGCGCTTATCGGGATT -> GTGGGCTTGCGCTTATCGGGATTA
AGTTCAGGAACGAGGACGGTAGTA -> GTTCAGGAACGAGGACGGTAGTAG
GACTGCGATCCGCACTCATTAGGT -> ACTGCGATCCGCACTCATTAGGTT
CTCTACGACGTGCTACATGGCATA -> TCTACGACGTGCTACATGGCATAA
TTTTATGGGAAGCAACATTCCATC -> TTTATGGGAAGCAACATTCCATCA
CCTCATTCTTGATCGATACGATTC -> CTCATTCTTGATCGATACGATTCG
AAATATGAGTGGGCTTGCGCTTAT -> AATATGAGTGGGCTTGCGCTTATC
ATCCCCAAATATGAGTGGGCTTGC -> TCCCCAAATATGAGTGGGCTTGCG
ACATTGCCTCATTCTTGATCGATA -> CATTGCCTCATTCTTGATCGATAC
CACGTCCTCCCAGTCTACTGTGGT -> ACGTCCTCCCAGTCTACTGTGGTA
TACTTTTTATGGGAAGCAACATTC -> ACTTTTTATGGGAAGCAACATTCC
TGTGGTACATGGACCCTTTTCGAA -> GTGGTACATGGACCCTTTTCGAAG
CTCCTAATCGCTACTTTTTATGGG -> TCCTAATCGCTACTTTTTATGGGA
TCAAAGTTGAGGGGAGTATCAGTC -> CAAAGTTGAGGGGAGTATCAGTCT
AATATCCCCAAATATGAGTGGGCT -> ATATCCCCAAATATGAGTGGGCTT
GGCAGACGCGCTAGGATTTCAACG -> GCAGACGCGCTAGGATTTCAACGG
GCAAAGACAGCCTGACCACACTCC -> CAAAGACAGCCTGACCACACTCCG
TTCCGGGGCCCGGTTGTAATATGA -> TCCGGGGCCCGGTTGTAATATGAT
GTGTAGTGCAGACGTGTCCTTACG -> TGTAGTGCAGACGTGTCCTTACGA
ATGCTTTCTCCACAATCTATACAA -> TGCTTTCTCCACAATCTATACAAG
GATCTTCAACGGAAGATTTCTATC -> ATCTTCAACGGAAGATTTCTATCA
GGGTTTCACTAGTTCCTTCCGGGG -> GGTTTCACTAGTTCCTTCCGGGGC
ATGGGTCACGTGTAGTGCAGACGT -> TGGGTCACGTGTAGTGCAGACGTG
CTGCGCCGGTATTTAAAAGAAGGC -> TGCGCCGGTATTTAAAAGAAGGCG
CCCTCTTCGCCATCAGCAGACCAT -> CCTCTTCGCCATCAGCAGACCATG
ATCCCGGAGTCACCCCTGCGACGG -> TCCCGGAGTCACCCCTGCGACGGC
CGATAGCGCAGTGGAGCAACACCA -> GATAGCGCAGTGGAGCAACACCAA
AGCTAACGGGACGCGCCGAACCCT -> GCTAACGGGACGCGCCGAACCCTC
CCCACCTGATGGTGCGGGCTGGGG -> CCACCTGATGGTGCGGGCTGGGGT
ATAAAAACTAGGTACACGGTTGTG -> TAAAAACTAGGTACACGGTTGTGC
TCGACCAGGAGAAAACCCCCCTAT -> CGACCAGGAGAAAACCCCCCTATC
ACGCGCTAGGATTTCAACGGCAAA -> CGCGCTAGGATTTCAACGGCAAAC
CACCCACAGGCAGTTGGGACTTCG -> ACCCACAGGCAGTTGGGACTTCGT
CCGGTATTTAAAAGAAGGCGGCTC -> CGGTATTTAAAAGAAGGCGGCTCC
ACTCATCTACCCACAGCTTCCTCC -> CTCATCTACCCACAGCTTCCTCCA
GGACTTCGTAGACGGAGCAGACAA -> GACTTCGTAGACGGAGCAGACAAA
CGTGCTACATGGCATAAGAGCTGC -> GTGCTACATGGCATAAGAGCTGCC
CTTGTGTTGTCCGCTAAACTTTGG -> TTGTGTTGTCCGCTAAACTTTGGG
TTTGCCACACCTCGGCAGTGATAT -> TTGCCACACCTCGGCAGTGATATG
AAGCCCACCTGATGGTGCGGGCTG -> AGCCCACCTGATGGTGCGGGCTGG
GTGCTACATGGCATAAGAGCTGCC -> TGCTACATGGCATAAGAGCTGCCG
TGCCCTGTCTACCGGGCTACGAGG -> GCCCTGTCTACCGGGCTACGAGGG
TCTCAATGCTTTATCATAAAAACT -> CTCAATGCTTTATCATAAAAACTA
GAGCCCCTCTTCGCCATCAGCAGA -> AGCCCCTCTTCGCCATCAGCAGAC
TTGCCTCATTCTTGATCGATACGA -> TGCCTCATTCTTGATCGATACGAT
CACCACCCTAACCAATGGTGGACA -> ACCACCCTAACCAATGGTGGACAT
AACACCAACAGATGGGCCCCGGCG -> ACACCAACAGATGGGCCCCGGCGG
GAAGACATTGCCTCATTCTTGATC -> AAGACATTGCCTCATTCTTGATCG
CGGTGAAACGCGAACCCTGGAGTC -> GGTGAAACGCGAACCCTGGAGTCG
TCATGGGCCGTCAATGAGGTATTT -> CATGGGCCGTCAATGAGGTATTTC
TAGCCATGCGCTCCTAATCGCTAC -> AGCCATGCGCTCCTAATCGCTACT
GTTGTCCCCTCCTTACTGCACATA -> TTGTCCCCTCCTTACTGCACATAA
GCATAAGAGCTGCCGTATACCTGC -> CATAAGAGCTGCCGTATACCTGCA
CCCTCCTTACTGCACATAACCTAC -> CCTCCTTACTGCACATAACCTACG
TTCGCGATGCAGCGGGATAATTTG -> TCGCGATGCAGCGGGATAATTTGG
CCTCTTGACTGTGGGGTTCTCAAT -> CTCTTGACTGTGGGGTTCTCAATG
TGGGCTTGCGCTTATCGGGATTAT -> GGGCTTGCGCTTATCGGGATTATG
AGACACGTTTCCGCTGTGGAAGAC -> GACACGTTTCCGCTGTGGAAGACA
CTGTTAGTCAAATGATGGATCCTA -> TGTTAGTCAAATGATGGATCCTAT
GGAACGAGGACGGTAGTAGCTAGA -> GAACGAGGACGGTAGTAGCTAGAC
GCATTGTCTTGTGCCCTGTCTACC -> CATTGTCTTGTGCCCTGTCTACCG
GAGTCACCCCTGCGACGGCGTCCT -> AGTCACCCCTGCGACGGCGTCCTT
GACCAGGAGAAAACCCCCCTATCT -> ACCAGGAGAAAACCCCCCTATCTC
ACTGCGATCCGCACTCATTAGGTT -> CTGCGATCCGCACTCATTAGGTTG
TGCGCCGATGCCCTAAAGTAGGGA -> GCGCCGATGCCCTAAAGTAGGGAG
TTTATCATAAAAACTAGGTACACG -> TTATCATAAAAACTAGGTACACGG
GTCGTAACACTAGAAATATGGTAT -> TCGTAACACTAGAAATATGGTATG
TGTGATGCCATTCTTTCAGCCCGT -> GTGATGCCATTCTTTCAGCCCGTT
CGGCGGGGAGATGCTGCTATTATT -> GGCGGGGAGATGCTGCTATTATTT
GCACTCATTAGGTTGGGAGTTCAG -> CACTCATTAGGTTGGGAGTTCAGG
AACACTAGAAATATGGTATGTCTG -> ACACTAGAAATATGGTATGTCTGA
GCCGGGCGTTTCGACTGTTAGTCA -> CCGGGCGTTTCGACTGTTAGTCAA
ACTTAGCTAACGGGACGCGCCGAA -> CTTAGCTAACGGGACGCGCCGAAC
CACCCTAACCAATGGTGGACATAA -> ACCCTAACCAATGGTGGACATAAT
AAGTTGAGGGGAGTATCAGTCTTC -> AGTTGAGGGGAGTATCAGTCTTCG
TATTTGGCAGACGCGCTAGGATTT -> ATTTGGCAGACGCGCTAGGATTTC
CCGGGCTACGAGGGATTTTAGATG -> CGGGCTACGAGGGATTTTAGATGC
CTTATAACGGCTGCCAAGGCGTTT -> TTATAACGGCTGCCAAGGCGTTTT
TATCCCCAAATATGAGTGGGCTTG -> ATCCCCAAATATGAGTGGGCTTGC
TCAGCCCGTTATTCCCAACAATAT -> CAGCCCGTTATTCCCAACAATATC
CCGCACTCATTAGGTTGGGAGTTC -> CGCACTCATTAGGTTGGGAGTTCA
CTCGGCAGTGATATGCTTTCTCCA -> TCGGCAGTGATATGCTTTCTCCAC
CTTCAACGGAAGATTTCTATCACG -> TTCAACGGAAGATTTCTATCACGG
TGGTGCGGGCTGGGGTGCGCCGAT -> GGTGCGGGCTGGGGTGCGCCGATG
TTCCATTTTCGCATTGCATGCATG -> TCCATTTTCGCATTGCATGCATGA
GGCAGTTGGGACTTCGTAGACGGA -> GCAGTTGGGACTTCGTAGACGGAG
ACGCGGTCACTCTAGTAAATACCT -> CGCGGTCACTCTAGTAAATACCTG
AGAGCTGCCGTATACCTGCAAGTC -> GAGCTGCCGTATACCTGCAAGTCC
ACACTAGAAATATGGTATGTCTGA -> CACTAGAAATATGGTATGTCTGAG
TCCTTCTTCATGGGCCGTCAATGA -> CCTTCTTCATGGGCCGTCAATGAG
CAGGAACGAGGACGGTAGTAGCTA -> AGGAACGAGGACGGTAGTAGCTAG
TCTAGCCATGCGCTCCTAATCGCT -> CTAGCCATGCGCTCCTAATCGCTA
ATTATGGGTCACGTGTAGTGCAGA -> TTATGGGTCACGTGTAGTGCAGAC
GACTCTAAAGTCTTATAACGGCTG -> ACTCTAAAGTCTTATAACGGCTGC
CAACACAGGATCCGGCTCGACCAG -> AACACAGGATCCGGCTCGACCAGG
ACGCCCTGCGAACACCCATACTTG -> CGCCCTGCGAACACCCATACTTGT
CAGTTTGGAATTATGAGGAGTGAT -> AGTTTGGAATTATGAGGAGTGATG
AGTTGGGACTTCGTAGACGGAGCA -> GTTGGGACTTCGTAGACGGAGCAG
ATCGATACGATTCGCGTTGTCCCC -> TCGATACGATTCGCGTTGTCCCCT
ACCTACGGTGAAACGCGAACCCTG -> CCTACGGTGAAACGCGAACCCTGG
TCTAATGACAGCTCATTAGCTGTT -> CTAATGACAGCTCATTAGCTGTTC
CCCGGAGTCACCCCTGCGACGGCG -> CCGGAGTCACCCCTGCGACGGCGT
ATGTCAATTTTCCAGTTGGGAGTC -> TGTCAATTTTCCAGTTGGGAGTCG
GACTTCGTAGACGGAGCAGACAAA -> ACTTCGTAGACGGAGCAGACAAAT
CCAGGAGAAAACCCCCCTATCTCG -> CAGGAGAAAACCCCCCTATCTCGT
GGCCTCTGAGAGCTGGATTGTGCC -> GCCTCTGAGAGCTGGATTGTGCCC
TATAGCATTCAAAGGGGACGCGCC -> ATAGCATTCAAAGGGGACGCGCCA
TGCCATTCTTTCAGCCCGTTATTC -> GCCATTCTTTCAGCCCGTTATTCC
AGGATTTCAACGGCAAACACAACG -> GGATTTCAACGGCAAACACAACGC
AAGGGGGATCTTCAACGGAAGATT -> AGGGGGATCTTCAACGGAAGATTT
CTAGAAATATGGTATGTCTGAGCA -> TAGAAATATGGTATGTCTGAGCAT
CAACGGCAAACACAACGCGGTCAC -> AACGGCAAACACAACGCGGTCACT
GTTATTCCCAACAATATCCCCAAA -> TTATTCCCAACAATATCCCCAAAT
CAGACAAATGAATCCCGGAGTCAC -> AGACAAATGAATCCCGGAGTCACC
TTCTGCGAATCAATTGGTTGGATG -> TCTGCGAATCAATTGGTTGGATGC
CCCCGGGACCTGCCGAGAGCGATC -> CCCGGGACCTGCCGAGAGCGATCT
AGACCATGTTATTTAAATGTATAC -> GACCATGTTATTTAAATGTATACT
CTGACCACACTCCGTACAGTTTGG -> TGACCACACTCCGTACAGTTTGGA
CTTCATGGGCCGTCAATGAGGTAT -> TTCATGGGCCGTCAATGAGGTATT
GATGCCATTCTTTCAGCCCGTTAT -> ATGCCATTCTTTCAGCCCGTTATT
CCTTCTTCATGGGCCGTCAATGAG -> CTTCTTCATGGGCCGTCAATGAGG
AAGGCGTTTTAACTCATGACAACA -> AGGCGTTTTAACTCATGACAACAC
GATGACATAGAGCATTGTCTTGTG -> ATGACATAGAGCATTGTCTTGTGC
CATGCGTTCCTCCTGTCACACTTA -> ATGCGTTCCTCCTGTCACACTTAC
ACACAATGTCAGCGCCGTCACCAA -> CACAATGTCAGCGCCGTCACCAAT
TCGCGTTGTCCCCTCCTTACTGCA -> CGCGTTGTCCCCTCCTTACTGCAC
TGCGCCGGTATTTAAAAGAAGGCG -> GCGCCGGTATTTAAAAGAAGGCGG
ATTTCCCATATGCAGCGTTCGCGA -> TTTCCCATATGCAGCGTTCGCGAT
CGCACTCATTAGGTTGGGAGTTCA -> GCACTCATTAGGTTGGGAGTTCAG
CATTCTTTCAGCCCGTTATTCCCA -> ATTCTTTCAGCCCGTTATTCCCAA
GCAAACACAACGCGGTCACTCTAG -> CAAACACAACGCGGTCACTCTAGT
CGTCCTCCCAGTCTACTGTGGTAC -> GTCCTCCCAGTCTACTGTGGTACA
ATCAGTCTTCGGAACCTCCACCCA -> TCAGTCTTCGGAACCTCCACCCAC
GAGCACGTCCTCCCAGTCTACTGT -> AGCACGTCCTCCCAGTCTACTGTG
ACAGGCAGTTGGGACTTCGTAGAC -> CAGGCAGTTGGGACTTCGTAGACG
GGAGCACGTCCTCCCAGTCTACTG -> GAGCACGTCCTCCCAGTCTACTGT
TGATTGGCAAGGGGTTTCACTAGT -> GATTGGCAAGGGGTTTCACTAGTT
GGCAAAGACAGCCTGACCACACTC -> GCAAAGACAGCCTGACCACACTCC
CTCTTCGCCATCAGCAGACCATGT -> TCTTCGCCATCAGCAGACCATGTT
GACGGGTCGCTCCCACGCTACGGA -> ACGGGTCGCTCCCACGCTACGGAT
CTCCCAGTCTACTGTGGTACATGG -> TCCCAGTCTACTGTGGTACATGGA
GCGCCGTCACCAATGCGTGTGATT -> CGCCGTCACCAATGCGTGTGATTG
GGTACATGGACCCTTTTCGAAGGG -> GTACATGGACCCTTTTCGAAGGGT
GGATCTTCAACGGAAGATTTCTAT -> GATCTTCAACGGAAGATTTCTATC
GCCTGACCACACTCCGTACAGTTT -> CCTGACCACACTCCGTACAGTTTG
GGGGTTCTCAATGCTTTATCATAA -> GGGTTCTCAATGCTTTATCATAAA
CGGGCTGGGGTGCGCCGATGCCCT -> GGGCTGGGGTGCGCCGATGCCCTA
CCTCCTTACTGCACATAACCTACG -> CTCCTTACTGCACATAACCTACGG
GAACCCTCTTGACTGTGGGGTTCT -> AACCCTCTTGACTGTGGGGTTCTC
ACAAGCATGCGTTCCTCCTGTCAC -> CAAGCATGCGTTCCTCCTGTCACA
GCCGAGAGCGATCTAGCCATGCGC -> CCGAGAGCGATCTAGCCATGCGCT
AACGAGGACGGTAGTAGCTAGACT -> ACGAGGACGGTAGTAGCTAGACTT
CCTCCCAGTCTACTGTGGTACATG -> CTCCCAGTCTACTGTGGTACATGG
CTAGGACCCCTAGCCTGCGCCGGT -> TAGGACCCCTAGCCTGCGCCGGTA
CCTCAAAGTTGAGGGGAGTATCAG -> CTCAAAGTTGAGGGGAGTATCAGT
AGACTTAGCTAACGGGACGCGCCG -> GACTTAGCTAACGGGACGCGCCGA
TCGTAGACGGAGCAGACAAATGAA -> CGTAGACGGAGCAGACAAATGAAT
AGCCCCTCTTCGCCATCAGCAGAC -> GCCCCTCTTCGCCATCAGCAGACC
TGATCGATACGATTCGCGTTGTCC -> GATCGATACGATTCGCGTTGTCCC
TCAACTACACACGGCAGGAACGCC -> CAACTACACACGGCAGGAACGCCC
CCTCTGGCTAAGACTGCACCACCC -> CTCTGGCTAAGACTGCACCACCCT
GGCAGGAACGCCCTGCGAACACCC -> GCAGGAACGCCCTGCGAACACCCA
CCGTGCGACTCGTGTGGCAGCCCC -> CGTGCGACTCGTGTGGCAGCCCCC
GTGCACACAATGTCAGCGCCGTCA -> TGCACACAATGTCAGCGCCGTCAC
GATTGTGCCCGCTCTAACTAGTCG -> ATTGTGCCCGCTCTAACTAGTCGA
AGGTATTTCCCATATGCAGCGTTC -> GGTATTTCCCATATGCAGCGTTCG
CAAGTAACATGTCAATTTTCCAGT -> AAGTAACATGTCAATTTTCCAGTT
CGTTCCTCAAAGTTGAGGGGAGTA -> GTTCCTCAAAGTTGAGGGGAGTAT
TACGGATTAACAAGCATGCGTTCC -> ACGGATTAACAAGCATGCGTTCCT
TTACGAAAGACGGGTCGCTCCCAC -> TACGAAAGACGGGTCGCTCCCACG
TGACAGCTCATTAGCTGTTCAAAC -> GACAGCTCATTAGCTGTTCAAACG
TGAGTGGGCTTGCGCTTATCGGGA -> GAGTGGGCTTGCGCTTATCGGGAT
ATCCGGCTCGACCAGGAGAAAACC -> TCCGGCTCGACCAGGAGAAAACCC
CCGGGGCTACGGCAAAGACAGCCT -> CGGGGCTACGGCAAAGACAGCCTG
ACATGGCATAAGAGCTGCCGTATA -> CATGGCATAAGAGCTGCCGTATAC
CTTTTATCTAGGACCCCTAGCCTG -> TTTTATCTAGGACCCCTAGCCTGC
GATACGATTCGCGTTGTCCCCTCC -> ATACGATTCGCGTTGTCCCCTCCT
ATTTTCGCATTGCATGCATGAACG -> TTTTCGCATTGCATGCATGAACGT
AGGGATTTTAGATGCAATCGTTCT -> GGGATTTTAGATGCAATCGTTCTG
CGGTCACTCTAGTAAATACCTGTG -> GGTCACTCTAGTAAATACCTGTGC
GATGCAGCGGGATAATTTGGCTTA -> ATGCAGCGGGATAATTTGGCTTAA
GTCAATGAGGTATTTCCCATATGC -> TCAATGAGGTATTTCCCATATGCA
CGGCAGGAACGCCCTGCGAACACC -> GGCAGGAACGCCCTGCGAACACCC
TTTCCCATATGCAGCGTTCGCGAT -> TTCCCATATGCAGCGTTCGCGATG
CACAGCTTCCTCCATGTCCGTCCT -> ACAGCTTCCTCCATGTCCGTCCTA
TCCACCCACAGGCAGTTGGGACTT -> CCACCCACAGGCAGTTGGGACTTC
TGTCCTTACGAAAGACGGGTCGCT -> GTCCTTACGAAAGACGGGTCGCTC
TCGCTACTTTTTATGGGAAGCAAC -> CGCTACTTTTTATGGGAAGCAACA
AAAGACACGTTTCCGCTGTGGAAG -> AAGACACGTTTCCGCTGTGGAAGA
GGCTACGGCAAAGACAGCCTGACC -> GCTACGGCAAAGACAGCCTGACCA
CGAAAGACACGTTTCCGCTGTGGA -> GAAAGACACGTTTCCGCTGTGGAA
ATGTATACTCCGGTGTCACAGAGA -> TGTATACTCCGGTGTCACAGAGAA
GGGCCTCTGAGAGCTGGATTGTGC -> GGCCTCTGAGAGCTGGATTGTGCC
TAGCTGTTCAAACGACCGTGCGAC -> AGCTGTTCAAACGACCGTGCGACT
CTCCGATAGCGCAGTGGAGCAACA -> TCCGATAGCGCAGTGGAGCAACAC
GGGATAATTTGGCTTAACCCTCAC -> GGATAATTTGGCTTAACCCTCACG
CCCTGCGAACACCCATACTTGTTT -> CCTGCGAACACCCATACTTGTTTC
ACGGCAAAGACAGCCTGACCACAC -> CGGCAAAGACAGCCTGACCACACT
GCTACGGATTAACAAGCATGCGTT -> CTACGGATTAACAAGCATGCGTTC
CTCTGGCTAAGACTGCACCACCCT -> TCTGGCTAAGACTGCACCACCCTA
TGCGAAACGACTGCGATCCGCACT -> GCGAAACGACTGCGATCCGCACTC
TGGAGCCCCTCTTCGCCATCAGCA -> GGAGCCCCTCTTCGCCATCAGCAG
GCCCTAAAGTAGGGAGCACGTCCT -> CCCTAAAGTAGGGAGCACGTCCTC
TAGCGCGTTCCTCAAAGTTGAGGG -> AGCGCGTTCCTCAAAGTTGAGGGG
GAAACGACTGCGATCCGCACTCAT -> AAACGACTGCGATCCGCACTCATT
CTCCTGTCACACTTACCCCTCAAC -> TCCTGTCACACTTACCCCTCAACT
TCATGGAGCCCCTCTTCGCCATCA -> CATGGAGCCCCTCTTCGCCATCAG
TAACGGCTGCCAAGGCGTTTTAAC -> AACGGCTGCCAAGGCGTTTTAACT
GGTGCGGGCTGGGGTGCGCCGATG -> GTGCGGGCTGGGGTGCGCCGATGC
CACGGAGCCGGGCGTTTCGACTGT -> ACGGAGCCGGGCGTTTCGACTGTT
TCGCATTGCATGCATGAACGTGGA -> CGCATTGCATGCATGAACGTGGAG
CGGCTCTACGACGTGCTACATGGC -> GGCTCTACGACGTGCTACATGGCA
TTGAGGGGAGTATCAGTCTTCGGA -> TGAGGGGAGTATCAGTCTTCGGAA
ATGGTTTCGATAGCGGCTCTACGA -> TGGTTTCGATAGCGGCTCTACGAC
AACTACACACGGCAGGAACGCCCT -> ACTACACACGGCAGGAACGCCCTG
CCTCTTCGCCATCAGCAGACCATG -> CTCTTCGCCATCAGCAGACCATGT
TCAATTTTCCAGTTGGGAGTCGTA -> CAATTTTCCAGTTGGGAGTCGTAA
TAAAGTCTTATAACGGCTGCCAAG -> AAAGTCTTATAACGGCTGCCAAGG
TTGTGATGCCATTCTTTCAGCCCG -> TGTGATGCCATTCTTTCAGCCCGT
GGAGCCGGGCGTTTCGACTGTTAG -> GAGCCGGGCGTTTCGACTGTTAGT
TCCAGTTGGGAGTCGTAACACTAG -> CCAGTTGGGAGTCGTAACACTAGA
GTTATTTAAATGTATACTCCGGTG -> TTATTTAAATGTATACTCCGGTGT
GGCGTTTTAACTCATGACAACACA -> GCGTTTTAACTCATGACAACACAG
GGCCCGGTTGTAATATGATCATGG -> GCCCGGTTGTAATATGATCATGGA
ATTATGAGGAGTGATGACATAGAG -> TTATGAGGAGTGATGACATAGAGC
GTATATCTTCCATTTTCGCATTGC -> TATATCTTCCATTTTCGCATTGCA
CCTGCAAGTCCACTCATCTACCCA -> CTGCAAGTCCACTCATCTACCCAC
GCCACACCTCGGCAGTGATATGCT -> CCACACCTCGGCAGTGATATGCTT
CGATCCGCACTCATTAGGTTGGGA -> GATCCGCACTCATTAGGTTGGGAG
CCCTCACGAAAGACACGTTTCCGC -> CCTCACGAAAGACACGTTTCCGCT
CTGCGACGGCGTCCTTCTTCATGG -> TGCGACGGCGTCCTTCTTCATGGG
TTATGGGAAGCAACATTCCATCAG -> TATGGGAAGCAACATTCCATCAGC
GTTTCACTAGTTCCTTCCGGGGCC -> TTTCACTAGTTCCTTCCGGGGCCC
GGACGGTAGTAGCTAGACTTAGCT -> GACGGTAGTAGCTAGACTTAGCTA
TTTTCCAGTTGGGAGTCGTAACAC -> TTTCCAGTTGGGAGTCGTAACACT
CAAGGCGTTTTAACTCATGACAAC -> AAGGCGTTTTAACTCATGACAACA
CTCCTTACTGCACATAACCTACGG -> TCCTTACTGCACATAACCTACGGT
AGGACGGTAGTAGCTAGACTTAGC -> GGACGGTAGTAGCTAGACTTAGCT
TGCACCACCCTAACCAATGGTGGA -> GCACCACCCTAACCAATGGTGGAC
TGTCTTGTGCCCTGTCTACCGGGC -> GTCTTGTGCCCTGTCTACCGGGCT
TGCTTTTATCTAGGACCCCTAGCC -> GCTTTTATCTAGGACCCCTAGCCT
CTCATTCTTGATCGATACGATTCG -> TCATTCTTGATCGATACGATTCGC
ATAAGAGCTGCCGTATACCTGCAA -> TAAGAGCTGCCGTATACCTGCAAG
TTGTAATATGATCATGGAGCCCCT -> TGTAATATGATCATGGAGCCCCTC
CGCGATGCAGCGGGATAATTTGGC -> GCGATGCAGCGGGATAATTTGGCT
CGGGCTACGAGGGATTTTAGATGC -> GGGCTACGAGGGATTTTAGATGCA
TCATCTACCCACAGCTTCCTCCAT -> CATCTACCCACAGCTTCCTCCATG
AATGCGTGTGATTGGCAAGGGGTT -> ATGCGTGTGATTGGCAAGGGGTTT
TCCCAGTCTACTGTGGTACATGGA -> CCCAGTCTACTGTGGTACATGGAC
TACACGGTTGTGCTCCGATAGCGC -> ACACGGTTGTGCTCCGATAGCGCA
CAGACGTGTCCTTACGAAAGACGG -> AGACGTGTCCTTACGAAAGACGGG
CGCATTGCATGCATGAACGTGGAG -> GCATTGCATGCATGAACGTGGAGT
GGAACGCCCTGCGAACACCCATAC -> GAACGCCCTGCGAACACCCATACT
GCTTTAGCCCCGGGGCTACGGCAA -> CTTTAGCCCCGGGGCTACGGCAAA
TGATGACATAGAGCATTGTCTTGT -> GATGACATAGAGCATTGTCTTGTG
TACATGACTCTAAAGTCTTATAAC -> ACATGACTCTAAAGTCTTATAACG
AGCACGTCCTCCCAGTCTACTGTG -> GCACGTCCTCCCAGTCTACTGTGG
TCATAAAAACTAGGTACACGGTTG -> CATAAAAACTAGGTACACGGTTGT
ACGGTGAAACGCGAACCCTGGAGT -> CGGTGAAACGCGAACCCTGGAGTC
CGTTTTAACTCATGACAACACAGG -> GTTTTAACTCATGACAACACAGGA
ACCTCGGCAGTGATATGCTTTCTC -> CCTCGGCAGTGATATGCTTTCTCC
TGGTTTCGATAGCGGCTCTACGAC -> GGTTTCGATAGCGGCTCTACGACG
GCGGCTCCGCGATAGCGCGTTCCT -> CGGCTCCGCGATAGCGCGTTCCTC
AGCGATCTAGCCATGCGCTCCTAA -> GCGATCTAGCCATGCGCTCCTAAT
CTTCGCCATCAGCAGACCATGTTA -> TTCGCCATCAGCAGACCATGTTAT
AGTCGATCAAGAGCTATTTGGCAG -> GTCGATCAAGAGCTATTTGGCAGA
AACAGATGGGCCCCGGCGGGGAGA -> ACAGATGGGCCCCGGCGGGGAGAT
AGCCTGCGCCGGTATTTAAAAGAA -> GCCTGCGCCGGTATTTAAAAGAAG
GCGGTCACTCTAGTAAATACCTGT -> CGGTCACTCTAGTAAATACCTGTG
TTCCTTCCGGGGCCCGGTTGTAAT -> TCCTTCCGGGGCCCGGTTGTAATA
TCTACTGTGGTACATGGACCCTTT -> CTACTGTGGTACATGGACCCTTTT
TCGATACGATTCGCGTTGTCCCCT -> CGATACGATTCGCGTTGTCCCCTC
TCTCGTTTATCTAATGACAGCTCA -> CTCGTTTATCTAATGACAGCTCAT
ATAGCATTCAAAGGGGACGCGCCA -> TAGCATTCAAAGGGGACGCGCCAC
ATATGGTATGTCTGAGCATTAGTG -> TATGGTATGTCTGAGCATTAGTGA
TTCCAGTTGGGAGTCGTAACACTA -> TCCAGTTGGGAGTCGTAACACTAG
AAGGGGACGCGCCACTTTTAAACC -> AGGGGACGCGCCACTTTTAAACCT
AACCTACGGTGAAACGCGAACCCT -> ACCTACGGTGAAACGCGAACCCTG
AATCGCTACTTTTTATGGGAAGCA -> ATCGCTACTTTTTATGGGAAGCAA
CTAGTAAATACCTGTGCACACAAT -> TAGTAAATACCTGTGCACACAATG
TACTCCGGTGTCACAGAGAAGCCC -> ACTCCGGTGTCACAGAGAAGCCCA
CCTGCGCCGGTATTTAAAAGAAGG -> CTGCGCCGGTATTTAAAAGAAGGC
CTACGGCAAAGACAGCCTGACCAC -> TACGGCAAAGACAGCCTGACCACA
CGTGTCCTTACGAAAGACGGGTCG -> GTGTCCTTACGAAAGACGGGTCGC
ACCCTCTTGACTGTGGGGTTCTCA -> CCCTCTTGACTGTGGGGTTCTCAA
GAATTATGAGGAGTGATGACATAG -> AATTATGAGGAGTGATGACATAGA
GCATTGCATGCATGAACGTGGAGT -> CATTGCATGCATGAACGTGGAGTT
GCAGGAACGCCCTGCGAACACCCA -> CAGGAACGCCCTGCGAACACCCAT
TGTTGTCCGCTAAACTTTGGGGCC -> GTTGTCCGCTAAACTTTGGGGCCT
TTTCACTAGTTCCTTCCGGGGCCC -> TTCACTAGTTCCTTCCGGGGCCCG
TCACGTGTAGTGCAGACGTGTCCT -> CACGTGTAGTGCAGACGTGTCCTT
GAACGTGGAGTTGAAGGGGGATCT -> AACGTGGAGTTGAAGGGGGATCTT
GACTGTTAGTCAAATGATGGATCC -> ACTGTTAGTCAAATGATGGATCCT
GAGCAGACAAATGAATCCCGGAGT -> AGCAGACAAATGAATCCCGGAGTC
TCCTCAAAGTTGAGGGGAGTATCA -> CCTCAAAGTTGAGGGGAGTATCAG
TTTTGCCACACCTCGGCAGTGATA -> TTTGCCACACCTCGGCAGTGATAT
AACAAGCATGCGTTCCTCCTGTCA -> ACAAGCATGCGTTCCTCCTGTCAC
GCTCCTAATCGCTACTTTTTATGG -> CTCCTAATCGCTACTTTTTATGGG
CCTCCACCCACAGGCAGTTGGGAC -> CTCCACCCACAGGCAGTTGGGACT
GGAGCCCCTCTTCGCCATCAGCAG -> GAGCCCCTCTTCGCCATCAGCAGA
ACTCCGGTGTCACAGAGAAGCCCA -> CTCCGGTGTCACAGAGAAGCCCAC
TCTAGGACCCCTAGCCTGCGCCGG -> CTAGGACCCCTAGCCTGCGCCGGT
CGATAGCGGCTCTACGACGTGCTA -> GATAGCGGCTCTACGACGTGCTAC
CGTTTCCGCTGTGGAAGACATTGC -> GTTTCCGCTGTGGAAGACATTGCC
TACGAGGGATTTTAGATGCAATCG -> ACGAGGGATTTTAGATGCAATCGT
TTCCATCAGCTTGTGATGCCATTC -> TCCATCAGCTTGTGATGCCATTCT
TAGCGGCTCTACGACGTGCTACAT -> AGCGGCTCTACGACGTGCTACATG
TGCTTTAGCCCCGGGGCTACGGCA -> GCTTTAGCCCCGGGGCTACGGCAA
TTATCTAATGACAGCTCATTAGCT -> TATCTAATGACAGCTCATTAGCTG
CCAAATATGAGTGGGCTTGCGCTT -> CAAATATGAGTGGGCTTGCGCTTA
TGGATGCCCACAAGTTGCTTTTAT -> GGATGCCCACAAGTTGCTTTTATC
CCGGCTCGACCAGGAGAAAACCCC -> CGGCTCGACCAGGAGAAAACCCCC
CAGCCTGACCACACTCCGTACAGT -> AGCCTGACCACACTCCGTACAGTT
CGGCAGTGATATGCTTTCTCCACA -> GGCAGTGATATGCTTTCTCCACAA
CTACGAGGGATTTTAGATGCAATC -> TACGAGGGATTTTAGATGCAATCG
GTCCACTCATCTACCCACAGCTTC -> TCCACTCATCTACCCACAGCTTCC
CTTACGAAAGACGGGTCGCTCCCA -> TTACGAAAGACGGGTCGCTCCCAC
ATATGCAGCGTTCGCGATGCAGCG -> TATGCAGCGTTCGCGATGCAGCGG
CAATGCGTGTGATTGGCAAGGGGT -> AATGCGTGTGATTGGCAAGGGGTT
AACACCCATACTTGTTTCAAGCTG -> ACACCCATACTTGTTTCAAGCTGC
TCCATGTCCGTCCTACGATCTTTT -> CCATGTCCGTCCTACGATCTTTTG
CTCAATGCTTTATCATAAAAACTA -> TCAATGCTTTATCATAAAAACTAG
GTTGGGAGTCGTAACACTAGAAAT -> TTGGGAGTCGTAACACTAGAAATA
TTTGGCTTAACCCTCACGAAAGAC -> TTGGCTTAACCCTCACGAAAGACA
CCGTTATTCCCAACAATATCCCCA -> CGTTATTCCCAACAATATCCCCAA
TGACAACACAGGATCCGGCTCGAC -> GACAACACAGGATCCGGCTCGACC
CTACTTTTTATGGGAAGCAACATT -> TACTTTTTATGGGAAGCAACATTC
GATCAAGAGCTATTTGGCAGACGC -> ATCAAGAGCTATTTGGCAGACGCG
GCGCCGGTATTTAAAAGAAGGCGG -> CGCCGGTATTTAAAAGAAGGCGGC
GAGGTATTTCCCATATGCAGCGTT -> AGGTATTTCCCATATGCAGCGTTC
TCCTTACGAAAGACGGGTCGCTCC -> CCTTACGAAAGACGGGTCGCTCCC
AGTGCAGACGTGTCCTTACGAAAG -> GTGCAGACGTGTCCTTACGAAAGA
TGGCAGCCCCCGGGACCTGCCGAG -> GGCAGCCCCCGGGACCTGCCGAGA
ACCGGGCTACGAGGGATTTTAGAT -> CCGGGCTACGAGGGATTTTAGATG
GCGCTAGGATTTCAACGGCAAACA -> CGCTAGGATTTCAACGGCAAACAC
TCGTTTATCTAATGACAGCTCATT -> CGTTTATCTAATGACAGCTCATTA
CTACACACGGCAGGAACGCCCTGC -> TACACACGGCAGGAACGCCCTGCG
TAGTGCAGACGTGTCCTTACGAAA -> AGTGCAGACGTGTCCTTACGAAAG
AGAAGCCCACCTGATGGTGCGGGC -> GAAGCCCACCTGATGGTGCGGGCT
CCGATAGCGCAGTGGAGCAACACC -> CGATAGCGCAGTGGAGCAACACCA
AGTCCACTCATCTACCCACAGCTT -> GTCCACTCATCTACCCACAGCTTC
TCCGTCCTACGATCTTTTGCCACA -> CCGTCCTACGATCTTTTGCCACAC
AGCAACACCAACAGATGGGCCCCG -> GCAACACCAACAGATGGGCCCCGG
CTTGATCGATACGATTCGCGTTGT -> TTGATCGATACGATTCGCGTTGTC
GTGATGACATAGAGCATTGTCTTG -> TGATGACATAGAGCATTGTCTTGT
CCTTACTGCACATAACCTACGGTG -> CTTACTGCACATAACCTACGGTGA
CTGGGGTGCGCCGATGCCCTAAAG -> TGGGGTGCGCCGATGCCCTAAAGT
GATAATTTGGCTTAACCCTCACGA -> ATAATTTGGCTTAACCCTCACGAA
GATGGTGCGGGCTGGGGTGCGCCG -> ATGGTGCGGGCTGGGGTGCGCCGA
TCCCATATGCAGCGTTCGCGATGC -> CCCATATGCAGCGTTCGCGATGCA
GCTGGATTGTGCCCGCTCTAACTA -> CTGGATTGTGCCCGCTCTAACTAG
GCACGTCCTCCCAGTCTACTGTGG -> CACGTCCTCCCAGTCTACTGTGGT
ATCAAGAGCTATTTGGCAGACGCG -> TCAAGAGCTATTTGGCAGACGCGC
TGGTACATGGACCCTTTTCGAAGG -> GGTACATGGACCCTTTTCGAAGGG
TGCACACAATGTCAGCGCCGTCAC -> GCACACAATGTCAGCGCCGTCACC
GGTACACGGTTGTGCTCCGATAGC -> GTACACGGTTGTGCTCCGATAGCG
GGCCGTCAATGAGGTATTTCCCAT -> GCCGTCAATGAGGTATTTCCCATA
TCAGCAGACCATGTTATTTAAATG -> CAGCAGACCATGTTATTTAAATGT
TTTAACTCATGACAACACAGGATC -> TTAACTCATGACAACACAGGATCC
CGCGTTCCTCAAAGTTGAGGGGAG -> GCGTTCCTCAAAGTTGAGGGGAGT
TGCCTCATTCTTGATCGATACGAT -> GCCTCATTCTTGATCGATACGATT
CGGGGAGATGCTGCTATTATTTTT -> GGGGAGATGCTGCTATTATTTTTT
TTTTTACATGACTCTAAAGTCTTA -> TTTTACATGACTCTAAAGTCTTAT
TCAGGAACGAGGACGGTAGTAGCT -> CAGGAACGAGGACGGTAGTAGCTA
CTTCCTCCATGTCCGTCCTACGAT -> TTCCTCCATGTCCGTCCTACGATC
CCATGTCCGTCCTACGATCTTTTG -> CATGTCCGTCCTACGATCTTTTGC
AGGTTGGGAGTTCAGGAACGAGGA -> GGTTGGGAGTTCAGGAACGAGGAC
AGTCTTATAACGGCTGCCAAGGCG -> GTCTTATAACGGCTGCCAAGGCGT
ACCGTGCGACTCGTGTGGCAGCCC -> CCGTGCGACTCGTGTGGCAGCCCC
AAGCTGCTTTAGCCCCGGGGCTAC -> AGCTGCTTTAGCCCCGGGGCTACG
GCGTGTGATTGGCAAGGGGTTTCA -> CGTGTGATTGGCAAGGGGTTTCAC
ATGACAGCTCATTAGCTGTTCAAA -> TGACAGCTCATTAGCTGTTCAAAC
AGGGGACGCGCCACTTTTAAACCT -> GGGGACGCGCCACTTTTAAACCTT
TCCGATAGCGCAGTGGAGCAACAC -> CCGATAGCGCAGTGGAGCAACACC
ATGAATCCCGGAGTCACCCCTGCG -> TGAATCCCGGAGTCACCCCTGCGA
ATGTCCGTCCTACGATCTTTTGCC -> TGTCCGTCCTACGATCTTTTGCCA
AACCCTCTTGACTGTGGGGTTCTC -> ACCCTCTTGACTGTGGGGTTCTCA
CTACCGGGCTACGAGGGATTTTAG -> TACCGGGCTACGAGGGATTTTAGA
CAATGGTGGACATAATGGTTTCGA -> AATGGTGGACATAATGGTTTCGAT
CCTAACCAATGGTGGACATAATGG -> CTAACCAATGGTGGACATAATGGT
TGCAAGTCCACTCATCTACCCACA -> GCAAGTCCACTCATCTACCCACAG
CAGACCATGTTATTTAAATGTATA -> AGACCATGTTATTTAAATGTATAC
CGATCTTTTGCCACACCTCGGCAG -> GATCTTTTGCCACACCTCGGCAGT
GCCATGCGCTCCTAATCGCTACTT -> CCATGCGCTCCTAATCGCTACTTT
GGAGTTGAAGGGGGATCTTCAACG -> GAGTTGAAGGGGGATCTTCAACGG
CATTCAAAGGGGACGCGCCACTTT -> ATTCAAAGGGGACGCGCCACTTTT
TGAACGTGGAGTTGAAGGGGGATC -> GAACGTGGAGTTGAAGGGGGATCT
TTCTTTCAGCCCGTTATTCCCAAC -> TCTTTCAGCCCGTTATTCCCAACA
AAGTAACATGTCAATTTTCCAGTT -> AGTAACATGTCAATTTTCCAGTTG
TATATCTTCCATTTTCGCATTGCA -> ATATCTTCCATTTTCGCATTGCAT
AGATGCAATCGTTCTGCGAATCAA -> GATGCAATCGTTCTGCGAATCAAT
GGACGCGCCGAACCCTCTTGACTG -> GACGCGCCGAACCCTCTTGACTGT
TTTTAGATGCAATCGTTCTGCGAA -> TTTAGATGCAATCGTTCTGCGAAT
TGGAATTATGAGGAGTGATGACAT -> GGAATTATGAGGAGTGATGACATA
GCGTTCCTCCTGTCACACTTACCC -> CGTTCCTCCTGTCACACTTACCCC
CAAACGACCGTGCGACTCGTGTGG -> AAACGACCGTGCGACTCGTGTGGC
CGTTCCTCCTGTCACACTTACCCC -> GTTCCTCCTGTCACACTTACCCCT
GTCAGCGCCGTCACCAATGCGTGT -> TCAGCGCCGTCACCAATGCGTGTG
CGTAACACTAGAAATATGGTATGT -> GTAACACTAGAAATATGGTATGTC
CCCGGGGCTACGGCAAAGACAGCC -> CCGGGGCTACGGCAAAGACAGCCT
ATGACTCTAAAGTCTTATAACGGC -> TGACTCTAAAGTCTTATAACGGCT
CATTGCATGCATGAACGTGGAGTT -> ATTGCATGCATGAACGTGGAGTTG
CGTTATTCCCAACAATATCCCCAA -> GTTATTCCCAACAATATCCCCAAA
GTTGGGACTTCGTAGACGGAGCAG -> TTGGGACTTCGTAGACGGAGCAGA
CACCCCTGCGACGGCGTCCTTCTT -> ACCCCTGCGACGGCGTCCTTCTTC
TAAACCTTGTGTTGTCCGCTAAAC -> AAACCTTGTGTTGTCCGCTAAACT
AAATATGGTATGTCTGAGCATTAG -> AATATGGTATGTCTGAGCATTAGT
GCTAACGGGACGCGCCGAACCCTC -> CTAACGGGACGCGCCGAACCCTCT
TTTGGGGCCTCTGAGAGCTGGATT -> TTGGGGCCTCTGAGAGCTGGATTG
CTAATCGCTACTTTTTATGGGAAG -> TAATCGCTACTTTTTATGGGAAGC
GTGCGAAACGACTGCGATCCGCAC -> TGCGAAACGACTGCGATCCGCACT
ACTTTTAAACCTTGTGTTGTCCGC -> CTTTTAAACCTTGTGTTGTCCGCT
AGAGCGATCTAGCCATGCGCTCCT -> GAGCGATCTAGCCATGCGCTCCTA
GCGATGCAGCGGGATAATTTGGCT -> CGATGCAGCGGGATAATTTGGCTT
GCCCACCTGATGGTGCGGGCTGGG -> CCCACCTGATGGTGCGGGCTGGGG
GAGTCGTAACACTAGAAATATGGT -> AGTCGTAACACTAGAAATATGGTA
GACGTGTCCTTACGAAAGACGGGT -> ACGTGTCCTTACGAAAGACGGGTC
CGGTGTCACAGAGAAGCCCACCTG -> GGTGTCACAGAGAAGCCCACCTGA
GGCAGCCCCCGGGACCTGCCGAGA -> GCAGCCCCCGGGACCTGCCGAGAG
ATCAATTGGTTGGATGCCCACAAG -> TCAATTGGTTGGATGCCCACAAGT
TCCTATAGGACACGCGGAGCCTCT -> CCTATAGGACACGCGGAGCCTCTG
ACTAGGTACACGGTTGTGCTCCGA -> CTAGGTACACGGTTGTGCTCCGAT
ACAATATCCCCAAATATGAGTGGG -> CAATATCCCCAAATATGAGTGGGC
GGGGACGCGCCACTTTTAAACCTT -> GGGACGCGCCACTTTTAAACCTTG
CTACGGATTAACAAGCATGCGTTC -> TACGGATTAACAAGCATGCGTTCC
CGGGCGTTTCGACTGTTAGTCAAA -> GGGCGTTTCGACTGTTAGTCAAAT
AACTTTGGGGCCTCTGAGAGCTGG -> ACTTTGGGGCCTCTGAGAGCTGGA
ACGACTGCGATCCGCACTCATTAG -> CGACTGCGATCCGCACTCATTAGG
CATGACTCTAAAGTCTTATAACGG -> ATGACTCTAAAGTCTTATAACGGC
TAGTAGCTAGACTTAGCTAACGGG -> AGTAGCTAGACTTAGCTAACGGGA
TTTCCGCTGTGGAAGACATTGCCT -> TTCCGCTGTGGAAGACATTGCCTC
CTATACAAGTAACATGTCAATTTT -> TATACAAGTAACATGTCAATTTTC
AACATTCCATCAGCTTGTGATGCC -> ACATTCCATCAGCTTGTGATGCCA
ATGGAGCCCCTCTTCGCCATCAGC -> TGGAGCCCCTCTTCGCCATCAGCA
CGGTTGTGCTCCGATAGCGCAGTG -> GGTTGTGCTCCGATAGCGCAGTGG
GTTCGCGATGCAGCGGGATAATTT -> TTCGCGATGCAGCGGGATAATTTG
CTACTGTGGTACATGGACCCTTTT -> TACTGTGGTACATGGACCCTTTTC
TTCAGGAACGAGGACGGTAGTAGC -> TCAGGAACGAGGACGGTAGTAGCT
CCTACGATCTTTTGCCACACCTCG -> CTACGATCTTTTGCCACACCTCGG
CGACCAGGAGAAAACCCCCCTATC -> GACCAGGAGAAAACCCCCCTATCT
GTCCTTCTTCATGGGCCGTCAATG -> TCCTTCTTCATGGGCCGTCAATGA
TGGATCCTATAGGACACGCGGAGC -> GGATCCTATAGGACACGCGGAGCC
GTAACATGTCAATTTTCCAGTTGG -> TAACATGTCAATTTTCCAGTTGGG
CTGTGCACACAATGTCAGCGCCGT -> TGTGCACACAATGTCAGCGCCGTC
GCGATCTAGCCATGCGCTCCTAAT -> CGATCTAGCCATGCGCTCCTAATC
TTCAGCCCGTTATTCCCAACAATA -> TCAGCCCGTTATTCCCAACAATAT
CTTAACCCTCACGAAAGACACGTT -> TTAACCCTCACGAAAGACACGTTT
TAAACTTTGGGGCCTCTGAGAGCT -> AAACTTTGGGGCCTCTGAGAGCTG
CATAAAAACTAGGTACACGGTTGT -> ATAAAAACTAGGTACACGGTTGTG
ATGGGAAGCAACATTCCATCAGCT -> TGGGAAGCAACATTCCATCAGCTT
CAGCGGGATAATTTGGCTTAACCC -> AGCGGGATAATTTGGCTTAACCCT
TTAGCTAACGGGACGCGCCGAACC -> TAGCTAACGGGACGCGCCGAACCC
GGTCACGTGTAGTGCAGACGTGTC -> GTCACGTGTAGTGCAGACGTGTCC
GGTCACTCTAGTAAATACCTGTGC -> GTCACTCTAGTAAATACCTGTGCA
TTTCAGCCCGTTATTCCCAACAAT -> TTCAGCCCGTTATTCCCAACAATA
TGTCACACTTACCCCTCAACTACA -> GTCACACTTACCCCTCAACTACAC
AATACCTGTGCACACAATGTCAGC -> ATACCTGTGCACACAATGTCAGCG
TGCCGAGAGCGATCTAGCCATGCG -> GCCGAGAGCGATCTAGCCATGCGC
TTTTAAACCTTGTGTTGTCCGCTA -> TTTAAACCTTGTGTTGTCCGCTAA
AAGTCCACTCATCTACCCACAGCT -> AGTCCACTCATCTACCCACAGCTT
CTATCTCGTTTATCTAATGACAGC -> TATCTCGTTTATCTAATGACAGCT
AGCATTGTCTTGTGCCCTGTCTAC -> GCATTGTCTTGTGCCCTGTCTACC
GCAACATTCCATCAGCTTGTGATG -> CAACATTCCATCAGCTTGTGATGC
TCTGCGAATCAATTGGTTGGATGC -> CTGCGAATCAATTGGTTGGATGCC
CTCCCACGCTACGGATTAACAAGC -> TCCCACGCTACGGATTAACAAGCA
GAAGCCCACCTGATGGTGCGGGCT -> AAGCCCACCTGATGGTGCGGGCTG
CATGTCCGTCCTACGATCTTTTGC -> ATGTCCGTCCTACGATCTTTTGCC
GAACCTCCACCCACAGGCAGTTGG -> AACCTCCACCCACAGGCAGTTGGG
CAACGGAAGATTTCTATCACGGAG -> AACGGAAGATTTCTATCACGGAGC
ATTTGGCTTAACCCTCACGAAAGA -> TTTGGCTTAACCCTCACGAAAGAC
CTAGTCGATCAAGAGCTATTTGGC -> TAGTCGATCAAGAGCTATTTGGCA
ACAGTTTGGAATTATGAGGAGTGA -> CAGTTTGGAATTATGAGGAGTGAT
GTTGAAGGGGGATCTTCAACGGAA -> TTGAAGGGGGATCTTCAACGGAAG
TCTATACAAGTAACATGTCAATTT -> CTATACAAGTAACATGTCAATTTT
CTGTTCAAACGACCGTGCGACTCG -> TGTTCAAACGACCGTGCGACTCGT
AACCTTGTGTTGTCCGCTAAACTT -> ACCTTGTGTTGTCCGCTAAACTTT
CGGGTCGCTCCCACGCTACGGATT -> GGGTCGCTCCCACGCTACGGATTA
GCGAACACCCATACTTGTTTCAAG -> CGAACACCCATACTTGTTTCAAGC
TAACCCTCACGAAAGACACGTTTC -> AACCCTCACGAAAGACACGTTTCC
CGTCAATGAGGTATTTCCCATATG -> GTCAATGAGGTATTTCCCATATGC
TCTACCGGGCTACGAGGGATTTTA -> CTACCGGGCTACGAGGGATTTTAG
TCGTGTGGCAGCCCCCGGGACCTG -> CGTGTGGCAGCCCCCGGGACCTGC
TAGTCGATCAAGAGCTATTTGGCA -> AGTCGATCAAGAGCTATTTGGCAG
TGCCAAGGCGTTTTAACTCATGAC -> GCCAAGGCGTTTTAACTCATGACA
AACGGCTGCCAAGGCGTTTTAACT -> ACGGCTGCCAAGGCGTTTTAACTC
AGACGGGTCGCTCCCACGCTACGG -> GACGGGTCGCTCCCACGCTACGGA
TGTCTACCGGGCTACGAGGGATTT -> GTCTACCGGGCTACGAGGGATTTT
CCCGTTATTCCCAACAATATCCCC -> CCGTTATTCCCAACAATATCCCCA
CATTCCATCAGCTTGTGATGCCAT -> ATTCCATCAGCTTGTGATGCCATT
GGATCCGGCTCGACCAGGAGAAAA -> GATCCGGCTCGACCAGGAGAAAAC
CAAGTTGCTTTTATCTAGGACCCC -> AAGTTGCTTTTATCTAGGACCCCT
TGACTCTAAAGTCTTATAACGGCT -> GACTCTAAAGTCTTATAACGGCTG
GGACACGCGGAGCCTCTGGCTAAG -> GACACGCGGAGCCTCTGGCTAAGA
TTTCGAAGGGTGCGAAACGACTGC -> TTCGAAGGGTGCGAAACGACTGCG
ACACCAACAGATGGGCCCCGGCGG -> CACCAACAGATGGGCCCCGGCGGG
AAGGCGGCTCCGCGATAGCGCGTT -> AGGCGGCTCCGCGATAGCGCGTTC
AGGAACGAGGACGGTAGTAGCTAG -> GGAACGAGGACGGTAGTAGCTAGA
GCCTCTGAGAGCTGGATTGTGCCC -> CCTCTGAGAGCTGGATTGTGCCCG
TCAAGAGCTATTTGGCAGACGCGC -> CAAGAGCTATTTGGCAGACGCGCT
CCTTCCGGGGCCCGGTTGTAATAT -> CTTCCGGGGCCCGGTTGTAATATG
CTCCATGTCCGTCCTACGATCTTT -> TCCATGTCCGTCCTACGATCTTTT
GTCTACTGTGGTACATGGACCCTT -> TCTACTGTGGTACATGGACCCTTT
CTAAAGTAGGGAGCACGTCCTCCC -> TAAAGTAGGGAGCACGTCCTCCCA
TAGCGCAGTGGAGCAACACCAACA -> AGCGCAGTGGAGCAACACCAACAG
TAAAAACTAGGTACACGGTTGTGC -> AAAAACTAGGTACACGGTTGTGCT
TCAACGGCAAACACAACGCGGTCA -> CAACGGCAAACACAACGCGGTCAC
AAGCAACATTCCATCAGCTTGTGA -> AGCAACATTCCATCAGCTTGTGAT
ATGAGTGGGCTTGCGCTTATCGGG -> TGAGTGGGCTTGCGCTTATCGGGA
CACTCCGTACAGTTTGGAATTATG -> ACTCCGTACAGTTTGGAATTATGA
TTAACAAGCATGCGTTCCTCCTGT -> TAACAAGCATGCGTTCCTCCTGTC
CAGAGAAGCCCACCTGATGGTGCG -> AGAGAAGCCCACCTGATGGTGCGG
ATGACAACACAGGATCCGGCTCGA -> TGACAACACAGGATCCGGCTCGAC
CCCAGTCTACTGTGGTACATGGAC -> CCAGTCTACTGTGGTACATGGACC
CCCCGGGGCTACGGCAAAGACAGC -> CCCGGGGCTACGGCAAAGACAGCC
AAAAGAAGGCGGCTCCGCGATAGC -> AAAGAAGGCGGCTCCGCGATAGCG
GAGTATCAGTCTTCGGAACCTCCA -> AGTATCAGTCTTCGGAACCTCCAC
GGTTGTGCTCCGATAGCGCAGTGG -> GTTGTGCTCCGATAGCGCAGTGGA
TTCGAAGGGTGCGAAACGACTGCG -> TCGAAGGGTGCGAAACGACTGCGA
GTAGACGGAGCAGACAAATGAATC -> TAGACGGAGCAGACAAATGAATCC
CGAAACGACTGCGATCCGCACTCA -> GAAACGACTGCGATCCGCACTCAT
CATGTCAATTTTCCAGTTGGGAGT -> ATGTCAATTTTCCAGTTGGGAGTC
CCCCCGGGACCTGCCGAGAGCGAT -> CCCCGGGACCTGCCGAGAGCGATC
CGGCGTCCTTCTTCATGGGCCGTC -> GGCGTCCTTCTTCATGGGCCGTCA
TGCCGTATACCTGCAAGTCCACTC -> GCCGTATACCTGCAAGTCCACTCA
GAAACGCGAACCCTGGAGTCGGTA -> AAACGCGAACCCTGGAGTCGGTAT
CTGTGGAAGACATTGCCTCATTCT -> TGTGGAAGACATTGCCTCATTCTT
ATGGTGCGGGCTGGGGTGCGCCGA -> TGGTGCGGGCTGGGGTGCGCCGAT
AGCCTGACCACACTCCGTACAGTT -> GCCTGACCACACTCCGTACAGTTT
TCAAATGATGGATCCTATAGGACA -> CAAATGATGGATCCTATAGGACAC
GCAGTGATATGCTTTCTCCACAAT -> CAGTGATATGCTTTCTCCACAATC
TCGGTATATCTTCCATTTTCGCAT -> CGGTATATCTTCCATTTTCGCATT
ACAGATGGGCCCCGGCGGGGAGAT -> CAGATGGGCCCCGGCGGGGAGATG
CACTCATCTACCCACAGCTTCCTC -> ACTCATCTACCCACAGCTTCCTCC
CGCTGTGGAAGACATTGCCTCATT -> GCTGTGGAAGACATTGCCTCATTC
TATCTCGTTTATCTAATGACAGCT -> ATCTCGTTTATCTAATGACAGCTC
GACGCGCTAGGATTTCAACGGCAA -> ACGCGCTAGGATTTCAACGGCAAA
TTAGCCCCGGGGCTACGGCAAAGA -> TAGCCCCGGGGCTACGGCAAAGAC
CGGAACCTCCACCCACAGGCAGTT -> GGAACCTCCACCCACAGGCAGTTG
TTGGGAGTCGTAACACTAGAAATA -> TGGGAGTCGTAACACTAGAAATAT
CCATTCTTTCAGCCCGTTATTCCC -> CATTCTTTCAGCCCGTTATTCCCA
GGAGCAGACAAATGAATCCCGGAG -> GAGCAGACAAATGAATCCCGGAGT
GATGCTGCTATTATTTTTTACATG -> ATGCTGCTATTATTTTTTACATGA
CGAACACCCATACTTGTTTCAAGC -> GAACACCCATACTTGTTTCAAGCT
ACTGCACATAACCTACGGTGAAAC -> CTGCACATAACCTACGGTGAAACG
TCCTCCTGTCACACTTACCCCTCA -> CCTCCTGTCACACTTACCCCTCAA
ACCCATACTTGTTTCAAGCTGCTT -> CCCATACTTGTTTCAAGCTGCTTT
CAAATGATGGATCCTATAGGACAC -> AAATGATGGATCCTATAGGACACG
GGGAGTCGTAACACTAGAAATATG -> GGAGTCGTAACACTAGAAATATGG
CCAACAGATGGGCCCCGGCGGGGA -> CAACAGATGGGCCCCGGCGGGGAG
TGGGGTGCGCCGATGCCCTAAAGT -> GGGGTGCGCCGATGCCCTAAAGTA
GGGCTACGAGGGATTTTAGATGCA -> GGCTACGAGGGATTTTAGATGCAA
TTCAAAGGGGACGCGCCACTTTTA -> TCAAAGGGGACGCGCCACTTTTAA
GCTGTGGAAGACATTGCCTCATTC -> CTGTGGAAGACATTGCCTCATTCT
TAGTCAAATGATGGATCCTATAGG -> AGTCAAATGATGGATCCTATAGGA
TGAGGAGTGATGACATAGAGCATT -> GAGGAGTGATGACATAGAGCATTG
ACCACACTCCGTACAGTTTGGAAT -> CCACACTCCGTACAGTTTGGAATT
GAGCCGGGCGTTTCGACTGTTAGT -> AGCCGGGCGTTTCGACTGTTAGTC
CAGCCCCCGGGACCTGCCGAGAGC -> AGCCCCCGGGACCTGCCGAGAGCG
CCCTAAAGTAGGGAGCACGTCCTC -> CCTAAAGTAGGGAGCACGTCCTCC
TTCAAGCTGCTTTAGCCCCGGGGC -> TCAAGCTGCTTTAGCCCCGGGGCT
CGCGCCGAACCCTCTTGACTGTGG -> GCGCCGAACCCTCTTGACTGTGGG
TAGGATTTCAACGGCAAACACAAC -> AGGATTTCAACGGCAAACACAACG
TCACACTTACCCCTCAACTACACA -> CACACTTACCCCTCAACTACACAC
TCCGCACTCATTAGGTTGGGAGTT -> CCGCACTCATTAGGTTGGGAGTTC
ACGCGGAGCCTCTGGCTAAGACTG -> CGCGGAGCCTCTGGCTAAGACTGC
AGGACACGCGGAGCCTCTGGCTAA -> GGACACGCGGAGCCTCTGGCTAAG
AGTAAATACCTGTGCACACAATGT -> GTAAATACCTGTGCACACAATGTC
ATTTCTATCACGGAGCCGGGCGTT -> TTTCTATCACGGAGCCGGGCGTTT
GACGTGCTACATGGCATAAGAGCT -> ACGTGCTACATGGCATAAGAGCTG
TCATTAGCTGTTCAAACGACCGTG -> CATTAGCTGTTCAAACGACCGTGC
AAGCATGCGTTCCTCCTGTCACAC -> AGCATGCGTTCCTCCTGTCACACT
CACAACGCGGTCACTCTAGTAAAT -> ACAACGCGGTCACTCTAGTAAATA
CGGGATAATTTGGCTTAACCCTCA -> GGGATAATTTGGCTTAACCCTCAC
GTCCCCTCCTTACTGCACATAACC -> TCCCCTCCTTACTGCACATAACCT
TGCAGCGGGATAATTTGGCTTAAC -> GCAGCGGGATAATTTGGCTTAACC
AGCTTCCTCCATGTCCGTCCTACG -> GCTTCCTCCATGTCCGTCCTACGA
GCTATTATTTTTTACATGACTCTA -> CTATTATTTTTTACATGACTCTAA
TGACATAGAGCATTGTCTTGTGCC -> GACATAGAGCATTGTCTTGTGCCC
ACCAACAGATGGGCCCCGGCGGGG -> CCAACAGATGGGCCCCGGCGGGGA
TGGATTGTGCCCGCTCTAACTAGT -> GGATTGTGCCCGCTCTAACTAGTC
ACGGCAAACACAACGCGGTCACTC -> CGGCAAACACAACGCGGTCACTCT
ATCTTCAACGGAAGATTTCTATCA -> TCTTCAACGGAAGATTTCTATCAC
GATCTAGCCATGCGCTCCTAATCG -> ATCTAGCCATGCGCTCCTAATCGC
ACCCTTTTCGAAGGGTGCGAAACG -> CCCTTTTCGAAGGGTGCGAAACGA
CCACTTTTAAACCTTGTGTTGTCC -> CACTTTTAAACCTTGTGTTGTCCG
CACCAACAGATGGGCCCCGGCGGG -> ACCAACAGATGGGCCCCGGCGGGG
TGTCCCCTCCTTACTGCACATAAC -> GTCCCCTCCTTACTGCACATAACC
TATACTCCGGTGTCACAGAGAAGC -> ATACTCCGGTGTCACAGAGAAGCC
TTCTCAATGCTTTATCATAAAAAC -> TCTCAATGCTTTATCATAAAAACT
ATCAGCTTGTGATGCCATTCTTTC -> TCAGCTTGTGATGCCATTCTTTCA
GGAAGCAACATTCCATCAGCTTGT -> GAAGCAACATTCCATCAGCTTGTG
TGGAGCAACACCAACAGATGGGCC -> GGAGCAACACCAACAGATGGGCCC
CAATATCCCCAAATATGAGTGGGC -> AATATCCCCAAATATGAGTGGGCT
TGTGTTGTCCGCTAAACTTTGGGG -> GTGTTGTCCGCTAAACTTTGGGGC
AAACTTTGGGGCCTCTGAGAGCTG -> AACTTTGGGGCCTCTGAGAGCTGG
GTCAATTTTCCAGTTGGGAGTCGT -> TCAATTTTCCAGTTGGGAGTCGTA
ACTCCGTACAGTTTGGAATTATGA -> CTCCGTACAGTTTGGAATTATGAG
CGTTTATCTAATGACAGCTCATTA -> GTTTATCTAATGACAGCTCATTAG
ACATGGACCCTTTTCGAAGGGTGC -> CATGGACCCTTTTCGAAGGGTGCG
ATTGGCAAGGGGTTTCACTAGTTC -> TTGGCAAGGGGTTTCACTAGTTCC
GCTATTTGGCAGACGCGCTAGGAT -> CTATTTGGCAGACGCGCTAGGATT
CTCGTTTATCTAATGACAGCTCAT -> TCGTTTATCTAATGACAGCTCATT
GAGTCGGTATATCTTCCATTTTCG -> AGTCGGTATATCTTCCATTTTCGC
TGGCATAAGAGCTGCCGTATACCT -> GGCATAAGAGCTGCCGTATACCTG
CACTTACCCCTCAACTACACACGG -> ACTTACCCCTCAACTACACACGGC
TACCTGCAAGTCCACTCATCTACC -> ACCTGCAAGTCCACTCATCTACCC
ATCTACCCACAGCTTCCTCCATGT -> TCTACCCACAGCTTCCTCCATGTC
CGTACAGTTTGGAATTATGAGGAG -> GTACAGTTTGGAATTATGAGGAGT
GCCGTATACCTGCAAGTCCACTCA -> CCGTATACCTGCAAGTCCACTCAT
AGGGGTTTCACTAGTTCCTTCCGG -> GGGGTTTCACTAGTTCCTTCCGGG
ACTGCACCACCCTAACCAATGGTG -> CTGCACCACCCTAACCAATGGTGG
ATGCGTGTGATTGGCAAGGGGTTT -> TGCGTGTGATTGGCAAGGGGTTTC
AAAGACAGCCTGACCACACTCCGT -> AAGACAGCCTGACCACACTCCGTA
CTATCACGGAGCCGGGCGTTTCGA -> TATCACGGAGCCGGGCGTTTCGAC
TATCTTCCATTTTCGCATTGCATG -> ATCTTCCATTTTCGCATTGCATGC
TCTGGCTAAGACTGCACCACCCTA -> CTGGCTAAGACTGCACCACCCTAA
GGATAATTTGGCTTAACCCTCACG -> GATAATTTGGCTTAACCCTCACGA
AGAGAAGCCCACCTGATGGTGCGG -> GAGAAGCCCACCTGATGGTGCGGG
ATTGTGCCCGCTCTAACTAGTCGA -> TTGTGCCCGCTCTAACTAGTCGAT
ACTCTAAAGTCTTATAACGGCTGC -> CTCTAAAGTCTTATAACGGCTGCC
CGACGGCGTCCTTCTTCATGGGCC -> GACGGCGTCCTTCTTCATGGGCCG
GGAGTATCAGTCTTCGGAACCTCC -> GAGTATCAGTCTTCGGAACCTCCA
AGCCATGCGCTCCTAATCGCTACT -> GCCATGCGCTCCTAATCGCTACTT
GACTGCACCACCCTAACCAATGGT -> ACTGCACCACCCTAACCAATGGTG
ATTTTTTACATGACTCTAAAGTCT -> TTTTTTACATGACTCTAAAGTCTT
GAGGACGGTAGTAGCTAGACTTAG -> AGGACGGTAGTAGCTAGACTTAGC
GAAGGGTGCGAAACGACTGCGATC -> AAGGGTGCGAAACGACTGCGATCC
CACATAACCTACGGTGAAACGCGA -> ACATAACCTACGGTGAAACGCGAA
GTCGATCAAGAGCTATTTGGCAGA -> TCGATCAAGAGCTATTTGGCAGAC
TATGCTTTCTCCACAATCTATACA -> ATGCTTTCTCCACAATCTATACAA
CTGTGGGGTTCTCAATGCTTTATC -> TGTGGGGTTCTCAATGCTTTATCA
ATCTAGGACCCCTAGCCTGCGCCG -> TCTAGGACCCCTAGCCTGCGCCGG
TTTCCAGTTGGGAGTCGTAACACT -> TTCCAGTTGGGAGTCGTAACACTA
TATACAAGTAACATGTCAATTTTC -> ATACAAGTAACATGTCAATTTTCC
TCCATCAGCTTGTGATGCCATTCT -> CCATCAGCTTGTGATGCCATTCTT
GTACAGTTTGGAATTATGAGGAGT -> TACAGTTTGGAATTATGAGGAGTG
ATGGCATAAGAGCTGCCGTATACC -> TGGCATAAGAGCTGCCGTATACCT
TCCTACGATCTTTTGCCACACCTC -> CCTACGATCTTTTGCCACACCTCG
CCATGTTATTTAAATGTATACTCC -> CATGTTATTTAAATGTATACTCCG
ATGCTGCTATTATTTTTTACATGA -> TGCTGCTATTATTTTTTACATGAC
GCCGTCACCAATGCGTGTGATTGG -> CCGTCACCAATGCGTGTGATTGGC
GCTAAGACTGCACCACCCTAACCA -> CTAAGACTGCACCACCCTAACCAA
GTCACGTGTAGTGCAGACGTGTCC -> TCACGTGTAGTGCAGACGTGTCCT
CAACACCAACAGATGGGCCCCGGC -> AACACCAACAGATGGGCCCCGGCG
TGTGCACACAATGTCAGCGCCGTC -> GTGCACACAATGTCAGCGCCGTCA
ACGTTTCCGCTGTGGAAGACATTG -> CGTTTCCGCTGTGGAAGACATTGC
CGGCTCGACCAGGAGAAAACCCCC -> GGCTCGACCAGGAGAAAACCCCCC
GGAGAAAACCCCCCTATCTCGTTT -> GAGAAAACCCCCCTATCTCGTTTA
CAGTGATATGCTTTCTCCACAATC -> AGTGATATGCTTTCTCCACAATCT
CTGCACCACCCTAACCAATGGTGG -> TGCACCACCCTAACCAATGGTGGA
TACTGTGGTACATGGACCCTTTTC -> ACTGTGGTACATGGACCCTTTTCG
GGCAGTGATATGCTTTCTCCACAA -> GCAGTGATATGCTTTCTCCACAAT
CGCTTATCGGGATTATGGGTCACG -> GCTTATCGGGATTATGGGTCACGT
GGAGTGATGACATAGAGCATTGTC -> GAGTGATGACATAGAGCATTGTCT
TCTCTATAGCATTCAAAGGGGACG -> CTCTATAGCATTCAAAGGGGACGC
AGGCGGCTCCGCGATAGCGCGTTC -> GGCGGCTCCGCGATAGCGCGTTCC
TTCGGAACCTCCACCCACAGGCAG -> TCGGAACCTCCACCCACAGGCAGT
CCTGTCTACCGGGCTACGAGGGAT -> CTGTCTACCGGGCTACGAGGGATT
GGAGTTCAGGAACGAGGACGGTAG -> GAGTTCAGGAACGAGGACGGTAGT
AGCTTGTGATGCCATTCTTTCAGC -> GCTTGTGATGCCATTCTTTCAGCC
GACCCCTAGCCTGCGCCGGTATTT -> ACCCCTAGCCTGCGCCGGTATTTA
ATATCCCCAAATATGAGTGGGCTT -> TATCCCCAAATATGAGTGGGCTTG
CCGTCCTACGATCTTTTGCCACAC -> CGTCCTACGATCTTTTGCCACACC
CGTTTCGACTGTTAGTCAAATGAT -> GTTTCGACTGTTAGTCAAATGATG
CAGCTTGTGATGCCATTCTTTCAG -> AGCTTGTGATGCCATTCTTTCAGC
CCGTACAGTTTGGAATTATGAGGA -> CGTACAGTTTGGAATTATGAGGAG
AGGACCCCTAGCCTGCGCCGGTAT -> GGACCCCTAGCCTGCGCCGGTATT
CCTGTGCACACAATGTCAGCGCCG -> CTGTGCACACAATGTCAGCGCCGT
CCCACAGCTTCCTCCATGTCCGTC -> CCACAGCTTCCTCCATGTCCGTCC
TTGTTTCAAGCTGCTTTAGCCCCG -> TGTTTCAAGCTGCTTTAGCCCCGG
CCTGGAGTCGGTATATCTTCCATT -> CTGGAGTCGGTATATCTTCCATTT
AGCTCATTAGCTGTTCAAACGACC -> GCTCATTAGCTGTTCAAACGACCG
ACAGCCTGACCACACTCCGTACAG -> CAGCCTGACCACACTCCGTACAGT
TGGAGTCGGTATATCTTCCATTTT -> GGAGTCGGTATATCTTCCATTTTC
TAGAAATATGGTATGTCTGAGCAT -> AGAAATATGGTATGTCTGAGCATT
GCTAAACTTTGGGGCCTCTGAGAG -> CTAAACTTTGGGGCCTCTGAGAGC
GAGCCTCTGGCTAAGACTGCACCA -> AGCCTCTGGCTAAGACTGCACCAC
ATAGCGCAGTGGAGCAACACCAAC -> TAGCGCAGTGGAGCAACACCAACA
AGTCACCCCTGCGACGGCGTCCTT -> GTCACCCCTGCGACGGCGTCCTTC
TCTTATAACGGCTGCCAAGGCGTT -> CTTATAACGGCTGCCAAGGCGTTT
ACACCTCGGCAGTGATATGCTTTC -> CACCTCGGCAGTGATATGCTTTCT
GATCCGGCTCGACCAGGAGAAAAC -> ATCCGGCTCGACCAGGAGAAAACC
GGGTCACGTGTAGTGCAGACGTGT -> GGTCACGTGTAGTGCAGACGTGTC
TAACCAATGGTGGACATAATGGTT -> AACCAATGGTGGACATAATGGTTT
GAGCTATTTGGCAGACGCGCTAGG -> AGCTATTTGGCAGACGCGCTAGGA
CTCATGACAACACAGGATCCGGCT -> TCATGACAACACAGGATCCGGCTC
GTCCTCCCAGTCTACTGTGGTACA -> TCCTCCCAGTCTACTGTGGTACAT
CTGGCTAAGACTGCACCACCCTAA -> TGGCTAAGACTGCACCACCCTAAC
GGAGCAACACCAACAGATGGGCCC -> GAGCAACACCAACAGATGGGCCCC
TATCGGGATTATGGGTCACGTGTA -> ATCGGGATTATGGGTCACGTGTAG
TCTAAAGTCTTATAACGGCTGCCA -> CTAAAGTCTTATAACGGCTGCCAA
CATAATGGTTTCGATAGCGGCTCT -> ATAATGGTTTCGATAGCGGCTCTA
CAGCTCATTAGCTGTTCAAACGAC -> AGCTCATTAGCTGTTCAAACGACC
TTTAAATGTATACTCCGGTGTCAC -> TTAAATGTATACTCCGGTGTCACA
TATTCCCAACAATATCCCCAAATA -> ATTCCCAACAATATCCCCAAATAT
ATTTAAATGTATACTCCGGTGTCA -> TTTAAATGTATACTCCGGTGTCAC
TACCGGGCTACGAGGGATTTTAGA -> ACCGGGCTACGAGGGATTTTAGAT
CGCCCTGCGAACACCCATACTTGT -> GCCCTGCGAACACCCATACTTGTT
TCGGCAGTGATATGCTTTCTCCAC -> CGGCAGTGATATGCTTTCTCCACA
TGCGCTCCTAATCGCTACTTTTTA -> GCGCTCCTAATCGCTACTTTTTAT
TGAGGTATTTCCCATATGCAGCGT -> GAGGTATTTCCCATATGCAGCGTT
TGTAGTGCAGACGTGTCCTTACGA -> GTAGTGCAGACGTGTCCTTACGAA
ACGGTAGTAGCTAGACTTAGCTAA -> CGGTAGTAGCTAGACTTAGCTAAC
CCGAACCCTCTTGACTGTGGGGTT -> CGAACCCTCTTGACTGTGGGGTTC
TCAAGCTGCTTTAGCCCCGGGGCT -> CAAGCTGCTTTAGCCCCGGGGCTA
ATATGATCATGGAGCCCCTCTTCG -> TATGATCATGGAGCCCCTCTTCGC
CAAACACAACGCGGTCACTCTAGT -> AAACACAACGCGGTCACTCTAGTA
ATCTAATGACAGCTCATTAGCTGT -> TCTAATGACAGCTCATTAGCTGTT
CCACAGGCAGTTGGGACTTCGTAG -> CACAGGCAGTTGGGACTTCGTAGA
GTGTCCTTACGAAAGACGGGTCGC -> TGTCCTTACGAAAGACGGGTCGCT
TGTCAATTTTCCAGTTGGGAGTCG -> GTCAATTTTCCAGTTGGGAGTCGT
TAACGGGACGCGCCGAACCCTCTT -> AACGGGACGCGCCGAACCCTCTTG
CCTAAAGTAGGGAGCACGTCCTCC -> CTAAAGTAGGGAGCACGTCCTCCC
GGTATATCTTCCATTTTCGCATTG -> GTATATCTTCCATTTTCGCATTGC
CACTAGTTCCTTCCGGGGCCCGGT -> ACTAGTTCCTTCCGGGGCCCGGTT
TTAAATGTATACTCCGGTGTCACA -> TAAATGTATACTCCGGTGTCACAG
CTAGACTTAGCTAACGGGACGCGC -> TAGACTTAGCTAACGGGACGCGCC
CGATCAAGAGCTATTTGGCAGACG -> GATCAAGAGCTATTTGGCAGACGC
AACGGCAAACACAACGCGGTCACT -> ACGGCAAACACAACGCGGTCACTC
CATGGGCCGTCAATGAGGTATTTC -> ATGGGCCGTCAATGAGGTATTTCC
GGGCTACGGCAAAGACAGCCTGAC -> GGCTACGGCAAAGACAGCCTGACC
CGCCGAACCCTCTTGACTGTGGGG -> GCCGAACCCTCTTGACTGTGGGGT
CAGCCCGTTATTCCCAACAATATC -> AGCCCGTTATTCCCAACAATATCC
GGGCCCCGGCGGGGAGATGCTGCT -> GGCCCCGGCGGGGAGATGCTGCTA
AAATACCTGTGCACACAATGTCAG -> AATACCTGTGCACACAATGTCAGC
TCACGAAAGACACGTTTCCGCTGT -> CACGAAAGACACGTTTCCGCTGTG
CCAGTCTACTGTGGTACATGGACC -> CAGTCTACTGTGGTACATGGACCC
CGCTAAACTTTGGGGCCTCTGAGA -> GCTAAACTTTGGGGCCTCTGAGAG
GGTGAAACGCGAACCCTGGAGTCG -> GTGAAACGCGAACCCTGGAGTCGG
ACACTCCGTACAGTTTGGAATTAT -> CACTCCGTACAGTTTGGAATTATG
CACAGGATCCGGCTCGACCAGGAG -> ACAGGATCCGGCTCGACCAGGAGA
CTCTTGACTGTGGGGTTCTCAATG -> TCTTGACTGTGGGGTTCTCAATGC
TTTAAAAGAAGGCGGCTCCGCGAT -> TTAAAAGAAGGCGGCTCCGCGATA
GGTTCTCAATGCTTTATCATAAAA -> GTTCTCAATGCTTTATCATAAAAA
TTGCGCTTATCGGGATTATGGGTC -> TGCGCTTATCGGGATTATGGGTCA
TCTACGACGTGCTACATGGCATAA -> CTACGACGTGCTACATGGCATAAG
GAACGCCCTGCGAACACCCATACT -> AACGCCCTGCGAACACCCATACTT
CTTGCGCTTATCGGGATTATGGGT -> TTGCGCTTATCGGGATTATGGGTC
CAGTCTTCGGAACCTCCACCCACA -> AGTCTTCGGAACCTCCACCCACAG
CCCTATCTCGTTTATCTAATGACA -> CCTATCTCGTTTATCTAATGACAG
TGGGAAGCAACATTCCATCAGCTT -> GGGAAGCAACATTCCATCAGCTTG
GCAGACGTGTCCTTACGAAAGACG -> CAGACGTGTCCTTACGAAAGACGG
AACGCGAACCCTGGAGTCGGTATA -> ACGCGAACCCTGGAGTCGGTATAT
CCCTGGAGTCGGTATATCTTCCAT -> CCTGGAGTCGGTATATCTTCCATT
CATCAGCTTGTGATGCCATTCTTT -> ATCAGCTTGTGATGCCATTCTTTC
ATTAGGTTGGGAGTTCAGGAACGA -> TTAGGTTGGGAGTTCAGGAACGAG
CAGACGCGCTAGGATTTCAACGGC -> AGACGCGCTAGGATTTCAACGGCA
CCCCTCCTTACTGCACATAACCTA -> CCCTCCTTACTGCACATAACCTAC
TTTATCTAATGACAGCTCATTAGC -> TTATCTAATGACAGCTCATTAGCT
CGAGAGCGATCTAGCCATGCGCTC -> GAGAGCGATCTAGCCATGCGCTCC
TCAATGAGGTATTTCCCATATGCA -> CAATGAGGTATTTCCCATATGCAG
AGGGGAGTATCAGTCTTCGGAACC -> GGGGAGTATCAGTCTTCGGAACCT
ATGTTATTTAAATGTATACTCCGG -> TGTTATTTAAATGTATACTCCGGT
CCTGCGAACACCCATACTTGTTTC -> CTGCGAACACCCATACTTGTTTCA
AAACCCCCCTATCTCGTTTATCTA -> AACCCCCCTATCTCGTTTATCTAA
GATAGCGCAGTGGAGCAACACCAA -> ATAGCGCAGTGGAGCAACACCAAC
TAATGACAGCTCATTAGCTGTTCA -> AATGACAGCTCATTAGCTGTTCAA
GAGTGGGCTTGCGCTTATCGGGAT -> AGTGGGCTTGCGCTTATCGGGATT
TGAAACGCGAACCCTGGAGTCGGT -> GAAACGCGAACCCTGGAGTCGGTA
TAGGTACACGGTTGTGCTCCGATA -> AGGTACACGGTTGTGCTCCGATAG
TCACCCCTGCGACGGCGTCCTTCT -> CACCCCTGCGACGGCGTCCTTCTT
CAATGTCAGCGCCGTCACCAATGC -> AATGTCAGCGCCGTCACCAATGCG
GGTTGGATGCCCACAAGTTGCTTT -> GTTGGATGCCCACAAGTTGCTTTT
GAGAGCTGGATTGTGCCCGCTCTA -> AGAGCTGGATTGTGCCCGCTCTAA
CCCTGTCTACCGGGCTACGAGGGA -> CCTGTCTACCGGGCTACGAGGGAT
CAGTCTACTGTGGTACATGGACCC -> AGTCTACTGTGGTACATGGACCCT
ATTCTTGATCGATACGATTCGCGT -> TTCTTGATCGATACGATTCGCGTT
AACCCTCACGAAAGACACGTTTCC -> ACCCTCACGAAAGACACGTTTCCG
TGCTACATGGCATAAGAGCTGCCG -> GCTACATGGCATAAGAGCTGCCGT
ATATGCTTTCTCCACAATCTATAC -> TATGCTTTCTCCACAATCTATACA
TGGGACTTCGTAGACGGAGCAGAC -> GGGACTTCGTAGACGGAGCAGACA
ATTCCCAACAATATCCCCAAATAT -> TTCCCAACAATATCCCCAAATATG
TTGGCAGACGCGCTAGGATTTCAA -> TGGCAGACGCGCTAGGATTTCAAC
AGTCTACTGTGGTACATGGACCCT -> GTCTACTGTGGTACATGGACCCTT
ACACGTTTCCGCTGTGGAAGACAT -> CACGTTTCCGCTGTGGAAGACATT
CTACGGTGAAACGCGAACCCTGGA -> TACGGTGAAACGCGAACCCTGGAG
GGGATTTTAGATGCAATCGTTCTG -> GGATTTTAGATGCAATCGTTCTGC
CGTGTGGCAGCCCCCGGGACCTGC -> GTGTGGCAGCCCCCGGGACCTGCC
ATTTAAAAGAAGGCGGCTCCGCGA -> TTTAAAAGAAGGCGGCTCCGCGAT
GACGGCGTCCTTCTTCATGGGCCG -> ACGGCGTCCTTCTTCATGGGCCGT
ATCCTATAGGACACGCGGAGCCTC -> TCCTATAGGACACGCGGAGCCTCT
TGCGACTCGTGTGGCAGCCCCCGG -> GCGACTCGTGTGGCAGCCCCCGGG
AAAACCCCCCTATCTCGTTTATCT -> AAACCCCCCTATCTCGTTTATCTA
CTAGCCTGCGCCGGTATTTAAAAG -> TAGCCTGCGCCGGTATTTAAAAGA
AACGTGGAGTTGAAGGGGGATCTT -> ACGTGGAGTTGAAGGGGGATCTTC
TACGATCTTTTGCCACACCTCGGC -> ACGATCTTTTGCCACACCTCGGCA
GACACGCGGAGCCTCTGGCTAAGA -> ACACGCGGAGCCTCTGGCTAAGAC
ACGTCCTCCCAGTCTACTGTGGTA -> CGTCCTCCCAGTCTACTGTGGTAC
AAACGACCGTGCGACTCGTGTGGC -> AACGACCGTGCGACTCGTGTGGCA
AGGCAGTTGGGACTTCGTAGACGG -> GGCAGTTGGGACTTCGTAGACGGA
ATGCCCTAAAGTAGGGAGCACGTC -> TGCCCTAAAGTAGGGAGCACGTCC
CATGGCATAAGAGCTGCCGTATAC -> ATGGCATAAGAGCTGCCGTATACC
GACTTAGCTAACGGGACGCGCCGA -> ACTTAGCTAACGGGACGCGCCGAA
GGAAGACATTGCCTCATTCTTGAT -> GAAGACATTGCCTCATTCTTGATC
AATTATGAGGAGTGATGACATAGA -> ATTATGAGGAGTGATGACATAGAG
CACGTGTAGTGCAGACGTGTCCTT -> ACGTGTAGTGCAGACGTGTCCTTA
CCATACTTGTTTCAAGCTGCTTTA -> CATACTTGTTTCAAGCTGCTTTAG
GAGAAGCCCACCTGATGGTGCGGG -> AGAAGCCCACCTGATGGTGCGGGC
TGGAGTTGAAGGGGGATCTTCAAC -> GGAGTTGAAGGGGGATCTTCAACG
TTGGTTGGATGCCCACAAGTTGCT -> TGGTTGGATGCCCACAAGTTGCTT
GCGTCCTTCTTCATGGGCCGTCAA -> CGTCCTTCTTCATGGGCCGTCAAT
ATTCTTTCAGCCCGTTATTCCCAA -> TTCTTTCAGCCCGTTATTCCCAAC
GGGTCGCTCCCACGCTACGGATTA -> GGTCGCTCCCACGCTACGGATTAA
GTTCAAACGACCGTGCGACTCGTG -> TTCAAACGACCGTGCGACTCGTGT
TCAACGGAAGATTTCTATCACGGA -> CAACGGAAGATTTCTATCACGGAG
CAACTACACACGGCAGGAACGCCC -> AACTACACACGGCAGGAACGCCCT
ACTCATGACAACACAGGATCCGGC -> CTCATGACAACACAGGATCCGGCT
GGGGCCCGGTTGTAATATGATCAT -> GGGCCCGGTTGTAATATGATCATG
ACGGAGCCGGGCGTTTCGACTGTT -> CGGAGCCGGGCGTTTCGACTGTTA
TTTTAACTCATGACAACACAGGAT -> TTTAACTCATGACAACACAGGATC
CCAATGGTGGACATAATGGTTTCG -> CAATGGTGGACATAATGGTTTCGA
CCTTTTCGAAGGGTGCGAAACGAC -> CTTTTCGAAGGGTGCGAAACGACT
CGATAGCGCGTTCCTCAAAGTTGA -> GATAGCGCGTTCCTCAAAGTTGAG
CTACATGGCATAAGAGCTGCCGTA -> TACATGGCATAAGAGCTGCCGTAT
AACCCCCCTATCTCGTTTATCTAA -> ACCCCCCTATCTCGTTTATCTAAT
TGGGGTTCTCAATGCTTTATCATA -> GGGGTTCTCAATGCTTTATCATAA
TGGGGCCTCTGAGAGCTGGATTGT -> GGGGCCTCTGAGAGCTGGATTGTG
GTGTGATTGGCAAGGGGTTTCACT -> TGTGATTGGCAAGGGGTTTCACTA
TCCCGGAGTCACCCCTGCGACGGC -> CCCGGAGTCACCCCTGCGACGGCG
ACGTGTCCTTACGAAAGACGGGTC -> CGTGTCCTTACGAAAGACGGGTCG
TCCCCTCCTTACTGCACATAACCT -> CCCCTCCTTACTGCACATAACCTA
TTCAACGGCAAACACAACGCGGTC -> TCAACGGCAAACACAACGCGGTCA
GTCGGTATATCTTCCATTTTCGCA -> TCGGTATATCTTCCATTTTCGCAT
GGATTATGGGTCACGTGTAGTGCA -> GATTATGGGTCACGTGTAGTGCAG
GATCGATACGATTCGCGTTGTCCC -> ATCGATACGATTCGCGTTGTCCCC
CGACTCGTGTGGCAGCCCCCGGGA -> GACTCGTGTGGCAGCCCCCGGGAC
GTTGCTTTTATCTAGGACCCCTAG -> TTGCTTTTATCTAGGACCCCTAGC
CGGTAGTAGCTAGACTTAGCTAAC -> GGTAGTAGCTAGACTTAGCTAACG
AGTAGGGAGCACGTCCTCCCAGTC -> GTAGGGAGCACGTCCTCCCAGTCT
ATTAGCTGTTCAAACGACCGTGCG -> TTAGCTGTTCAAACGACCGTGCGA
GTGCGCCGATGCCCTAAAGTAGGG -> TGCGCCGATGCCCTAAAGTAGGGA
ATCATGGAGCCCCTCTTCGCCATC -> TCATGGAGCCCCTCTTCGCCATCA
AGCCCCCGGGACCTGCCGAGAGCG -> GCCCCCGGGACCTGCCGAGAGCGA
GGGCCCGGTTGTAATATGATCATG -> GGCCCGGTTGTAATATGATCATGG
CTCTAGTAAATACCTGTGCACACA -> TCTAGTAAATACCTGTGCACACAA
ACTGTTAGTCAAATGATGGATCCT -> CTGTTAGTCAAATGATGGATCCTA
TGCTATTATTTTTTACATGACTCT -> GCTATTATTTTTTACATGACTCTA
GCGGGATAATTTGGCTTAACCCTC -> CGGGATAATTTGGCTTAACCCTCA
GAGCGATCTAGCCATGCGCTCCTA -> AGCGATCTAGCCATGCGCTCCTAA
TCGCTCCCACGCTACGGATTAACA -> CGCTCCCACGCTACGGATTAACAA
TACATGGACCCTTTTCGAAGGGTG -> ACATGGACCCTTTTCGAAGGGTGC
CCCCTAGCCTGCGCCGGTATTTAA -> CCCTAGCCTGCGCCGGTATTTAAA
CACGGTTGTGCTCCGATAGCGCAG -> ACGGTTGTGCTCCGATAGCGCAGT
GTGCCCTGTCTACCGGGCTACGAG -> TGCCCTGTCTACCGGGCTACGAGG
GCTTTCTCCACAATCTATACAAGT -> CTTTCTCCACAATCTATACAAGTA
ACCTGCAAGTCCACTCATCTACCC -> CCTGCAAGTCCACTCATCTACCCA
TGTTCAAACGACCGTGCGACTCGT -> GTTCAAACGACCGTGCGACTCGTG
AATTTTCCAGTTGGGAGTCGTAAC -> ATTTTCCAGTTGGGAGTCGTAACA
CTCAAAGTTGAGGGGAGTATCAGT -> TCAAAGTTGAGGGGAGTATCAGTC
TGTGCTCCGATAGCGCAGTGGAGC -> GTGCTCCGATAGCGCAGTGGAGCA
CTAACGGGACGCGCCGAACCCTCT -> TAACGGGACGCGCCGAACCCTCTT
CTCGACCAGGAGAAAACCCCCCTA -> TCGACCAGGAGAAAACCCCCCTAT
TTATGGGTCACGTGTAGTGCAGAC -> TATGGGTCACGTGTAGTGCAGACG
GGCTCTACGACGTGCTACATGGCA -> GCTCTACGACGTGCTACATGGCAT
GCCGGTATTTAAAAGAAGGCGGCT -> CCGGTATTTAAAAGAAGGCGGCTC
CACACTCCGTACAGTTTGGAATTA -> ACACTCCGTACAGTTTGGAATTAT
AAGACTGCACCACCCTAACCAATG -> AGACTGCACCACCCTAACCAATGG
TCGCCATCAGCAGACCATGTTATT -> CGCCATCAGCAGACCATGTTATTT
GACATTGCCTCATTCTTGATCGAT -> ACATTGCCTCATTCTTGATCGATA
GGCTAAGACTGCACCACCCTAACC -> GCTAAGACTGCACCACCCTAACCA
CCTGCGACGGCGTCCTTCTTCATG -> CTGCGACGGCGTCCTTCTTCATGG
CGCTAGGATTTCAACGGCAAACAC -> GCTAGGATTTCAACGGCAAACACA
CTGGATTGTGCCCGCTCTAACTAG -> TGGATTGTGCCCGCTCTAACTAGT
AATATGGTATGTCTGAGCATTAGT -> ATATGGTATGTCTGAGCATTAGTG
AATCCCGGAGTCACCCCTGCGACG -> ATCCCGGAGTCACCCCTGCGACGG
ACGCGCCGAACCCTCTTGACTGTG -> CGCGCCGAACCCTCTTGACTGTGG
GTGATTGGCAAGGGGTTTCACTAG -> TGATTGGCAAGGGGTTTCACTAGT
ACGGAAGATTTCTATCACGGAGCC -> CGGAAGATTTCTATCACGGAGCCG
ATTCCATCAGCTTGTGATGCCATT -> TTCCATCAGCTTGTGATGCCATTC
TTGTCCGCTAAACTTTGGGGCCTC -> TGTCCGCTAAACTTTGGGGCCTCT
AGAGCTATTTGGCAGACGCGCTAG -> GAGCTATTTGGCAGACGCGCTAGG
AAACGCGAACCCTGGAGTCGGTAT -> AACGCGAACCCTGGAGTCGGTATA
ATAATGGTTTCGATAGCGGCTCTA -> TAATGGTTTCGATAGCGGCTCTAC
CGGAGCCGGGCGTTTCGACTGTTA -> GGAGCCGGGCGTTTCGACTGTTAG
CATGAACGTGGAGTTGAAGGGGGA -> ATGAACGTGGAGTTGAAGGGGGAT
ACGACGTGCTACATGGCATAAGAG -> CGACGTGCTACATGGCATAAGAGC
TAAGACTGCACCACCCTAACCAAT -> AAGACTGCACCACCCTAACCAATG
TGCGTGTGATTGGCAAGGGGTTTC -> GCGTGTGATTGGCAAGGGGTTTCA
AATCTATACAAGTAACATGTCAAT -> ATCTATACAAGTAACATGTCAATT
GCCACTTTTAAACCTTGTGTTGTC -> CCACTTTTAAACCTTGTGTTGTCC
ACAAGTTGCTTTTATCTAGGACCC -> CAAGTTGCTTTTATCTAGGACCCC
ACCTCCACCCACAGGCAGTTGGGA -> CCTCCACCCACAGGCAGTTGGGAC
AATGATGGATCCTATAGGACACGC -> ATGATGGATCCTATAGGACACGCG
GATCTTTTGCCACACCTCGGCAGT -> ATCTTTTGCCACACCTCGGCAGTG
TAACATGTCAATTTTCCAGTTGGG -> AACATGTCAATTTTCCAGTTGGGA
CAATTGGTTGGATGCCCACAAGTT -> AATTGGTTGGATGCCCACAAGTTG
CCACCCTAACCAATGGTGGACATA -> CACCCTAACCAATGGTGGACATAA
CTTTAGCCCCGGGGCTACGGCAAA -> TTTAGCCCCGGGGCTACGGCAAAG
TCCTAATCGCTACTTTTTATGGGA -> CCTAATCGCTACTTTTTATGGGAA
TCTTCCATTTTCGCATTGCATGCA -> CTTCCATTTTCGCATTGCATGCAT
TTAGCTGTTCAAACGACCGTGCGA -> TAGCTGTTCAAACGACCGTGCGAC
ATCATAAAAACTAGGTACACGGTT -> TCATAAAAACTAGGTACACGGTTG
CTTATCGGGATTATGGGTCACGTG -> TTATCGGGATTATGGGTCACGTGT
GCGACGGCGTCCTTCTTCATGGGC -> CGACGGCGTCCTTCTTCATGGGCC
TACGATTCGCGTTGTCCCCTCCTT -> ACGATTCGCGTTGTCCCCTCCTTA
TATGAGTGGGCTTGCGCTTATCGG -> ATGAGTGGGCTTGCGCTTATCGGG
GCTACTTTTTATGGGAAGCAACAT -> CTACTTTTTATGGGAAGCAACATT
ATCTCGTTTATCTAATGACAGCTC -> TCTCGTTTATCTAATGACAGCTCA
CGTTCGCGATGCAGCGGGATAATT -> GTTCGCGATGCAGCGGGATAATTT
TGTTTCAAGCTGCTTTAGCCCCGG -> GTTTCAAGCTGCTTTAGCCCCGGG
TGAATCCCGGAGTCACCCCTGCGA -> GAATCCCGGAGTCACCCCTGCGAC
CATGGACCCTTTTCGAAGGGTGCG -> ATGGACCCTTTTCGAAGGGTGCGA
GGGCTGGGGTGCGCCGATGCCCTA -> GGCTGGGGTGCGCCGATGCCCTAA
CATCTACCCACAGCTTCCTCCATG -> ATCTACCCACAGCTTCCTCCATGT
GACATAATGGTTTCGATAGCGGCT -> ACATAATGGTTTCGATAGCGGCTC
GGTAGTAGCTAGACTTAGCTAACG -> GTAGTAGCTAGACTTAGCTAACGG
ATGCAGCGTTCGCGATGCAGCGGG -> TGCAGCGTTCGCGATGCAGCGGGA
GCAGTGGAGCAACACCAACAGATG -> CAGTGGAGCAACACCAACAGATGG
CTGCCAAGGCGTTTTAACTCATGA -> TGCCAAGGCGTTTTAACTCATGAC
GCCATTCTTTCAGCCCGTTATTCC -> CCATTCTTTCAGCCCGTTATTCCC
GTAGCTAGACTTAGCTAACGGGAC -> TAGCTAGACTTAGCTAACGGGACG
TGTCCGCTAAACTTTGGGGCCTCT -> GTCCGCTAAACTTTGGGGCCTCTG
TAGGACACGCGGAGCCTCTGGCTA -> AGGACACGCGGAGCCTCTGGCTAA
TCTTCGGAACCTCCACCCACAGGC -> CTTCGGAACCTCCACCCACAGGCA
CTAATGACAGCTCATTAGCTGTTC -> TAATGACAGCTCATTAGCTGTTCA
TGATGCCATTCTTTCAGCCCGTTA -> GATGCCATTCTTTCAGCCCGTTAT
ACCCCTAGCCTGCGCCGGTATTTA -> CCCCTAGCCTGCGCCGGTATTTAA
GGACCCTTTTCGAAGGGTGCGAAA -> GACCCTTTTCGAAGGGTGCGAAAC
CATTTTCGCATTGCATGCATGAAC -> ATTTTCGCATTGCATGCATGAACG
CGCCACTTTTAAACCTTGTGTTGT -> GCCACTTTTAAACCTTGTGTTGTC
CGGCAAACACAACGCGGTCACTCT -> GGCAAACACAACGCGGTCACTCTA
CTCTGAGAGCTGGATTGTGCCCGC -> TCTGAGAGCTGGATTGTGCCCGCT
AGCTGTTCAAACGACCGTGCGACT -> GCTGTTCAAACGACCGTGCGACTC
GACTGTGGGGTTCTCAATGCTTTA -> ACTGTGGGGTTCTCAATGCTTTAT
GCGGGCTGGGGTGCGCCGATGCCC -> CGGGCTGGGGTGCGCCGATGCCCT
CCTCCATGTCCGTCCTACGATCTT -> CTCCATGTCCGTCCTACGATCTTT
CCCTAGCCTGCGCCGGTATTTAAA -> CCTAGCCTGCGCCGGTATTTAAAA
TATGCAGCGTTCGCGATGCAGCGG -> ATGCAGCGTTCGCGATGCAGCGGG
ATGCAGCGGGATAATTTGGCTTAA -> TGCAGCGGGATAATTTGGCTTAAC
GCAAGGGGTTTCACTAGTTCCTTC -> CAAGGGGTTTCACTAGTTCCTTCC
GGTGCGAAACGACTGCGATCCGCA -> GTGCGAAACGACTGCGATCCGCAC
GGGACTTCGTAGACGGAGCAGACA -> GGACTTCGTAGACGGAGCAGACAA
ACCAATGGTGGACATAATGGTTTC -> CCAATGGTGGACATAATGGTTTCG
AGACGGAGCAGACAAATGAATCCC -> GACGGAGCAGACAAATGAATCCCG
CTTCCATTTTCGCATTGCATGCAT -> TTCCATTTTCGCATTGCATGCATG
CCCGGGACCTGCCGAGAGCGATCT -> CCGGGACCTGCCGAGAGCGATCTA
ACGGGACGCGCCGAACCCTCTTGA -> CGGGACGCGCCGAACCCTCTTGAC
GGGGAGATGCTGCTATTATTTTTT -> GGGAGATGCTGCTATTATTTTTTA
CGGCTCCGCGATAGCGCGTTCCTC -> GGCTCCGCGATAGCGCGTTCCTCA
CTGCCGTATACCTGCAAGTCCACT -> TGCCGTATACCTGCAAGTCCACTC
GAGTGATGACATAGAGCATTGTCT -> AGTGATGACATAGAGCATTGTCTT
TGTATACTCCGGTGTCACAGAGAA -> GTATACTCCGGTGTCACAGAGAAG
GCGGCTCTACGACGTGCTACATGG -> CGGCTCTACGACGTGCTACATGGC
TAGCTAGACTTAGCTAACGGGACG -> AGCTAGACTTAGCTAACGGGACGC
AATGACAGCTCATTAGCTGTTCAA -> ATGACAGCTCATTAGCTGTTCAAA
ATCGGGATTATGGGTCACGTGTAG -> TCGGGATTATGGGTCACGTGTAGT
GATAGCGGCTCTACGACGTGCTAC -> ATAGCGGCTCTACGACGTGCTACA
TACTGCACATAACCTACGGTGAAA -> ACTGCACATAACCTACGGTGAAAC
CGGTATTTAAAAGAAGGCGGCTCC -> GGTATTTAAAAGAAGGCGGCTCCG
TTGGATGCCCACAAGTTGCTTTTA -> TGGATGCCCACAAGTTGCTTTTAT
ACTAGTTCCTTCCGGGGCCCGGTT -> CTAGTTCCTTCCGGGGCCCGGTTG
CACTTTTAAACCTTGTGTTGTCCG -> ACTTTTAAACCTTGTGTTGTCCGC
AGGCGTTTTAACTCATGACAACAC -> GGCGTTTTAACTCATGACAACACA
ACGAAAGACGGGTCGCTCCCACGC -> CGAAAGACGGGTCGCTCCCACGCT
CGCTCCCACGCTACGGATTAACAA -> GCTCCCACGCTACGGATTAACAAG
CGCGGTCACTCTAGTAAATACCTG -> GCGGTCACTCTAGTAAATACCTGT
CACACAATGTCAGCGCCGTCACCA -> ACACAATGTCAGCGCCGTCACCAA
CTAGGTACACGGTTGTGCTCCGAT -> TAGGTACACGGTTGTGCTCCGATA
GTGCGGGCTGGGGTGCGCCGATGC -> TGCGGGCTGGGGTGCGCCGATGCC
GATTTCAACGGCAAACACAACGCG -> ATTTCAACGGCAAACACAACGCGG
ACGATTCGCGTTGTCCCCTCCTTA -> CGATTCGCGTTGTCCCCTCCTTAC
CGATACGATTCGCGTTGTCCCCTC -> GATACGATTCGCGTTGTCCCCTCC
ACGAAAGACACGTTTCCGCTGTGG -> CGAAAGACACGTTTCCGCTGTGGA
ATACGATTCGCGTTGTCCCCTCCT -> TACGATTCGCGTTGTCCCCTCCTT
TAGCCCCGGGGCTACGGCAAAGAC -> AGCCCCGGGGCTACGGCAAAGACA
ACTCGTGTGGCAGCCCCCGGGACC -> CTCGTGTGGCAGCCCCCGGGACCT
TGCATGCATGAACGTGGAGTTGAA -> GCATGCATGAACGTGGAGTTGAAG
AATGTCAGCGCCGTCACCAATGCG -> ATGTCAGCGCCGTCACCAATGCGT
GTCACCAATGCGTGTGATTGGCAA -> TCACCAATGCGTGTGATTGGCAAG
AGCGGGATAATTTGGCTTAACCCT -> GCGGGATAATTTGGCTTAACCCTC
CTAGGATTTCAACGGCAAACACAA -> TAGGATTTCAACGGCAAACACAAC
CTCTATAGCATTCAAAGGGGACGC -> TCTATAGCATTCAAAGGGGACGCG
AATGCTTTATCATAAAAACTAGGT -> ATGCTTTATCATAAAAACTAGGTA
AACGCCCTGCGAACACCCATACTT -> ACGCCCTGCGAACACCCATACTTG
CAGCGTTCGCGATGCAGCGGGATA -> AGCGTTCGCGATGCAGCGGGATAA
CGTCCTACGATCTTTTGCCACACC -> GTCCTACGATCTTTTGCCACACCT
GATCCGCACTCATTAGGTTGGGAG -> ATCCGCACTCATTAGGTTGGGAGT
CCTCCTGTCACACTTACCCCTCAA -> CTCCTGTCACACTTACCCCTCAAC
TCTACCCACAGCTTCCTCCATGTC -> CTACCCACAGCTTCCTCCATGTCC
ACTCATTAGGTTGGGAGTTCAGGA -> CTCATTAGGTTGGGAGTTCAGGAA
GCTCATTAGCTGTTCAAACGACCG -> CTCATTAGCTGTTCAAACGACCGT
CTTTCTCCACAATCTATACAAGTA -> TTTCTCCACAATCTATACAAGTAA
AGAGCTGGATTGTGCCCGCTCTAA -> GAGCTGGATTGTGCCCGCTCTAAC
GTCCTTACGAAAGACGGGTCGCTC -> TCCTTACGAAAGACGGGTCGCTCC
TCACCAATGCGTGTGATTGGCAAG -> CACCAATGCGTGTGATTGGCAAGG
GGGGTGCGCCGATGCCCTAAAGTA -> GGGTGCGCCGATGCCCTAAAGTAG
ACCATGTTATTTAAATGTATACTC -> CCATGTTATTTAAATGTATACTCC
AACACAACGCGGTCACTCTAGTAA -> ACACAACGCGGTCACTCTAGTAAA
CTTACTGCACATAACCTACGGTGA -> TTACTGCACATAACCTACGGTGAA
GCGCTCCTAATCGCTACTTTTTAT -> CGCTCCTAATCGCTACTTTTTATG
TCTTCATGGGCCGTCAATGAGGTA -> CTTCATGGGCCGTCAATGAGGTAT
AACGGGACGCGCCGAACCCTCTTG -> ACGGGACGCGCCGAACCCTCTTGA
GTTTATCTAATGACAGCTCATTAG -> TTTATCTAATGACAGCTCATTAGC
CTGCGATCCGCACTCATTAGGTTG -> TGCGATCCGCACTCATTAGGTTGG
GTGCAGACGTGTCCTTACGAAAGA -> TGCAGACGTGTCCTTACGAAAGAC
ACCCACAGCTTCCTCCATGTCCGT -> CCCACAGCTTCCTCCATGTCCGTC
AGACAGCCTGACCACACTCCGTAC -> GACAGCCTGACCACACTCCGTACA
TTTGGAATTATGAGGAGTGATGAC -> TTGGAATTATGAGGAGTGATGACA
CCCTCAACTACACACGGCAGGAAC -> CCTCAACTACACACGGCAGGAACG
AGTCGTAACACTAGAAATATGGTA -> GTCGTAACACTAGAAATATGGTAT
ACGAGGGATTTTAGATGCAATCGT -> CGAGGGATTTTAGATGCAATCGTT
TTAAAAGAAGGCGGCTCCGCGATA -> TAAAAGAAGGCGGCTCCGCGATAG
TGGGCCGTCAATGAGGTATTTCCC -> GGGCCGTCAATGAGGTATTTCCCA
GCTGCCGTATACCTGCAAGTCCAC -> CTGCCGTATACCTGCAAGTCCACT
GAATCCCGGAGTCACCCCTGCGAC -> AATCCCGGAGTCACCCCTGCGACG
CTTACCCCTCAACTACACACGGCA -> TTACCCCTCAACTACACACGGCAG
AGCGCAGTGGAGCAACACCAACAG -> GCGCAGTGGAGCAACACCAACAGA
TAAATGTATACTCCGGTGTCACAG -> AAATGTATACTCCGGTGTCACAGA
CCTCTGAGAGCTGGATTGTGCCCG -> CTCTGAGAGCTGGATTGTGCCCGC
CTAGTTCCTTCCGGGGCCCGGTTG -> TAGTTCCTTCCGGGGCCCGGTTGT
GCTAGACTTAGCTAACGGGACGCG -> CTAGACTTAGCTAACGGGACGCGC
TTGACTGTGGGGTTCTCAATGCTT -> TGACTGTGGGGTTCTCAATGCTTT
TGATGGATCCTATAGGACACGCGG -> GATGGATCCTATAGGACACGCGGA
CGCCGGTATTTAAAAGAAGGCGGC -> GCCGGTATTTAAAAGAAGGCGGCT
ACTTCGTAGACGGAGCAGACAAAT -> CTTCGTAGACGGAGCAGACAAATG
TGCAATCGTTCTGCGAATCAATTG -> GCAATCGTTCTGCGAATCAATTGG
TGAAGGGGGATCTTCAACGGAAGA -> GAAGGGGGATCTTCAACGGAAGAT
TACAGTTTGGAATTATGAGGAGTG -> ACAGTTTGGAATTATGAGGAGTGA
TCATTCTTGATCGATACGATTCGC -> CATTCTTGATCGATACGATTCGCG
GTTGAGGGGAGTATCAGTCTTCGG -> TTGAGGGGAGTATCAGTCTTCGGA
CCACAGCTTCCTCCATGTCCGTCC -> CACAGCTTCCTCCATGTCCGTCCT
GTAGGGAGCACGTCCTCCCAGTCT -> TAGGGAGCACGTCCTCCCAGTCTA
GGAGCCTCTGGCTAAGACTGCACC -> GAGCCTCTGGCTAAGACTGCACCA
ATGAACGTGGAGTTGAAGGGGGAT -> TGAACGTGGAGTTGAAGGGGGATC
TTATTCCCAACAATATCCCCAAAT -> TATTCCCAACAATATCCCCAAATA
TCGAAGGGTGCGAAACGACTGCGA -> CGAAGGGTGCGAAACGACTGCGAT
GTGCTCCGATAGCGCAGTGGAGCA -> TGCTCCGATAGCGCAGTGGAGCAA
CGTGTGATTGGCAAGGGGTTTCAC -> GTGTGATTGGCAAGGGGTTTCACT
ATTGCCTCATTCTTGATCGATACG -> TTGCCTCATTCTTGATCGATACGA
AATCAATTGGTTGGATGCCCACAA -> ATCAATTGGTTGGATGCCCACAAG
AAGTTGCTTTTATCTAGGACCCCT -> AGTTGCTTTTATCTAGGACCCCTA
GATGCCCTAAAGTAGGGAGCACGT -> ATGCCCTAAAGTAGGGAGCACGTC
GCCCCTCTTCGCCATCAGCAGACC -> CCCCTCTTCGCCATCAGCAGACCA
CGTCCTTCTTCATGGGCCGTCAAT -> GTCCTTCTTCATGGGCCGTCAATG
GTGGAGCAACACCAACAGATGGGC -> TGGAGCAACACCAACAGATGGGCC
GGATTTCAACGGCAAACACAACGC -> GATTTCAACGGCAAACACAACGCG
GCGAATCAATTGGTTGGATGCCCA -> CGAATCAATTGGTTGGATGCCCAC
CAACAATATCCCCAAATATGAGTG -> AACAATATCCCCAAATATGAGTGG
TAACAAGCATGCGTTCCTCCTGTC -> AACAAGCATGCGTTCCTCCTGTCA
AAGACATTGCCTCATTCTTGATCG -> AGACATTGCCTCATTCTTGATCGA
GTACACGGTTGTGCTCCGATAGCG -> TACACGGTTGTGCTCCGATAGCGC
TTTTTATGGGAAGCAACATTCCAT -> TTTTATGGGAAGCAACATTCCATC
TACACACGGCAGGAACGCCCTGCG -> ACACACGGCAGGAACGCCCTGCGA
GGCTGGGGTGCGCCGATGCCCTAA -> GCTGGGGTGCGCCGATGCCCTAAA
GTAAATACCTGTGCACACAATGTC -> TAAATACCTGTGCACACAATGTCA
TAGCATTCAAAGGGGACGCGCCAC -> AGCATTCAAAGGGGACGCGCCACT
TGCGATCCGCACTCATTAGGTTGG -> GCGATCCGCACTCATTAGGTTGGG
GGGAGTTCAGGAACGAGGACGGTA -> GGAGTTCAGGAACGAGGACGGTAG
AGCATGCGTTCCTCCTGTCACACT -> GCATGCGTTCCTCCTGTCACACTT
GAGTTCAGGAACGAGGACGGTAGT -> AGTTCAGGAACGAGGACGGTAGTA
GTCCTACGATCTTTTGCCACACCT -> TCCTACGATCTTTTGCCACACCTC
ACATAATGGTTTCGATAGCGGCTC -> CATAATGGTTTCGATAGCGGCTCT
GGCGGCTCCGCGATAGCGCGTTCC -> GCGGCTCCGCGATAGCGCGTTCCT
TGGTGGACATAATGGTTTCGATAG -> GGTGGACATAATGGTTTCGATAGC
TTTTATCTAGGACCCCTAGCCTGC -> TTTATCTAGGACCCCTAGCCTGCG
ACTTTGGGGCCTCTGAGAGCTGGA -> CTTTGGGGCCTCTGAGAGCTGGAT
AAAAACTAGGTACACGGTTGTGCT -> AAAACTAGGTACACGGTTGTGCTC
AGAAAACCCCCCTATCTCGTTTAT -> GAAAACCCCCCTATCTCGTTTATC
TCAAACGACCGTGCGACTCGTGTG -> CAAACGACCGTGCGACTCGTGTGG
TCTTTCAGCCCGTTATTCCCAACA -> CTTTCAGCCCGTTATTCCCAACAA
TGAGGGGAGTATCAGTCTTCGGAA -> GAGGGGAGTATCAGTCTTCGGAAC
ACTAGTCGATCAAGAGCTATTTGG -> CTAGTCGATCAAGAGCTATTTGGC
GACATAGAGCATTGTCTTGTGCCC -> ACATAGAGCATTGTCTTGTGCCCT
ACAATCTATACAAGTAACATGTCA -> CAATCTATACAAGTAACATGTCAA
AAAGAAGGCGGCTCCGCGATAGCG -> AAGAAGGCGGCTCCGCGATAGCGC
TATCATAAAAACTAGGTACACGGT -> ATCATAAAAACTAGGTACACGGTT
GGATTTTAGATGCAATCGTTCTGC -> GATTTTAGATGCAATCGTTCTGCG
TACAAGTAACATGTCAATTTTCCA -> ACAAGTAACATGTCAATTTTCCAG
AGACGCGCTAGGATTTCAACGGCA -> GACGCGCTAGGATTTCAACGGCAA
TAGTAAATACCTGTGCACACAATG -> AGTAAATACCTGTGCACACAATGT
CGCGTTGTCCCCTCCTTACTGCAC -> GCGTTGTCCCCTCCTTACTGCACA
GTAACACTAGAAATATGGTATGTC -> TAACACTAGAAATATGGTATGTCT
TCGGGATTATGGGTCACGTGTAGT -> CGGGATTATGGGTCACGTGTAGTG
TATCAGTCTTCGGAACCTCCACCC -> ATCAGTCTTCGGAACCTCCACCCA
GTATCAGTCTTCGGAACCTCCACC -> TATCAGTCTTCGGAACCTCCACCC
TTCAAACGACCGTGCGACTCGTGT -> TCAAACGACCGTGCGACTCGTGTG
TTTTTTACATGACTCTAAAGTCTT -> TTTTTACATGACTCTAAAGTCTTA
TTCCCATATGCAGCGTTCGCGATG -> TCCCATATGCAGCGTTCGCGATGC
GACTCGTGTGGCAGCCCCCGGGAC -> ACTCGTGTGGCAGCCCCCGGGACC
CTGCTTTAGCCCCGGGGCTACGGC -> TGCTTTAGCCCCGGGGCTACGGCA
ACCCTCACGAAAGACACGTTTCCG -> CCCTCACGAAAGACACGTTTCCGC
GCCCGCTCTAACTAGTCGATCAAG -> CCCGCTCTAACTAGTCGATCAAGA
TCCGGCTCGACCAGGAGAAAACCC -> CCGGCTCGACCAGGAGAAAACCCC
ATAACCTACGGTGAAACGCGAACC -> TAACCTACGGTGAAACGCGAACCC
ATTCGCGTTGTCCCCTCCTTACTG -> TTCGCGTTGTCCCCTCCTTACTGC
TACCTGTGCACACAATGTCAGCGC -> ACCTGTGCACACAATGTCAGCGCC
AGGAGTGATGACATAGAGCATTGT -> GGAGTGATGACATAGAGCATTGTC
GGGAGATGCTGCTATTATTTTTTA -> GGAGATGCTGCTATTATTTTTTAC
ACAGGATCCGGCTCGACCAGGAGA -> CAGGATCCGGCTCGACCAGGAGAA
GTTTCCGCTGTGGAAGACATTGCC -> TTTCCGCTGTGGAAGACATTGCCT
GGATGCCCACAAGTTGCTTTTATC -> GATGCCCACAAGTTGCTTTTATCT
ATGGACCCTTTTCGAAGGGTGCGA -> TGGACCCTTTTCGAAGGGTGCGAA
TCACTCTAGTAAATACCTGTGCAC -> CACTCTAGTAAATACCTGTGCACA
CAAGCATGCGTTCCTCCTGTCACA -> AAGCATGCGTTCCTCCTGTCACAC
TTTCAAGCTGCTTTAGCCCCGGGG -> TTCAAGCTGCTTTAGCCCCGGGGC
CCTTGTGTTGTCCGCTAAACTTTG -> CTTGTGTTGTCCGCTAAACTTTGG
GTGGCAGCCCCCGGGACCTGCCGA -> TGGCAGCCCCCGGGACCTGCCGAG
TAGAGCATTGTCTTGTGCCCTGTC -> AGAGCATTGTCTTGTGCCCTGTCT
ATACCTGCAAGTCCACTCATCTAC -> TACCTGCAAGTCCACTCATCTACC
AGCGGCTCTACGACGTGCTACATG -> GCGGCTCTACGACGTGCTACATGG
CGGATTAACAAGCATGCGTTCCTC -> GGATTAACAAGCATGCGTTCCTCC
CCATCAGCAGACCATGTTATTTAA -> CATCAGCAGACCATGTTATTTAAA
AACATGTCAATTTTCCAGTTGGGA -> ACATGTCAATTTTCCAGTTGGGAG
CCGGTGTCACAGAGAAGCCCACCT -> CGGTGTCACAGAGAAGCCCACCTG
GCTGTTCAAACGACCGTGCGACTC -> CTGTTCAAACGACCGTGCGACTCG
ATACTCCGGTGTCACAGAGAAGCC -> TACTCCGGTGTCACAGAGAAGCCC
ATCTTTTGCCACACCTCGGCAGTG -> TCTTTTGCCACACCTCGGCAGTGA
GCGCTTATCGGGATTATGGGTCAC -> CGCTTATCGGGATTATGGGTCACG
TTATTTTTTACATGACTCTAAAGT -> TATTTTTTACATGACTCTAAAGTC
TTGTCCCCTCCTTACTGCACATAA -> TGTCCCCTCCTTACTGCACATAAC
ACCCCTCAACTACACACGGCAGGA -> CCCCTCAACTACACACGGCAGGAA
ACGGGTCGCTCCCACGCTACGGAT -> CGGGTCGCTCCCACGCTACGGATT
GAACGAGGACGGTAGTAGCTAGAC -> AACGAGGACGGTAGTAGCTAGACT
AGCAGACAAATGAATCCCGGAGTC -> GCAGACAAATGAATCCCGGAGTCA
GTGATATGCTTTCTCCACAATCTA -> TGATATGCTTTCTCCACAATCTAT
CCACACCTCGGCAGTGATATGCTT -> CACACCTCGGCAGTGATATGCTTT
GAGGGATTTTAGATGCAATCGTTC -> AGGGATTTTAGATGCAATCGTTCT
CCCTTTTCGAAGGGTGCGAAACGA -> CCTTTTCGAAGGGTGCGAAACGAC
ACCCTGGAGTCGGTATATCTTCCA -> CCCTGGAGTCGGTATATCTTCCAT
TACATGGCATAAGAGCTGCCGTAT -> ACATGGCATAAGAGCTGCCGTATA
AAGAAGGCGGCTCCGCGATAGCGC -> AGAAGGCGGCTCCGCGATAGCGCG
TCAGCTTGTGATGCCATTCTTTCA -> CAGCTTGTGATGCCATTCTTTCAG
GCCTCTGGCTAAGACTGCACCACC -> CCTCTGGCTAAGACTGCACCACCC
ATTTTCCAGTTGGGAGTCGTAACA -> TTTTCCAGTTGGGAGTCGTAACAC
TTCACTAGTTCCTTCCGGGGCCCG -> TCACTAGTTCCTTCCGGGGCCCGG
CTCAACTACACACGGCAGGAACGC -> TCAACTACACACGGCAGGAACGCC
GAGGGGAGTATCAGTCTTCGGAAC -> AGGGGAGTATCAGTCTTCGGAACC
CCGTCACCAATGCGTGTGATTGGC -> CGTCACCAATGCGTGTGATTGGCA
AAGTAGGGAGCACGTCCTCCCAGT -> AGTAGGGAGCACGTCCTCCCAGTC
AAGGGGTTTCACTAGTTCCTTCCG -> AGGGGTTTCACTAGTTCCTTCCGG
TAACCTACGGTGAAACGCGAACCC -> AACCTACGGTGAAACGCGAACCCT
ATTAACAAGCATGCGTTCCTCCTG -> TTAACAAGCATGCGTTCCTCCTGT
ATAACGGCTGCCAAGGCGTTTTAA -> TAACGGCTGCCAAGGCGTTTTAAC
CCCCTGCGACGGCGTCCTTCTTCA -> CCCTGCGACGGCGTCCTTCTTCAT
GATTTTAGATGCAATCGTTCTGCG -> ATTTTAGATGCAATCGTTCTGCGA
CTCCGTACAGTTTGGAATTATGAG -> TCCGTACAGTTTGGAATTATGAGG
GTGGAAGACATTGCCTCATTCTTG -> TGGAAGACATTGCCTCATTCTTGA
GGCGGGGAGATGCTGCTATTATTT -> GCGGGGAGATGCTGCTATTATTTT
CGGGATTATGGGTCACGTGTAGTG -> GGGATTATGGGTCACGTGTAGTGC
TGGGAGTCGTAACACTAGAAATAT -> GGGAGTCGTAACACTAGAAATATG
CGTGCGACTCGTGTGGCAGCCCCC -> GTGCGACTCGTGTGGCAGCCCCCG
GGCATAAGAGCTGCCGTATACCTG -> GCATAAGAGCTGCCGTATACCTGC
CCCCTATCTCGTTTATCTAATGAC -> CCCTATCTCGTTTATCTAATGACA
ACACAGGATCCGGCTCGACCAGGA -> CACAGGATCCGGCTCGACCAGGAG
TCCCACGCTACGGATTAACAAGCA -> CCCACGCTACGGATTAACAAGCAT
ACCCACAGGCAGTTGGGACTTCGT -> CCCACAGGCAGTTGGGACTTCGTA
GGCTCCGCGATAGCGCGTTCCTCA -> GCTCCGCGATAGCGCGTTCCTCAA
TTGCCACACCTCGGCAGTGATATG -> TGCCACACCTCGGCAGTGATATGC
ACAGCTTCCTCCATGTCCGTCCTA -> CAGCTTCCTCCATGTCCGTCCTAC
ACATAGAGCATTGTCTTGTGCCCT -> CATAGAGCATTGTCTTGTGCCCTG
CACACGGCAGGAACGCCCTGCGAA -> ACACGGCAGGAACGCCCTGCGAAC
CAGTGGAGCAACACCAACAGATGG -> AGTGGAGCAACACCAACAGATGGG
TGCATGAACGTGGAGTTGAAGGGG -> GCATGAACGTGGAGTTGAAGGGGG
ACAGCTCATTAGCTGTTCAAACGA -> CAGCTCATTAGCTGTTCAAACGAC
TGTGCCCTGTCTACCGGGCTACGA -> GTGCCCTGTCTACCGGGCTACGAG
TCCTCCCAGTCTACTGTGGTACAT -> CCTCCCAGTCTACTGTGGTACATG
GCATGCGTTCCTCCTGTCACACTT -> CATGCGTTCCTCCTGTCACACTTA
GGTTTCACTAGTTCCTTCCGGGGC -> GTTTCACTAGTTCCTTCCGGGGCC
TCCCAACAATATCCCCAAATATGA -> CCCAACAATATCCCCAAATATGAG
GTTGTGCTCCGATAGCGCAGTGGA -> TTGTGCTCCGATAGCGCAGTGGAG
CCATATGCAGCGTTCGCGATGCAG -> CATATGCAGCGTTCGCGATGCAGC
GGGAGTATCAGTCTTCGGAACCTC -> GGAGTATCAGTCTTCGGAACCTCC
TGGGAGTTCAGGAACGAGGACGGT -> GGGAGTTCAGGAACGAGGACGGTA
TTAACTCATGACAACACAGGATCC -> TAACTCATGACAACACAGGATCCG
CCTCAACTACACACGGCAGGAACG -> CTCAACTACACACGGCAGGAACGC
ACCCCCCTATCTCGTTTATCTAAT -> CCCCCCTATCTCGTTTATCTAATG
GCCTGCGCCGGTATTTAAAAGAAG -> CCTGCGCCGGTATTTAAAAGAAGG
CAGTTGGGAGTCGTAACACTAGAA -> AGTTGGGAGTCGTAACACTAGAAA
TTTACATGACTCTAAAGTCTTATA -> TTACATGACTCTAAAGTCTTATAA
CTGAGAGCTGGATTGTGCCCGCTC -> TGAGAGCTGGATTGTGCCCGCTCT
GATTCGCGTTGTCCCCTCCTTACT -> ATTCGCGTTGTCCCCTCCTTACTG
CGAGGGATTTTAGATGCAATCGTT -> GAGGGATTTTAGATGCAATCGTTC
CTGCCGAGAGCGATCTAGCCATGC -> TGCCGAGAGCGATCTAGCCATGCG
ACCAATGCGTGTGATTGGCAAGGG -> CCAATGCGTGTGATTGGCAAGGGG
CACTAGAAATATGGTATGTCTGAG -> ACTAGAAATATGGTATGTCTGAGC
GCGATAGCGCGTTCCTCAAAGTTG -> CGATAGCGCGTTCCTCAAAGTTGA
GACCACACTCCGTACAGTTTGGAA -> ACCACACTCCGTACAGTTTGGAAT
CAACAGATGGGCCCCGGCGGGGAG -> AACAGATGGGCCCCGGCGGGGAGA
TCGGAACCTCCACCCACAGGCAGT -> CGGAACCTCCACCCACAGGCAGTT
CGATGCAGCGGGATAATTTGGCTT -> GATGCAGCGGGATAATTTGGCTTA
CCGCTCTAACTAGTCGATCAAGAG -> CGCTCTAACTAGTCGATCAAGAGC
GGCCCCGGCGGGGAGATGCTGCTA -> GCCCCGGCGGGGAGATGCTGCTAT
CACAATCTATACAAGTAACATGTC -> ACAATCTATACAAGTAACATGTCA
GCCATCAGCAGACCATGTTATTTA -> CCATCAGCAGACCATGTTATTTAA
TGCTTTATCATAAAAACTAGGTAC -> GCTTTATCATAAAAACTAGGTACA
CTACGACGTGCTACATGGCATAAG -> TACGACGTGCTACATGGCATAAGA
GAACCCTGGAGTCGGTATATCTTC -> AACCCTGGAGTCGGTATATCTTCC
CCACAATCTATACAAGTAACATGT -> CACAATCTATACAAGTAACATGTC
GCATGAACGTGGAGTTGAAGGGGG -> CATGAACGTGGAGTTGAAGGGGGA
TTAACCCTCACGAAAGACACGTTT -> TAACCCTCACGAAAGACACGTTTC
AAATGAATCCCGGAGTCACCCCTG -> AATGAATCCCGGAGTCACCCCTGC
GTAATATGATCATGGAGCCCCTCT -> TAATATGATCATGGAGCCCCTCTT
TGCGACGGCGTCCTTCTTCATGGG -> GCGACGGCGTCCTTCTTCATGGGC
AGTAACATGTCAATTTTCCAGTTG -> GTAACATGTCAATTTTCCAGTTGG
ACAACGCGGTCACTCTAGTAAATA -> CAACGCGGTCACTCTAGTAAATAC
AAAGACGGGTCGCTCCCACGCTAC -> AAGACGGGTCGCTCCCACGCTACG
AGCAGACCATGTTATTTAAATGTA -> GCAGACCATGTTATTTAAATGTAT
TTAGGTTGGGAGTTCAGGAACGAG -> TAGGTTGGGAGTTCAGGAACGAGG
AAAGGGGACGCGCCACTTTTAAAC -> AAGGGGACGCGCCACTTTTAAACC
CTCGTGTGGCAGCCCCCGGGACCT -> TCGTGTGGCAGCCCCCGGGACCTG
TATCTAATGACAGCTCATTAGCTG -> ATCTAATGACAGCTCATTAGCTGT
ACTCTAGTAAATACCTGTGCACAC -> CTCTAGTAAATACCTGTGCACACA
CCTGCCGAGAGCGATCTAGCCATG -> CTGCCGAGAGCGATCTAGCCATGC
CACGAAAGACACGTTTCCGCTGTG -> ACGAAAGACACGTTTCCGCTGTGG
GTCCGTCCTACGATCTTTTGCCAC -> TCCGTCCTACGATCTTTTGCCACA
AACTCATGACAACACAGGATCCGG -> ACTCATGACAACACAGGATCCGGC
TCAAAGGGGACGCGCCACTTTTAA -> CAAAGGGGACGCGCCACTTTTAAA
TAACTAGTCGATCAAGAGCTATTT -> AACTAGTCGATCAAGAGCTATTTG
TGCAGACGTGTCCTTACGAAAGAC -> GCAGACGTGTCCTTACGAAAGACG
AGCTAGACTTAGCTAACGGGACGC -> GCTAGACTTAGCTAACGGGACGCG
TAAAAGAAGGCGGCTCCGCGATAG -> AAAAGAAGGCGGCTCCGCGATAGC
TGATCATGGAGCCCCTCTTCGCCA -> GATCATGGAGCCCCTCTTCGCCAT
TAGACGGAGCAGACAAATGAATCC -> AGACGGAGCAGACAAATGAATCCC
GCCCCGGCGGGGAGATGCTGCTAT -> CCCCGGCGGGGAGATGCTGCTATT
GTACATGGACCCTTTTCGAAGGGT -> TACATGGACCCTTTTCGAAGGGTG
TGACTGTGGGGTTCTCAATGCTTT -> GACTGTGGGGTTCTCAATGCTTTA
TCACAGAGAAGCCCACCTGATGGT -> CACAGAGAAGCCCACCTGATGGTG
GCGCGTTCCTCAAAGTTGAGGGGA -> CGCGTTCCTCAAAGTTGAGGGGAG
GCACCACCCTAACCAATGGTGGAC -> CACCACCCTAACCAATGGTGGACA
TTCCTCAAAGTTGAGGGGAGTATC -> TCCTCAAAGTTGAGGGGAGTATCA
GTCTTCGGAACCTCCACCCACAGG -> TCTTCGGAACCTCCACCCACAGGC
CATTGCCTCATTCTTGATCGATAC -> ATTGCCTCATTCTTGATCGATACG
CCTAATCGCTACTTTTTATGGGAA -> CTAATCGCTACTTTTTATGGGAAG
ACGGCTGCCAAGGCGTTTTAACTC -> CGGCTGCCAAGGCGTTTTAACTCA
GGTATTTAAAAGAAGGCGGCTCCG -> GTATTTAAAAGAAGGCGGCTCCGC
GGACCCCTAGCCTGCGCCGGTATT -> GACCCCTAGCCTGCGCCGGTATTT
GGGACGCGCCACTTTTAAACCTTG -> GGACGCGCCACTTTTAAACCTTGT
GGCTTGCGCTTATCGGGATTATGG -> GCTTGCGCTTATCGGGATTATGGG
CAGGAGAAAACCCCCCTATCTCGT -> AGGAGAAAACCCCCCTATCTCGTT
CCACACTCCGTACAGTTTGGAATT -> CACACTCCGTACAGTTTGGAATTA
CTATAGGACACGCGGAGCCTCTGG -> TATAGGACACGCGGAGCCTCTGGC
AACTAGGTACACGGTTGTGCTCCG -> ACTAGGTACACGGTTGTGCTCCGA
CTTGTTTCAAGCTGCTTTAGCCCC -> TTGTTTCAAGCTGCTTTAGCCCCG
GCGTTGTCCCCTCCTTACTGCACA -> CGTTGTCCCCTCCTTACTGCACAT
GACAGCTCATTAGCTGTTCAAACG -> ACAGCTCATTAGCTGTTCAAACGA
CGGAAGATTTCTATCACGGAGCCG -> GGAAGATTTCTATCACGGAGCCGG
GAGTTGAAGGGGGATCTTCAACGG -> AGTTGAAGGGGGATCTTCAACGGA
TCTTGATCGATACGATTCGCGTTG -> CTTGATCGATACGATTCGCGTTGT
CCCCTCTTCGCCATCAGCAGACCA -> CCCTCTTCGCCATCAGCAGACCAT
CCCCCCTATCTCGTTTATCTAATG -> CCCCCTATCTCGTTTATCTAATGA
AAAGTCTTATAACGGCTGCCAAGG -> AAGTCTTATAACGGCTGCCAAGGC
CGATCTAGCCATGCGCTCCTAATC -> GATCTAGCCATGCGCTCCTAATCG
GGCTTAACCCTCACGAAAGACACG -> GCTTAACCCTCACGAAAGACACGT
TGGCAGACGCGCTAGGATTTCAAC -> GGCAGACGCGCTAGGATTTCAACG
TTGCTTTTATCTAGGACCCCTAGC -> TGCTTTTATCTAGGACCCCTAGCC
AGGGTGCGAAACGACTGCGATCCG -> GGGTGCGAAACGACTGCGATCCGC
ATCAGCAGACCATGTTATTTAAAT -> TCAGCAGACCATGTTATTTAAATG
CAAGTCCACTCATCTACCCACAGC -> AAGTCCACTCATCTACCCACAGCT
TTCCTCCATGTCCGTCCTACGATC -> TCCTCCATGTCCGTCCTACGATCT
AAGATTTCTATCACGGAGCCGGGC -> AGATTTCTATCACGGAGCCGGGCG
CTACGATCTTTTGCCACACCTCGG -> TACGATCTTTTGCCACACCTCGGC
GTTTTAACTCATGACAACACAGGA -> TTTTAACTCATGACAACACAGGAT
GGGTTCTCAATGCTTTATCATAAA -> GGTTCTCAATGCTTTATCATAAAA
GTATTTCCCATATGCAGCGTTCGC -> TATTTCCCATATGCAGCGTTCGCG
CGAAGGGTGCGAAACGACTGCGAT -> GAAGGGTGCGAAACGACTGCGATC
AGAGCATTGTCTTGTGCCCTGTCT -> GAGCATTGTCTTGTGCCCTGTCTA
CGAGGACGGTAGTAGCTAGACTTA -> GAGGACGGTAGTAGCTAGACTTAG
CCCAAATATGAGTGGGCTTGCGCT -> CCAAATATGAGTGGGCTTGCGCTT
GGGACCTGCCGAGAGCGATCTAGC -> GGACCTGCCGAGAGCGATCTAGCC
TCCTCCATGTCCGTCCTACGATCT -> CCTCCATGTCCGTCCTACGATCTT
AGACTGCACCACCCTAACCAATGG -> GACTGCACCACCCTAACCAATGGT
CCGGGACCTGCCGAGAGCGATCTA -> CGGGACCTGCCGAGAGCGATCTAG
TACGACGTGCTACATGGCATAAGA -> ACGACGTGCTACATGGCATAAGAG
CTTTTTATGGGAAGCAACATTCCA -> TTTTTATGGGAAGCAACATTCCAT
TGTGGGGTTCTCAATGCTTTATCA -> GTGGGGTTCTCAATGCTTTATCAT
GCTTGCGCTTATCGGGATTATGGG -> CTTGCGCTTATCGGGATTATGGGT
GGTTTCGATAGCGGCTCTACGACG -> GTTTCGATAGCGGCTCTACGACGT
TGCGAATCAATTGGTTGGATGCCC -> GCGAATCAATTGGTTGGATGCCCA
CCCGCTCTAACTAGTCGATCAAGA -> CCGCTCTAACTAGTCGATCAAGAG
TGTTAGTCAAATGATGGATCCTAT -> GTTAGTCAAATGATGGATCCTATA
ACAAGTAACATGTCAATTTTCCAG -> CAAGTAACATGTCAATTTTCCAGT
CGATTCGCGTTGTCCCCTCCTTAC -> GATTCGCGTTGTCCCCTCCTTACT
GATATGCTTTCTCCACAATCTATA -> ATATGCTTTCTCCACAATCTATAC
CTCCGCGATAGCGCGTTCCTCAAA -> TCCGCGATAGCGCGTTCCTCAAAG
CACTCATTAGGTTGGGAGTTCAGG -> ACTCATTAGGTTGGGAGTTCAGGA
TATGAGGAGTGATGACATAGAGCA -> ATGAGGAGTGATGACATAGAGCAT
CACAGAGAAGCCCACCTGATGGTG -> ACAGAGAAGCCCACCTGATGGTGC
GGATTGTGCCCGCTCTAACTAGTC -> GATTGTGCCCGCTCTAACTAGTCG
CACAAGTTGCTTTTATCTAGGACC -> ACAAGTTGCTTTTATCTAGGACCC
CGGCAAAGACAGCCTGACCACACT -> GGCAAAGACAGCCTGACCACACTC
ATTCAAAGGGGACGCGCCACTTTT -> TTCAAAGGGGACGCGCCACTTTTA
GCTCCGATAGCGCAGTGGAGCAAC -> CTCCGATAGCGCAGTGGAGCAACA
GGGATCTTCAACGGAAGATTTCTA -> GGATCTTCAACGGAAGATTTCTAT
GATTGGCAAGGGGTTTCACTAGTT -> ATTGGCAAGGGGTTTCACTAGTTC
CCGCGATAGCGCGTTCCTCAAAGT -> CGCGATAGCGCGTTCCTCAAAGTT
GCGCCGAACCCTCTTGACTGTGGG -> CGCCGAACCCTCTTGACTGTGGGG
GCCGATGCCCTAAAGTAGGGAGCA -> CCGATGCCCTAAAGTAGGGAGCAC
TTCGACTGTTAGTCAAATGATGGA -> TCGACTGTTAGTCAAATGATGGAT
CCACGCTACGGATTAACAAGCATG -> CACGCTACGGATTAACAAGCATGC
CGTGTAGTGCAGACGTGTCCTTAC -> GTGTAGTGCAGACGTGTCCTTACG
CGCGATAGCGCGTTCCTCAAAGTT -> GCGATAGCGCGTTCCTCAAAGTTG
AGAAATATGGTATGTCTGAGCATT -> GAAATATGGTATGTCTGAGCATTA
TCTATCACGGAGCCGGGCGTTTCG -> CTATCACGGAGCCGGGCGTTTCGA
GCCGAACCCTCTTGACTGTGGGGT -> CCGAACCCTCTTGACTGTGGGGTT
TTCTATCACGGAGCCGGGCGTTTC -> TCTATCACGGAGCCGGGCGTTTCG
GGTGTCACAGAGAAGCCCACCTGA -> GTGTCACAGAGAAGCCCACCTGAT
TGGTTGGATGCCCACAAGTTGCTT -> GGTTGGATGCCCACAAGTTGCTTT
TCATTAGGTTGGGAGTTCAGGAAC -> CATTAGGTTGGGAGTTCAGGAACG
CAGGATCCGGCTCGACCAGGAGAA -> AGGATCCGGCTCGACCAGGAGAAA
TTACCCCTCAACTACACACGGCAG -> TACCCCTCAACTACACACGGCAGG
CAAAGGGGACGCGCCACTTTTAAA -> AAAGGGGACGCGCCACTTTTAAAC
CTCCGGTGTCACAGAGAAGCCCAC -> TCCGGTGTCACAGAGAAGCCCACC
ACGTGGAGTTGAAGGGGGATCTTC -> CGTGGAGTTGAAGGGGGATCTTCA
TGCAGCGTTCGCGATGCAGCGGGA -> GCAGCGTTCGCGATGCAGCGGGAT
AGCTGCCGTATACCTGCAAGTCCA -> GCTGCCGTATACCTGCAAGTCCAC
GAATCAATTGGTTGGATGCCCACA -> AATCAATTGGTTGGATGCCCACAA
TTCGCGTTGTCCCCTCCTTACTGC -> TCGCGTTGTCCCCTCCTTACTGCA
CTTCCGGGGCCCGGTTGTAATATG -> TTCCGGGGCCCGGTTGTAATATGA
TTTCGATAGCGGCTCTACGACGTG -> TTCGATAGCGGCTCTACGACGTGC
TTATGAGGAGTGATGACATAGAGC -> TATGAGGAGTGATGACATAGAGCA
AGTGGAGCAACACCAACAGATGGG -> GTGGAGCAACACCAACAGATGGGC
CATATGCAGCGTTCGCGATGCAGC -> ATATGCAGCGTTCGCGATGCAGCG
TACGGTGAAACGCGAACCCTGGAG -> ACGGTGAAACGCGAACCCTGGAGT
AGTGATATGCTTTCTCCACAATCT -> GTGATATGCTTTCTCCACAATCTA
CCGGTTGTAATATGATCATGGAGC -> CGGTTGTAATATGATCATGGAGCC
TTTAGATGCAATCGTTCTGCGAAT -> TTAGATGCAATCGTTCTGCGAATC
TTCCTCCTGTCACACTTACCCCTC -> TCCTCCTGTCACACTTACCCCTCA
GTCACTCTAGTAAATACCTGTGCA -> TCACTCTAGTAAATACCTGTGCAC
AGCCCCGGGGCTACGGCAAAGACA -> GCCCCGGGGCTACGGCAAAGACAG
CAGCGCCGTCACCAATGCGTGTGA -> AGCGCCGTCACCAATGCGTGTGAT
TCTTCGCCATCAGCAGACCATGTT -> CTTCGCCATCAGCAGACCATGTTA
GACCATGTTATTTAAATGTATACT -> ACCATGTTATTTAAATGTATACTC
GTGGGGTTCTCAATGCTTTATCAT -> TGGGGTTCTCAATGCTTTATCATA
CGCGCCACTTTTAAACCTTGTGTT -> GCGCCACTTTTAAACCTTGTGTTG
GAAATATGGTATGTCTGAGCATTA -> AAATATGGTATGTCTGAGCATTAG
GGAACCTCCACCCACAGGCAGTTG -> GAACCTCCACCCACAGGCAGTTGG
GCTTCCTCCATGTCCGTCCTACGA -> CTTCCTCCATGTCCGTCCTACGAT
GTCTACCGGGCTACGAGGGATTTT -> TCTACCGGGCTACGAGGGATTTTA
GCCGTCAATGAGGTATTTCCCATA -> CCGTCAATGAGGTATTTCCCATAT
TCCATTTTCGCATTGCATGCATGA -> CCATTTTCGCATTGCATGCATGAA
GTCACACTTACCCCTCAACTACAC -> TCACACTTACCCCTCAACTACACA
CCATTTTCGCATTGCATGCATGAA -> CATTTTCGCATTGCATGCATGAAC
GTCTTATAACGGCTGCCAAGGCGT -> TCTTATAACGGCTGCCAAGGCGTT
AGGAGAAAACCCCCCTATCTCGTT -> GGAGAAAACCCCCCTATCTCGTTT
CGACGTGCTACATGGCATAAGAGC -> GACGTGCTACATGGCATAAGAGCT
CGAACCCTGGAGTCGGTATATCTT -> GAACCCTGGAGTCGGTATATCTTC
GTGGGCTTGCGCTTATCGGGATTA -> TGGGCTTGCGCTTATCGGGATTAT
GGGCCGTCAATGAGGTATTTCCCA -> GGCCGTCAATGAGGTATTTCCCAT
GACGCGCCACTTTTAAACCTTGTG -> ACGCGCCACTTTTAAACCTTGTGT
TTCGTAGACGGAGCAGACAAATGA -> TCGTAGACGGAGCAGACAAATGAA
ATCTATACAAGTAACATGTCAATT -> TCTATACAAGTAACATGTCAATTT
CCCTAACCAATGGTGGACATAATG -> CCTAACCAATGGTGGACATAATGG
ACTTGTTTCAAGCTGCTTTAGCCC -> CTTGTTTCAAGCTGCTTTAGCCCC
GGGCTTGCGCTTATCGGGATTATG -> GGCTTGCGCTTATCGGGATTATGG
GAGGAGTGATGACATAGAGCATTG -> AGGAGTGATGACATAGAGCATTGT
GATTATGGGTCACGTGTAGTGCAG -> ATTATGGGTCACGTGTAGTGCAGA
TACCCACAGCTTCCTCCATGTCCG -> ACCCACAGCTTCCTCCATGTCCGT
GCTTTATCATAAAAACTAGGTACA -> CTTTATCATAAAAACTAGGTACAC
GTATTTAAAAGAAGGCGGCTCCGC -> TATTTAAAAGAAGGCGGCTCCGCG
GCGCCACTTTTAAACCTTGTGTTG -> CGCCACTTTTAAACCTTGTGTTGT
CATGACAACACAGGATCCGGCTCG -> ATGACAACACAGGATCCGGCTCGA
GTTCCTCCTGTCACACTTACCCCT -> TTCCTCCTGTCACACTTACCCCTC
CTAAACTTTGGGGCCTCTGAGAGC -> TAAACTTTGGGGCCTCTGAGAGCT
AGTTGAAGGGGGATCTTCAACGGA -> GTTGAAGGGGGATCTTCAACGGAA
TGCTTTCTCCACAATCTATACAAG -> GCTTTCTCCACAATCTATACAAGT
ACGCGAACCCTGGAGTCGGTATAT -> CGCGAACCCTGGAGTCGGTATATC
AAATGATGGATCCTATAGGACACG -> AATGATGGATCCTATAGGACACGC
TCCTGTCACACTTACCCCTCAACT -> CCTGTCACACTTACCCCTCAACTA
GACGGAGCAGACAAATGAATCCCG -> ACGGAGCAGACAAATGAATCCCGG
TATCACGGAGCCGGGCGTTTCGAC -> ATCACGGAGCCGGGCGTTTCGACT
TGATGGTGCGGGCTGGGGTGCGCC -> GATGGTGCGGGCTGGGGTGCGCCG
ATGCTTTATCATAAAAACTAGGTA -> TGCTTTATCATAAAAACTAGGTAC
GCTACATGGCATAAGAGCTGCCGT -> CTACATGGCATAAGAGCTGCCGTA
CGGTTGTAATATGATCATGGAGCC -> GGTTGTAATATGATCATGGAGCCC
ACTTTTTATGGGAAGCAACATTCC -> CTTTTTATGGGAAGCAACATTCCA
CTAACCAATGGTGGACATAATGGT -> TAACCAATGGTGGACATAATGGTT
ATCTTCCATTTTCGCATTGCATGC -> TCTTCCATTTTCGCATTGCATGCA
TTGTCTTGTGCCCTGTCTACCGGG -> TGTCTTGTGCCCTGTCTACCGGGC
ATGATCATGGAGCCCCTCTTCGCC -> TGATCATGGAGCCCCTCTTCGCCA
ACTTACCCCTCAACTACACACGGC -> CTTACCCCTCAACTACACACGGCA
AGTTTGGAATTATGAGGAGTGATG -> GTTTGGAATTATGAGGAGTGATGA
ATCGCTACTTTTTATGGGAAGCAA -> TCGCTACTTTTTATGGGAAGCAAC
CTGGAGTCGGTATATCTTCCATTT -> TGGAGTCGGTATATCTTCCATTTT
GGCAAACACAACGCGGTCACTCTA -> GCAAACACAACGCGGTCACTCTAG
GGACCTGCCGAGAGCGATCTAGCC -> GACCTGCCGAGAGCGATCTAGCCA
TGTTATTTAAATGTATACTCCGGT -> GTTATTTAAATGTATACTCCGGTG
GGTGGACATAATGGTTTCGATAGC -> GTGGACATAATGGTTTCGATAGCG
CACCAATGCGTGTGATTGGCAAGG -> ACCAATGCGTGTGATTGGCAAGGG
AACACAGGATCCGGCTCGACCAGG -> ACACAGGATCCGGCTCGACCAGGA
TCCGGGGCCCGGTTGTAATATGAT -> CCGGGGCCCGGTTGTAATATGATC
AAGGGTGCGAAACGACTGCGATCC -> AGGGTGCGAAACGACTGCGATCCG
TTGGGGCCTCTGAGAGCTGGATTG -> TGGGGCCTCTGAGAGCTGGATTGT
CTATTATTTTTTACATGACTCTAA -> TATTATTTTTTACATGACTCTAAA
GGCTGCCAAGGCGTTTTAACTCAT -> GCTGCCAAGGCGTTTTAACTCATG
CTCTAAAGTCTTATAACGGCTGCC -> TCTAAAGTCTTATAACGGCTGCCA
TCTCCACAATCTATACAAGTAACA -> CTCCACAATCTATACAAGTAACAT
CAAAGTTGAGGGGAGTATCAGTCT -> AAAGTTGAGGGGAGTATCAGTCTT
CTGATGGTGCGGGCTGGGGTGCGC -> TGATGGTGCGGGCTGGGGTGCGCC
TGGGTCACGTGTAGTGCAGACGTG -> GGGTCACGTGTAGTGCAGACGTGT
GCCCCCGGGACCTGCCGAGAGCGA -> CCCCCGGGACCTGCCGAGAGCGAT
AGTTGGGAGTCGTAACACTAGAAA -> GTTGGGAGTCGTAACACTAGAAAT
CCTAGCCTGCGCCGGTATTTAAAA -> CTAGCCTGCGCCGGTATTTAAAAG
TTATAACGGCTGCCAAGGCGTTTT -> TATAACGGCTGCCAAGGCGTTTTA
TTGGCAAGGGGTTTCACTAGTTCC -> TGGCAAGGGGTTTCACTAGTTCCT
GCAGACAAATGAATCCCGGAGTCA -> CAGACAAATGAATCCCGGAGTCAC
GGAAGATTTCTATCACGGAGCCGG -> GAAGATTTCTATCACGGAGCCGGG
TTAGATGCAATCGTTCTGCGAATC -> TAGATGCAATCGTTCTGCGAATCA
CTTCGGAACCTCCACCCACAGGCA -> TTCGGAACCTCCACCCACAGGCAG
CCACCTGATGGTGCGGGCTGGGGT -> CACCTGATGGTGCGGGCTGGGGTG
CGGGACGCGCCGAACCCTCTTGAC -> GGGACGCGCCGAACCCTCTTGACT
GGATCCTATAGGACACGCGGAGCC -> GATCCTATAGGACACGCGGAGCCT
ATGAGGTATTTCCCATATGCAGCG -> TGAGGTATTTCCCATATGCAGCGT
CCTATCTCGTTTATCTAATGACAG -> CTATCTCGTTTATCTAATGACAGC
TAACTCATGACAACACAGGATCCG -> AACTCATGACAACACAGGATCCGG
AGATTTCTATCACGGAGCCGGGCG -> GATTTCTATCACGGAGCCGGGCGT
ATTGCATGCATGAACGTGGAGTTG -> TTGCATGCATGAACGTGGAGTTGA
CTTCTTCATGGGCCGTCAATGAGG -> TTCTTCATGGGCCGTCAATGAGGT
TCTATAGCATTCAAAGGGGACGCG -> CTATAGCATTCAAAGGGGACGCGC
CCCATATGCAGCGTTCGCGATGCA -> CCATATGCAGCGTTCGCGATGCAG
GAGCATTGTCTTGTGCCCTGTCTA -> AGCATTGTCTTGTGCCCTGTCTAC
GGAATTATGAGGAGTGATGACATA -> GAATTATGAGGAGTGATGACATAG
CTACCCACAGCTTCCTCCATGTCC -> TACCCACAGCTTCCTCCATGTCCG
GTTCCTTCCGGGGCCCGGTTGTAA -> TTCCTTCCGGGGCCCGGTTGTAAT
ACGCTACGGATTAACAAGCATGCG -> CGCTACGGATTAACAAGCATGCGT
CCCTGCGACGGCGTCCTTCTTCAT -> CCTGCGACGGCGTCCTTCTTCATG
GGGGTTTCACTAGTTCCTTCCGGG -> GGGTTTCACTAGTTCCTTCCGGGG
CAATCTATACAAGTAACATGTCAA -> AATCTATACAAGTAACATGTCAAT
CTTAGCTAACGGGACGCGCCGAAC -> TTAGCTAACGGGACGCGCCGAACC
CCTTACGAAAGACGGGTCGCTCCC -> CTTACGAAAGACGGGTCGCTCCCA
GGCTACGAGGGATTTTAGATGCAA -> GCTACGAGGGATTTTAGATGCAAT
ACGATCTTTTGCCACACCTCGGCA -> CGATCTTTTGCCACACCTCGGCAG
CCCAACAATATCCCCAAATATGAG -> CCAACAATATCCCCAAATATGAGT
TTGCATGCATGAACGTGGAGTTGA -> TGCATGCATGAACGTGGAGTTGAA
CTTTATCATAAAAACTAGGTACAC -> TTTATCATAAAAACTAGGTACACG
CAAAGACAGCCTGACCACACTCCG -> AAAGACAGCCTGACCACACTCCGT
GGAGTCGTAACACTAGAAATATGG -> GAGTCGTAACACTAGAAATATGGT
AGCGTTCGCGATGCAGCGGGATAA -> GCGTTCGCGATGCAGCGGGATAAT
ACAAATGAATCCCGGAGTCACCCC -> CAAATGAATCCCGGAGTCACCCCT
GATGCAATCGTTCTGCGAATCAAT -> ATGCAATCGTTCTGCGAATCAATT
ACACCCATACTTGTTTCAAGCTGC -> CACCCATACTTGTTTCAAGCTGCT
AGTGATGACATAGAGCATTGTCTT -> GTGATGACATAGAGCATTGTCTTG
CGCAGTGGAGCAACACCAACAGAT -> GCAGTGGAGCAACACCAACAGATG
GCGCAGTGGAGCAACACCAACAGA -> CGCAGTGGAGCAACACCAACAGAT
GAAGCAACATTCCATCAGCTTGTG -> AAGCAACATTCCATCAGCTTGTGA
AGGGAGCACGTCCTCCCAGTCTAC -> GGGAGCACGTCCTCCCAGTCTACT
AAACGACTGCGATCCGCACTCATT -> AACGACTGCGATCCGCACTCATTA
CTAACTAGTCGATCAAGAGCTATT -> TAACTAGTCGATCAAGAGCTATTT
CGCTACGGATTAACAAGCATGCGT -> GCTACGGATTAACAAGCATGCGTT
CAATCGTTCTGCGAATCAATTGGT -> AATCGTTCTGCGAATCAATTGGTT
GATGGATCCTATAGGACACGCGGA -> ATGGATCCTATAGGACACGCGGAG
CGTATACCTGCAAGTCCACTCATC -> GTATACCTGCAAGTCCACTCATCT
CATTCTTGATCGATACGATTCGCG -> ATTCTTGATCGATACGATTCGCGT
ATATGAGTGGGCTTGCGCTTATCG -> TATGAGTGGGCTTGCGCTTATCGG
ATAGCGGCTCTACGACGTGCTACA -> TAGCGGCTCTACGACGTGCTACAT
TTACATGACTCTAAAGTCTTATAA -> TACATGACTCTAAAGTCTTATAAC
CTGTCTACCGGGCTACGAGGGATT -> TGTCTACCGGGCTACGAGGGATTT
CAGCAGACCATGTTATTTAAATGT -> AGCAGACCATGTTATTTAAATGTA
CACGCGGAGCCTCTGGCTAAGACT -> ACGCGGAGCCTCTGGCTAAGACTG
GGCGTTTCGACTGTTAGTCAAATG -> GCGTTTCGACTGTTAGTCAAATGA
TGCGAACACCCATACTTGTTTCAA -> GCGAACACCCATACTTGTTTCAAG
CGGCTGCCAAGGCGTTTTAACTCA -> GGCTGCCAAGGCGTTTTAACTCAT
CCGGCGGGGAGATGCTGCTATTAT -> CGGCGGGGAGATGCTGCTATTATT
TCCTTACTGCACATAACCTACGGT -> CCTTACTGCACATAACCTACGGTG
GGAGTCACCCCTGCGACGGCGTCC -> GAGTCACCCCTGCGACGGCGTCCT
ATTTGGCAGACGCGCTAGGATTTC -> TTTGGCAGACGCGCTAGGATTTCA
ACCTTGTGTTGTCCGCTAAACTTT -> CCTTGTGTTGTCCGCTAAACTTTG
GGACATAATGGTTTCGATAGCGGC -> GACATAATGGTTTCGATAGCGGCT
CTCATTAGGTTGGGAGTTCAGGAA -> TCATTAGGTTGGGAGTTCAGGAAC
ACACACGGCAGGAACGCCCTGCGA -> CACACGGCAGGAACGCCCTGCGAA
TATAACGGCTGCCAAGGCGTTTTA -> ATAACGGCTGCCAAGGCGTTTTAA
TGTGATTGGCAAGGGGTTTCACTA -> GTGATTGGCAAGGGGTTTCACTAG
AAAGTTGAGGGGAGTATCAGTCTT -> AAGTTGAGGGGAGTATCAGTCTTC
AATATGATCATGGAGCCCCTCTTC -> ATATGATCATGGAGCCCCTCTTCG
GGGACGCGCCGAACCCTCTTGACT -> GGACGCGCCGAACCCTCTTGACTG
TTTCTCCACAATCTATACAAGTAA -> TTCTCCACAATCTATACAAGTAAC
ACACGCGGAGCCTCTGGCTAAGAC -> CACGCGGAGCCTCTGGCTAAGACT
CATGGAGCCCCTCTTCGCCATCAG -> ATGGAGCCCCTCTTCGCCATCAGC
AGTTGAGGGGAGTATCAGTCTTCG -> GTTGAGGGGAGTATCAGTCTTCGG
AACGGAAGATTTCTATCACGGAGC -> ACGGAAGATTTCTATCACGGAGCC
TCACGGAGCCGGGCGTTTCGACTG -> CACGGAGCCGGGCGTTTCGACTGT
TTGGGAGTTCAGGAACGAGGACGG -> TGGGAGTTCAGGAACGAGGACGGT
CTATTTGGCAGACGCGCTAGGATT -> TATTTGGCAGACGCGCTAGGATTT
AGGTACACGGTTGTGCTCCGATAG -> GGTACACGGTTGTGCTCCGATAGC
GCCCTGCGAACACCCATACTTGTT -> CCCTGCGAACACCCATACTTGTTT
AAGACGGGTCGCTCCCACGCTACG -> AGACGGGTCGCTCCCACGCTACGG
TGTGGAAGACATTGCCTCATTCTT -> GTGGAAGACATTGCCTCATTCTTG
ACGGCGTCCTTCTTCATGGGCCGT -> CGGCGTCCTTCTTCATGGGCCGTC
CGACTGTTAGTCAAATGATGGATC -> GACTGTTAGTCAAATGATGGATCC
CGGTATATCTTCCATTTTCGCATT -> GGTATATCTTCCATTTTCGCATTG
ATTTCAACGGCAAACACAACGCGG -> TTTCAACGGCAAACACAACGCGGT
CAATGCTTTATCATAAAAACTAGG -> AATGCTTTATCATAAAAACTAGGT
GATCCTATAGGACACGCGGAGCCT -> ATCCTATAGGACACGCGGAGCCTC
CTCTAACTAGTCGATCAAGAGCTA -> TCTAACTAGTCGATCAAGAGCTAT
TTTATCTAGGACCCCTAGCCTGCG -> TTATCTAGGACCCCTAGCCTGCGC
GCCCTGTCTACCGGGCTACGAGGG -> CCCTGTCTACCGGGCTACGAGGGA
TCTAGTAAATACCTGTGCACACAA -> CTAGTAAATACCTGTGCACACAAT
CTTGTGCCCTGTCTACCGGGCTAC -> TTGTGCCCTGTCTACCGGGCTACG
TGACCACACTCCGTACAGTTTGGA -> GACCACACTCCGTACAGTTTGGAA
CACACCTCGGCAGTGATATGCTTT -> ACACCTCGGCAGTGATATGCTTTC
GGGAAGCAACATTCCATCAGCTTG -> GGAAGCAACATTCCATCAGCTTGT
GTCACCCCTGCGACGGCGTCCTTC -> TCACCCCTGCGACGGCGTCCTTCT
CCCCTCAACTACACACGGCAGGAA -> CCCTCAACTACACACGGCAGGAAC
TCTTGTGCCCTGTCTACCGGGCTA -> CTTGTGCCCTGTCTACCGGGCTAC
ACCTGCCGAGAGCGATCTAGCCAT -> CCTGCCGAGAGCGATCTAGCCATG
ACCTGATGGTGCGGGCTGGGGTGC -> CCTGATGGTGCGGGCTGGGGTGCG
GCTTATCGGGATTATGGGTCACGT -> CTTATCGGGATTATGGGTCACGTG
TGCTGCTATTATTTTTTACATGAC -> GCTGCTATTATTTTTTACATGACT
TCGATCAAGAGCTATTTGGCAGAC -> CGATCAAGAGCTATTTGGCAGACG
CATGCATGAACGTGGAGTTGAAGG -> ATGCATGAACGTGGAGTTGAAGGG
ACCCTAACCAATGGTGGACATAAT -> CCCTAACCAATGGTGGACATAATG
ACGGCAGGAACGCCCTGCGAACAC -> CGGCAGGAACGCCCTGCGAACACC
TCTGAGAGCTGGATTGTGCCCGCT -> CTGAGAGCTGGATTGTGCCCGCTC
CAAGGGGTTTCACTAGTTCCTTCC -> AAGGGGTTTCACTAGTTCCTTCCG
TTGAAGGGGGATCTTCAACGGAAG -> TGAAGGGGGATCTTCAACGGAAGA
AGTAGCTAGACTTAGCTAACGGGA -> GTAGCTAGACTTAGCTAACGGGAC
AGCCGGGCGTTTCGACTGTTAGTC -> GCCGGGCGTTTCGACTGTTAGTCA
GTTTCGACTGTTAGTCAAATGATG -> TTTCGACTGTTAGTCAAATGATGG
CACCTCGGCAGTGATATGCTTTCT -> ACCTCGGCAGTGATATGCTTTCTC
ACACGGTTGTGCTCCGATAGCGCA -> CACGGTTGTGCTCCGATAGCGCAG
CCTACGGTGAAACGCGAACCCTGG -> CTACGGTGAAACGCGAACCCTGGA
GGTCGCTCCCACGCTACGGATTAA -> GTCGCTCCCACGCTACGGATTAAC
CTAGCCATGCGCTCCTAATCGCTA -> TAGCCATGCGCTCCTAATCGCTAC
TAGCCTGCGCCGGTATTTAAAAGA -> AGCCTGCGCCGGTATTTAAAAGAA
GCTGCTTTAGCCCCGGGGCTACGG -> CTGCTTTAGCCCCGGGGCTACGGC
AATCGTTCTGCGAATCAATTGGTT -> ATCGTTCTGCGAATCAATTGGTTG
AGGAACGCCCTGCGAACACCCATA -> GGAACGCCCTGCGAACACCCATAC
CCAGTTGGGAGTCGTAACACTAGA -> CAGTTGGGAGTCGTAACACTAGAA
TCATGACAACACAGGATCCGGCTC -> CATGACAACACAGGATCCGGCTCG
ATGCGCTCCTAATCGCTACTTTTT -> TGCGCTCCTAATCGCTACTTTTTA
AATGGTTTCGATAGCGGCTCTACG -> ATGGTTTCGATAGCGGCTCTACGA
TATGGGTCACGTGTAGTGCAGACG -> ATGGGTCACGTGTAGTGCAGACGT
ACTGTGGTACATGGACCCTTTTCG -> CTGTGGTACATGGACCCTTTTCGA
CGGGACCTGCCGAGAGCGATCTAG -> GGGACCTGCCGAGAGCGATCTAGC
TTATCGGGATTATGGGTCACGTGT -> TATCGGGATTATGGGTCACGTGTA
TCTTTTGCCACACCTCGGCAGTGA -> CTTTTGCCACACCTCGGCAGTGAT
GTTCTCAATGCTTTATCATAAAAA -> TTCTCAATGCTTTATCATAAAAAC
CGCGCTAGGATTTCAACGGCAAAC -> GCGCTAGGATTTCAACGGCAAACA
CTGCAAGTCCACTCATCTACCCAC -> TGCAAGTCCACTCATCTACCCACA
TAAATACCTGTGCACACAATGTCA -> AAATACCTGTGCACACAATGTCAG
CTAAAGTCTTATAACGGCTGCCAA -> TAAAGTCTTATAACGGCTGCCAAG
TCGATAGCGGCTCTACGACGTGCT -> CGATAGCGGCTCTACGACGTGCTA
TTAGTCAAATGATGGATCCTATAG -> TAGTCAAATGATGGATCCTATAGG
TCAATGCTTTATCATAAAAACTAG -> CAATGCTTTATCATAAAAACTAGG
CGCGGAGCCTCTGGCTAAGACTGC -> GCGGAGCCTCTGGCTAAGACTGCA
TGCGCTTATCGGGATTATGGGTCA -> GCGCTTATCGGGATTATGGGTCAC
CCCACGCTACGGATTAACAAGCAT -> CCACGCTACGGATTAACAAGCATG
AACCTCCACCCACAGGCAGTTGGG -> ACCTCCACCCACAGGCAGTTGGGA
CTCATTAGCTGTTCAAACGACCGT -> TCATTAGCTGTTCAAACGACCGTG
TTACTGCACATAACCTACGGTGAA -> TACTGCACATAACCTACGGTGAAA
TATGGGAAGCAACATTCCATCAGC -> ATGGGAAGCAACATTCCATCAGCT
CTGCGAATCAATTGGTTGGATGCC -> TGCGAATCAATTGGTTGGATGCCC
CCTCGGCAGTGATATGCTTTCTCC -> CTCGGCAGTGATATGCTTTCTCCA
CACGTTTCCGCTGTGGAAGACATT -> ACGTTTCCGCTGTGGAAGACATTG
AACGCGGTCACTCTAGTAAATACC -> ACGCGGTCACTCTAGTAAATACCT
AACTAGTCGATCAAGAGCTATTTG -> ACTAGTCGATCAAGAGCTATTTGG
ATCTAGCCATGCGCTCCTAATCGC -> TCTAGCCATGCGCTCCTAATCGCT
TGTCAGCGCCGTCACCAATGCGTG -> GTCAGCGCCGTCACCAATGCGTGT
GCGTTCGCGATGCAGCGGGATAAT -> CGTTCGCGATGCAGCGGGATAATT
ATTGGTTGGATGCCCACAAGTTGC -> TTGGTTGGATGCCCACAAGTTGCT
ATACTTGTTTCAAGCTGCTTTAGC -> TACTTGTTTCAAGCTGCTTTAGCC
GTCTTGTGCCCTGTCTACCGGGCT -> TCTTGTGCCCTGTCTACCGGGCTA
GTTCCTCAAAGTTGAGGGGAGTAT -> TTCCTCAAAGTTGAGGGGAGTATC
CCACTCATCTACCCACAGCTTCCT -> CACTCATCTACCCACAGCTTCCTC
AAGTCTTATAACGGCTGCCAAGGC -> AGTCTTATAACGGCTGCCAAGGCG
GGCAAGGGGTTTCACTAGTTCCTT -> GCAAGGGGTTTCACTAGTTCCTTC
CTTCGTAGACGGAGCAGACAAATG -> TTCGTAGACGGAGCAGACAAATGA
TTCGATAGCGGCTCTACGACGTGC -> TCGATAGCGGCTCTACGACGTGCT
CTAAGACTGCACCACCCTAACCAA -> TAAGACTGCACCACCCTAACCAAT
CGACCGTGCGACTCGTGTGGCAGC -> GACCGTGCGACTCGTGTGGCAGCC
ATAGAGCATTGTCTTGTGCCCTGT -> TAGAGCATTGTCTTGTGCCCTGTC
GAGAAAACCCCCCTATCTCGTTTA -> AGAAAACCCCCCTATCTCGTTTAT
TCCCCAAATATGAGTGGGCTTGCG -> CCCCAAATATGAGTGGGCTTGCGC
AATGAATCCCGGAGTCACCCCTGC -> ATGAATCCCGGAGTCACCCCTGCG
GGGAGCACGTCCTCCCAGTCTACT -> GGAGCACGTCCTCCCAGTCTACTG
TCCGCTAAACTTTGGGGCCTCTGA -> CCGCTAAACTTTGGGGCCTCTGAG
CTGTCACACTTACCCCTCAACTAC -> TGTCACACTTACCCCTCAACTACA
CCGATGCCCTAAAGTAGGGAGCAC -> CGATGCCCTAAAGTAGGGAGCACG
TTCTTCATGGGCCGTCAATGAGGT -> TCTTCATGGGCCGTCAATGAGGTA
CATTGTCTTGTGCCCTGTCTACCG -> ATTGTCTTGTGCCCTGTCTACCGG
AACCCTGGAGTCGGTATATCTTCC -> ACCCTGGAGTCGGTATATCTTCCA
CCCCCTATCTCGTTTATCTAATGA -> CCCCTATCTCGTTTATCTAATGAC
ATAGCGCGTTCCTCAAAGTTGAGG -> TAGCGCGTTCCTCAAAGTTGAGGG
GTTCAGGAACGAGGACGGTAGTAG -> TTCAGGAACGAGGACGGTAGTAGC
CAGTTGGGACTTCGTAGACGGAGC -> AGTTGGGACTTCGTAGACGGAGCA
CGCCGATGCCCTAAAGTAGGGAGC -> GCCGATGCCCTAAAGTAGGGAGCA
ATCCGCACTCATTAGGTTGGGAGT -> TCCGCACTCATTAGGTTGGGAGTT
CAAGCTGCTTTAGCCCCGGGGCTA -> AAGCTGCTTTAGCCCCGGGGCTAC
ATGGTGGACATAATGGTTTCGATA -> TGGTGGACATAATGGTTTCGATAG
ATGCAATCGTTCTGCGAATCAATT -> TGCAATCGTTCTGCGAATCAATTG
AGCTATTTGGCAGACGCGCTAGGA -> GCTATTTGGCAGACGCGCTAGGAT
TCCACTCATCTACCCACAGCTTCC -> CCACTCATCTACCCACAGCTTCCT
CTCACGAAAGACACGTTTCCGCTG -> TCACGAAAGACACGTTTCCGCTGT
CGAATCAATTGGTTGGATGCCCAC -> GAATCAATTGGTTGGATGCCCACA
GATGCCCACAAGTTGCTTTTATCT -> ATGCCCACAAGTTGCTTTTATCTA
CCGGAGTCACCCCTGCGACGGCGT -> CGGAGTCACCCCTGCGACGGCGTC
ACGAGGACGGTAGTAGCTAGACTT -> CGAGGACGGTAGTAGCTAGACTTA
ACCAGGAGAAAACCCCCCTATCTC -> CCAGGAGAAAACCCCCCTATCTCG
ATGCGTTCCTCCTGTCACACTTAC -> TGCGTTCCTCCTGTCACACTTACC
CGCCATCAGCAGACCATGTTATTT -> GCCATCAGCAGACCATGTTATTTA
CTTTTGCCACACCTCGGCAGTGAT -> TTTTGCCACACCTCGGCAGTGATA
TAATATGATCATGGAGCCCCTCTT -> AATATGATCATGGAGCCCCTCTTC
GGTTGGGAGTTCAGGAACGAGGAC -> GTTGGGAGTTCAGGAACGAGGACG
CACACTTACCCCTCAACTACACAC -> ACACTTACCCCTCAACTACACACG
GCCTCATTCTTGATCGATACGATT -> CCTCATTCTTGATCGATACGATTC
GCGTTTCGACTGTTAGTCAAATGA -> CGTTTCGACTGTTAGTCAAATGAT
AGTATCAGTCTTCGGAACCTCCAC -> GTATCAGTCTTCGGAACCTCCACC
TAGACTTAGCTAACGGGACGCGCC -> AGACTTAGCTAACGGGACGCGCCG
TACGGCAAAGACAGCCTGACCACA -> ACGGCAAAGACAGCCTGACCACAC
TTTTACATGACTCTAAAGTCTTAT -> TTTACATGACTCTAAAGTCTTATA
TTGGCTTAACCCTCACGAAAGACA -> TGGCTTAACCCTCACGAAAGACAC
CCGCTAAACTTTGGGGCCTCTGAG -> CGCTAAACTTTGGGGCCTCTGAGA
GCCCGTTATTCCCAACAATATCCC -> CCCGTTATTCCCAACAATATCCCC
CTATAGCATTCAAAGGGGACGCGC -> TATAGCATTCAAAGGGGACGCGCC
ATTATTTTTTACATGACTCTAAAG -> TTATTTTTTACATGACTCTAAAGT
CGCTCCTAATCGCTACTTTTTATG -> GCTCCTAATCGCTACTTTTTATGG
CGCCGTCACCAATGCGTGTGATTG -> GCCGTCACCAATGCGTGTGATTGG
GCTCGACCAGGAGAAAACCCCCCT -> CTCGACCAGGAGAAAACCCCCCTA
CTGCTATTATTTTTTACATGACTC -> TGCTATTATTTTTTACATGACTCT
AAAGTAGGGAGCACGTCCTCCCAG -> AAGTAGGGAGCACGTCCTCCCAGT
AGAAGGCGGCTCCGCGATAGCGCG -> GAAGGCGGCTCCGCGATAGCGCGT
GGCGTCCTTCTTCATGGGCCGTCA -> GCGTCCTTCTTCATGGGCCGTCAA
TGGAAGACATTGCCTCATTCTTGA -> GGAAGACATTGCCTCATTCTTGAT
CCACAAGTTGCTTTTATCTAGGAC -> CACAAGTTGCTTTTATCTAGGACC
AGTCTTCGGAACCTCCACCCACAG -> GTCTTCGGAACCTCCACCCACAGG
GGGGATCTTCAACGGAAGATTTCT -> GGGATCTTCAACGGAAGATTTCTA
GCGTTTTAACTCATGACAACACAG -> CGTTTTAACTCATGACAACACAGG
CATAACCTACGGTGAAACGCGAAC -> ATAACCTACGGTGAAACGCGAACC
TCCGTACAGTTTGGAATTATGAGG -> CCGTACAGTTTGGAATTATGAGGA
CATAGAGCATTGTCTTGTGCCCTG -> ATAGAGCATTGTCTTGTGCCCTGT
TTGGGACTTCGTAGACGGAGCAGA -> TGGGACTTCGTAGACGGAGCAGAC
TTCGCATTGCATGCATGAACGTGG -> TCGCATTGCATGCATGAACGTGGA
CATCAGCAGACCATGTTATTTAAA -> ATCAGCAGACCATGTTATTTAAAT
GGTGCGCCGATGCCCTAAAGTAGG -> GTGCGCCGATGCCCTAAAGTAGGG
GTAGTAGCTAGACTTAGCTAACGG -> TAGTAGCTAGACTTAGCTAACGGG
TCCGGTGTCACAGAGAAGCCCACC -> CCGGTGTCACAGAGAAGCCCACCT
TACTTGTTTCAAGCTGCTTTAGCC -> ACTTGTTTCAAGCTGCTTTAGCCC
GGCTCGACCAGGAGAAAACCCCCC -> GCTCGACCAGGAGAAAACCCCCCT
AGGGGGATCTTCAACGGAAGATTT -> GGGGGATCTTCAACGGAAGATTTC
AGCCTCTGGCTAAGACTGCACCAC -> GCCTCTGGCTAAGACTGCACCACC
CACGCTACGGATTAACAAGCATGC -> ACGCTACGGATTAACAAGCATGCG
CGTTGTCCCCTCCTTACTGCACAT -> GTTGTCCCCTCCTTACTGCACATA
TGCCCACAAGTTGCTTTTATCTAG -> GCCCACAAGTTGCTTTTATCTAGG
AATTTGGCTTAACCCTCACGAAAG -> ATTTGGCTTAACCCTCACGAAAGA
CAACATTCCATCAGCTTGTGATGC -> AACATTCCATCAGCTTGTGATGCC
CTTTTCGAAGGGTGCGAAACGACT -> TTTTCGAAGGGTGCGAAACGACTG
AGATGGGCCCCGGCGGGGAGATGC -> GATGGGCCCCGGCGGGGAGATGCT
CCGAGAGCGATCTAGCCATGCGCT -> CGAGAGCGATCTAGCCATGCGCTC
AGTCGGTATATCTTCCATTTTCGC -> GTCGGTATATCTTCCATTTTCGCA
GGATTAACAAGCATGCGTTCCTCC -> GATTAACAAGCATGCGTTCCTCCT
GTCCGCTAAACTTTGGGGCCTCTG -> TCCGCTAAACTTTGGGGCCTCTGA
GCGAAACGACTGCGATCCGCACTC -> CGAAACGACTGCGATCCGCACTCA
AGCCCGTTATTCCCAACAATATCC -> GCCCGTTATTCCCAACAATATCCC
TCGACTGTTAGTCAAATGATGGAT -> CGACTGTTAGTCAAATGATGGATC
GAGCAACACCAACAGATGGGCCCC -> AGCAACACCAACAGATGGGCCCCG
GGGGCCTCTGAGAGCTGGATTGTG -> GGGCCTCTGAGAGCTGGATTGTGC
TCGCGATGCAGCGGGATAATTTGG -> CGCGATGCAGCGGGATAATTTGGC
ATGCCATTCTTTCAGCCCGTTATT -> TGCCATTCTTTCAGCCCGTTATTC
GTGTTGTCCGCTAAACTTTGGGGC -> TGTTGTCCGCTAAACTTTGGGGCC
CCGTCAATGAGGTATTTCCCATAT -> CGTCAATGAGGTATTTCCCATATG
TCCGCGATAGCGCGTTCCTCAAAG -> CCGCGATAGCGCGTTCCTCAAAGT
TATTTTTTACATGACTCTAAAGTC -> ATTTTTTACATGACTCTAAAGTCT
GTATACCTGCAAGTCCACTCATCT -> TATACCTGCAAGTCCACTCATCTA
TTTCGCATTGCATGCATGAACGTG -> TTCGCATTGCATGCATGAACGTGG
TGGCTAAGACTGCACCACCCTAAC -> GGCTAAGACTGCACCACCCTAACC
GAACACCCATACTTGTTTCAAGCT -> AACACCCATACTTGTTTCAAGCTG
AGGATCCGGCTCGACCAGGAGAAA -> GGATCCGGCTCGACCAGGAGAAAA
TTGTGCCCGCTCTAACTAGTCGAT -> TGTGCCCGCTCTAACTAGTCGATC
TAACACTAGAAATATGGTATGTCT -> AACACTAGAAATATGGTATGTCTG
CGAACCCTCTTGACTGTGGGGTTC -> GAACCCTCTTGACTGTGGGGTTCT
AGCAACATTCCATCAGCTTGTGAT -> GCAACATTCCATCAGCTTGTGATG
TTTCAACGGCAAACACAACGCGGT -> TTCAACGGCAAACACAACGCGGTC
GGTTGTAATATGATCATGGAGCCC -> GTTGTAATATGATCATGGAGCCCC
GTTTGGAATTATGAGGAGTGATGA -> TTTGGAATTATGAGGAGTGATGAC
GTGATGCCATTCTTTCAGCCCGTT -> TGATGCCATTCTTTCAGCCCGTTA
TTATTTAAATGTATACTCCGGTGT -> TATTTAAATGTATACTCCGGTGTC
CAGCTTCCTCCATGTCCGTCCTAC -> AGCTTCCTCCATGTCCGTCCTACG
CCCATACTTGTTTCAAGCTGCTTT -> CCATACTTGTTTCAAGCTGCTTTA
TTCAACGGAAGATTTCTATCACGG -> TCAACGGAAGATTTCTATCACGGA
ATGATGGATCCTATAGGACACGCG -> TGATGGATCCTATAGGACACGCGG
ACTGTGGGGTTCTCAATGCTTTAT -> CTGTGGGGTTCTCAATGCTTTATC
AAGAGCTGCCGTATACCTGCAAGT -> AGAGCTGCCGTATACCTGCAAGTC
GTGCCCGCTCTAACTAGTCGATCA -> TGCCCGCTCTAACTAGTCGATCAA
GACCTGCCGAGAGCGATCTAGCCA -> ACCTGCCGAGAGCGATCTAGCCAT
ATGGATCCTATAGGACACGCGGAG -> TGGATCCTATAGGACACGCGGAGC
GGTATTTCCCATATGCAGCGTTCG -> GTATTTCCCATATGCAGCGTTCGC
TTCTTGATCGATACGATTCGCGTT -> TCTTGATCGATACGATTCGCGTTG
TTCATGGGCCGTCAATGAGGTATT -> TCATGGGCCGTCAATGAGGTATTT
TGCGTTCCTCCTGTCACACTTACC -> GCGTTCCTCCTGTCACACTTACCC
GCATGCATGAACGTGGAGTTGAAG -> CATGCATGAACGTGGAGTTGAAGG
TAGGGAGCACGTCCTCCCAGTCTA -> AGGGAGCACGTCCTCCCAGTCTAC
CCCACAGGCAGTTGGGACTTCGTA -> CCACAGGCAGTTGGGACTTCGTAG
TTATCATAAAAACTAGGTACACGG -> TATCATAAAAACTAGGTACACGGT
TATGATCATGGAGCCCCTCTTCGC -> ATGATCATGGAGCCCCTCTTCGCC
GCGGGGAGATGCTGCTATTATTTT -> CGGGGAGATGCTGCTATTATTTTT
GCCCACAAGTTGCTTTTATCTAGG -> CCCACAAGTTGCTTTTATCTAGGA
TGCCCGCTCTAACTAGTCGATCAA -> GCCCGCTCTAACTAGTCGATCAAG
GGGGAGTATCAGTCTTCGGAACCT -> GGGAGTATCAGTCTTCGGAACCTC
TTTATGGGAAGCAACATTCCATCA -> TTATGGGAAGCAACATTCCATCAG
TGTCACAGAGAAGCCCACCTGATG -> GTCACAGAGAAGCCCACCTGATGG
ACACAACGCGGTCACTCTAGTAAA -> CACAACGCGGTCACTCTAGTAAAT
AGTCAAATGATGGATCCTATAGGA -> GTCAAATGATGGATCCTATAGGAC
GCAGACCATGTTATTTAAATGTAT -> CAGACCATGTTATTTAAATGTATA
CGATGCCCTAAAGTAGGGAGCACG -> GATGCCCTAAAGTAGGGAGCACGT
CGGAGCAGACAAATGAATCCCGGA -> GGAGCAGACAAATGAATCCCGGAG
AGATGCTGCTATTATTTTTTACAT -> GATGCTGCTATTATTTTTTACATG
CGGGGCCCGGTTGTAATATGATCA -> GGGGCCCGGTTGTAATATGATCAT
CGCGAACCCTGGAGTCGGTATATC -> GCGAACCCTGGAGTCGGTATATCT
ATGCATGAACGTGGAGTTGAAGGG -> TGCATGAACGTGGAGTTGAAGGGG
TCCGCTGTGGAAGACATTGCCTCA -> CCGCTGTGGAAGACATTGCCTCAT
TGCGGGCTGGGGTGCGCCGATGCC -> GCGGGCTGGGGTGCGCCGATGCCC
GTTAGTCAAATGATGGATCCTATA -> TTAGTCAAATGATGGATCCTATAG
TCTTGACTGTGGGGTTCTCAATGC -> CTTGACTGTGGGGTTCTCAATGCT
TATTATTTTTTACATGACTCTAAA -> ATTATTTTTTACATGACTCTAAAG
ACGACCGTGCGACTCGTGTGGCAG -> CGACCGTGCGACTCGTGTGGCAGC
CACAATGTCAGCGCCGTCACCAAT -> ACAATGTCAGCGCCGTCACCAATG
TCCACAATCTATACAAGTAACATG -> CCACAATCTATACAAGTAACATGT
ATGCCCACAAGTTGCTTTTATCTA -> TGCCCACAAGTTGCTTTTATCTAG
GTGTGGCAGCCCCCGGGACCTGCC -> TGTGGCAGCCCCCGGGACCTGCCG
CTCATCTACCCACAGCTTCCTCCA -> TCATCTACCCACAGCTTCCTCCAT
TTGGAATTATGAGGAGTGATGACA -> TGGAATTATGAGGAGTGATGACAT
CATTAGGTTGGGAGTTCAGGAACG -> ATTAGGTTGGGAGTTCAGGAACGA
AGCGCCGTCACCAATGCGTGTGAT -> GCGCCGTCACCAATGCGTGTGATT
GAAAACCCCCCTATCTCGTTTATC -> AAAACCCCCCTATCTCGTTTATCT
GGGTGCGCCGATGCCCTAAAGTAG -> GGTGCGCCGATGCCCTAAAGTAGG
GCCCGGTTGTAATATGATCATGGA -> CCCGGTTGTAATATGATCATGGAG
CCTGATGGTGCGGGCTGGGGTGCG -> CTGATGGTGCGGGCTGGGGTGCGC
TCCTTCCGGGGCCCGGTTGTAATA -> CCTTCCGGGGCCCGGTTGTAATAT
GTCGCTCCCACGCTACGGATTAAC -> TCGCTCCCACGCTACGGATTAACA
ACATGTCAATTTTCCAGTTGGGAG -> CATGTCAATTTTCCAGTTGGGAGT
ATTTTAGATGCAATCGTTCTGCGA -> TTTTAGATGCAATCGTTCTGCGAA
AGTTGCTTTTATCTAGGACCCCTA -> GTTGCTTTTATCTAGGACCCCTAG
ATCGTTCTGCGAATCAATTGGTTG -> TCGTTCTGCGAATCAATTGGTTGG
CCTGACCACACTCCGTACAGTTTG -> CTGACCACACTCCGTACAGTTTGG
GTGAAACGCGAACCCTGGAGTCGG -> TGAAACGCGAACCCTGGAGTCGGT
TACCCCTCAACTACACACGGCAGG -> ACCCCTCAACTACACACGGCAGGA
GTGTCACAGAGAAGCCCACCTGAT -> TGTCACAGAGAAGCCCACCTGATG
TCAATTGGTTGGATGCCCACAAGT -> CAATTGGTTGGATGCCCACAAGTT
TCGTTCTGCGAATCAATTGGTTGG -> CGTTCTGCGAATCAATTGGTTGGA
ACATTCCATCAGCTTGTGATGCCA -> CATTCCATCAGCTTGTGATGCCAT
GTGGAGTTGAAGGGGGATCTTCAA -> TGGAGTTGAAGGGGGATCTTCAAC
CAACGCGGTCACTCTAGTAAATAC -> AACGCGGTCACTCTAGTAAATACC
CATGCGCTCCTAATCGCTACTTTT -> ATGCGCTCCTAATCGCTACTTTTT
GCCCCGGGGCTACGGCAAAGACAG -> CCCCGGGGCTACGGCAAAGACAGC
TGGCAAGGGGTTTCACTAGTTCCT -> GGCAAGGGGTTTCACTAGTTCCTT
TAATTTGGCTTAACCCTCACGAAA -> AATTTGGCTTAACCCTCACGAAAG
GACAACACAGGATCCGGCTCGACC -> ACAACACAGGATCCGGCTCGACCA
TTTTCGAAGGGTGCGAAACGACTG -> TTTCGAAGGGTGCGAAACGACTGC
ACAACACAGGATCCGGCTCGACCA -> CAACACAGGATCCGGCTCGACCAG
GTGCGACTCGTGTGGCAGCCCCCG -> TGCGACTCGTGTGGCAGCCCCCGG
TAGTTCCTTCCGGGGCCCGGTTGT -> AGTTCCTTCCGGGGCCCGGTTGTA
TGAGAGCTGGATTGTGCCCGCTCT -> GAGAGCTGGATTGTGCCCGCTCTA
GATGGGCCCCGGCGGGGAGATGCT -> ATGGGCCCCGGCGGGGAGATGCTG
GAAGGCGGCTCCGCGATAGCGCGT -> AAGGCGGCTCCGCGATAGCGCGTT
TTGTGTTGTCCGCTAAACTTTGGG -> TGTGTTGTCCGCTAAACTTTGGGG
GATTAACAAGCATGCGTTCCTCCT -> ATTAACAAGCATGCGTTCCTCCTG
CTTTGGGGCCTCTGAGAGCTGGAT -> TTTGGGGCCTCTGAGAGCTGGATT
GTTGGATGCCCACAAGTTGCTTTT -> TTGGATGCCCACAAGTTGCTTTTA
GAGCTGCCGTATACCTGCAAGTCC -> AGCTGCCGTATACCTGCAAGTCCA
TCTAACTAGTCGATCAAGAGCTAT -> CTAACTAGTCGATCAAGAGCTATT
AGCGCGTTCCTCAAAGTTGAGGGG -> GCGCGTTCCTCAAAGTTGAGGGGA
CTGCGAACACCCATACTTGTTTCA -> TGCGAACACCCATACTTGTTTCAA
TGTGCCCGCTCTAACTAGTCGATC -> GTGCCCGCTCTAACTAGTCGATCA
GACCCTTTTCGAAGGGTGCGAAAC -> ACCCTTTTCGAAGGGTGCGAAACG
CCTGTCACACTTACCCCTCAACTA -> CTGTCACACTTACCCCTCAACTAC
GACGCGCCGAACCCTCTTGACTGT -> ACGCGCCGAACCCTCTTGACTGTG
AATGTATACTCCGGTGTCACAGAG -> ATGTATACTCCGGTGTCACAGAGA
TCTTCAACGGAAGATTTCTATCAC -> CTTCAACGGAAGATTTCTATCACG
GTTGGGAGTTCAGGAACGAGGACG -> TTGGGAGTTCAGGAACGAGGACGG
GCGAACCCTGGAGTCGGTATATCT -> CGAACCCTGGAGTCGGTATATCTT
GAAAGACACGTTTCCGCTGTGGAA -> AAAGACACGTTTCCGCTGTGGAAG
TGGACCCTTTTCGAAGGGTGCGAA -> GGACCCTTTTCGAAGGGTGCGAAA
GCATTCAAAGGGGACGCGCCACTT -> CATTCAAAGGGGACGCGCCACTTT
ATACAAGTAACATGTCAATTTTCC -> TACAAGTAACATGTCAATTTTCCA
GGAGTCGGTATATCTTCCATTTTC -> GAGTCGGTATATCTTCCATTTTCG
CGCTCTAACTAGTCGATCAAGAGC -> GCTCTAACTAGTCGATCAAGAGCT
CTCCACCCACAGGCAGTTGGGACT -> TCCACCCACAGGCAGTTGGGACTT
GCAATCGTTCTGCGAATCAATTGG -> CAATCGTTCTGCGAATCAATTGGT
ACATGACTCTAAAGTCTTATAACG -> CATGACTCTAAAGTCTTATAACGG
CGGAGCCTCTGGCTAAGACTGCAC -> GGAGCCTCTGGCTAAGACTGCACC
CCCGGTTGTAATATGATCATGGAG -> CCGGTTGTAATATGATCATGGAGC
TTCGCCATCAGCAGACCATGTTAT -> TCGCCATCAGCAGACCATGTTATT
CAAATATGAGTGGGCTTGCGCTTA -> AAATATGAGTGGGCTTGCGCTTAT
AGCTGGATTGTGCCCGCTCTAACT -> GCTGGATTGTGCCCGCTCTAACTA
AATTGGTTGGATGCCCACAAGTTG -> ATTGGTTGGATGCCCACAAGTTGC
CAGATGGGCCCCGGCGGGGAGATG -> AGATGGGCCCCGGCGGGGAGATGC
TTTGGCAGACGCGCTAGGATTTCA -> TTGGCAGACGCGCTAGGATTTCAA
GCGGAGCCTCTGGCTAAGACTGCA -> CGGAGCCTCTGGCTAAGACTGCAC
AAACTAGGTACACGGTTGTGCTCC -> AACTAGGTACACGGTTGTGCTCCG
CCCCGGCGGGGAGATGCTGCTATT -> CCCGGCGGGGAGATGCTGCTATTA
TTTCTATCACGGAGCCGGGCGTTT -> TTCTATCACGGAGCCGGGCGTTTC
GAAGGGGGATCTTCAACGGAAGAT -> AAGGGGGATCTTCAACGGAAGATT
AACCAATGGTGGACATAATGGTTT -> ACCAATGGTGGACATAATGGTTTC
TTGATCGATACGATTCGCGTTGTC -> TGATCGATACGATTCGCGTTGTCC
TATTTAAAAGAAGGCGGCTCCGCG -> ATTTAAAAGAAGGCGGCTCCGCGA
CACAGGCAGTTGGGACTTCGTAGA -> ACAGGCAGTTGGGACTTCGTAGAC
TTGTGCTCCGATAGCGCAGTGGAG -> TGTGCTCCGATAGCGCAGTGGAGC
AGACATTGCCTCATTCTTGATCGA -> GACATTGCCTCATTCTTGATCGAT
AGTTCCTTCCGGGGCCCGGTTGTA -> GTTCCTTCCGGGGCCCGGTTGTAA
ATGGGCCGTCAATGAGGTATTTCC -> TGGGCCGTCAATGAGGTATTTCCC
TACGAAAGACGGGTCGCTCCCACG -> ACGAAAGACGGGTCGCTCCCACGC
TTCCGCTGTGGAAGACATTGCCTC -> TCCGCTGTGGAAGACATTGCCTCA
GCGACTCGTGTGGCAGCCCCCGGG -> CGACTCGTGTGGCAGCCCCCGGGA
GTTGTCCGCTAAACTTTGGGGCCT -> TTGTCCGCTAAACTTTGGGGCCTC
TATACCTGCAAGTCCACTCATCTA -> ATACCTGCAAGTCCACTCATCTAC
TCGTAACACTAGAAATATGGTATG -> CGTAACACTAGAAATATGGTATGT
TAATGGTTTCGATAGCGGCTCTAC -> AATGGTTTCGATAGCGGCTCTACG
GGACGCGCCACTTTTAAACCTTGT -> GACGCGCCACTTTTAAACCTTGTG
GATCATGGAGCCCCTCTTCGCCAT -> ATCATGGAGCCCCTCTTCGCCATC
GCGATCCGCACTCATTAGGTTGGG -> CGATCCGCACTCATTAGGTTGGGA
CGTTCTGCGAATCAATTGGTTGGA -> GTTCTGCGAATCAATTGGTTGGAT
AATGAGGTATTTCCCATATGCAGC -> ATGAGGTATTTCCCATATGCAGCG
GCTTGTGATGCCATTCTTTCAGCC -> CTTGTGATGCCATTCTTTCAGCCC
CTTGTGATGCCATTCTTTCAGCCC -> TTGTGATGCCATTCTTTCAGCCCG
ACGCGCCACTTTTAAACCTTGTGT -> CGCGCCACTTTTAAACCTTGTGTT
CGTCACCAATGCGTGTGATTGGCA -> GTCACCAATGCGTGTGATTGGCAA
AAACACAACGCGGTCACTCTAGTA -> AACACAACGCGGTCACTCTAGTAA
ACTACACACGGCAGGAACGCCCTG -> CTACACACGGCAGGAACGCCCTGC
GCACATAACCTACGGTGAAACGCG -> CACATAACCTACGGTGAAACGCGA
TATTTAAATGTATACTCCGGTGTC -> ATTTAAATGTATACTCCGGTGTCA
CCAATGCGTGTGATTGGCAAGGGG -> CAATGCGTGTGATTGGCAAGGGGT
ATACCTGTGCACACAATGTCAGCG -> TACCTGTGCACACAATGTCAGCGC
CGGAGTCACCCCTGCGACGGCGTC -> GGAGTCACCCCTGCGACGGCGTCC
ACCCCTGCGACGGCGTCCTTCTTC -> CCCCTGCGACGGCGTCCTTCTTCA
AACGACTGCGATCCGCACTCATTA -> ACGACTGCGATCCGCACTCATTAG
ACACGGCAGGAACGCCCTGCGAAC -> CACGGCAGGAACGCCCTGCGAACA
GATTTCTATCACGGAGCCGGGCGT -> ATTTCTATCACGGAGCCGGGCGTT
GGAGATGCTGCTATTATTTTTTAC -> GAGATGCTGCTATTATTTTTTACA
ACCTGTGCACACAATGTCAGCGCC -> CCTGTGCACACAATGTCAGCGCCG
TAGGACCCCTAGCCTGCGCCGGTA -> AGGACCCCTAGCCTGCGCCGGTAT
GCTTAACCCTCACGAAAGACACGT -> CTTAACCCTCACGAAAGACACGTT
TTTTCGCATTGCATGCATGAACGT -> TTTCGCATTGCATGCATGAACGTG
AGCCCACCTGATGGTGCGGGCTGG -> GCCCACCTGATGGTGCGGGCTGGG
GCTCTAACTAGTCGATCAAGAGCT -> CTCTAACTAGTCGATCAAGAGCTA
GCTCCGCGATAGCGCGTTCCTCAA -> CTCCGCGATAGCGCGTTCCTCAAA
GGGGGATCTTCAACGGAAGATTTC -> GGGGATCTTCAACGGAAGATTTCT
TAGCTAACGGGACGCGCCGAACCC -> AGCTAACGGGACGCGCCGAACCCT
TGTCCGTCCTACGATCTTTTGCCA -> GTCCGTCCTACGATCTTTTGCCAC
CAAGAGCTATTTGGCAGACGCGCT -> AAGAGCTATTTGGCAGACGCGCTA
GAGATGCTGCTATTATTTTTTACA -> AGATGCTGCTATTATTTTTTACAT
GCAGCGTTCGCGATGCAGCGGGAT -> CAGCGTTCGCGATGCAGCGGGATA
ATAATTTGGCTTAACCCTCACGAA -> TAATTTGGCTTAACCCTCACGAAA
AGACAAATGAATCCCGGAGTCACC -> GACAAATGAATCCCGGAGTCACCC
GCTACGGCAAAGACAGCCTGACCA -> CTACGGCAAAGACAGCCTGACCAC
TCAGCGCCGTCACCAATGCGTGTG -> CAGCGCCGTCACCAATGCGTGTGA
AATATGAGTGGGCTTGCGCTTATC -> ATATGAGTGGGCTTGCGCTTATCG
ATGAGGAGTGATGACATAGAGCAT -> TGAGGAGTGATGACATAGAGCATT
TAGGTTGGGAGTTCAGGAACGAGG -> AGGTTGGGAGTTCAGGAACGAGGA
TGCTCCGATAGCGCAGTGGAGCAA -> GCTCCGATAGCGCAGTGGAGCAAC
TGGCTTAACCCTCACGAAAGACAC -> GGCTTAACCCTCACGAAAGACACG
TGTGGCAGCCCCCGGGACCTGCCG -> GTGGCAGCCCCCGGGACCTGCCGA
CCGCTGTGGAAGACATTGCCTCAT -> CGCTGTGGAAGACATTGCCTCATT
GAAAGACGGGTCGCTCCCACGCTA -> AAAGACGGGTCGCTCCCACGCTAC
ACATAACCTACGGTGAAACGCGAA -> CATAACCTACGGTGAAACGCGAAC
ATTGTCTTGTGCCCTGTCTACCGG -> TTGTCTTGTGCCCTGTCTACCGGG
GCAAGTCCACTCATCTACCCACAG -> CAAGTCCACTCATCTACCCACAGC
GTAGTGCAGACGTGTCCTTACGAA -> TAGTGCAGACGTGTCCTTACGAAA
ACGGATTAACAAGCATGCGTTCCT -> CGGATTAACAAGCATGCGTTCCTC
AATGGTGGACATAATGGTTTCGAT -> ATGGTGGACATAATGGTTTCGATA
CAGGAACGCCCTGCGAACACCCAT -> AGGAACGCCCTGCGAACACCCATA
TTCTCCACAATCTATACAAGTAAC -> TCTCCACAATCTATACAAGTAACA
ATATCTTCCATTTTCGCATTGCAT -> TATCTTCCATTTTCGCATTGCATG
GCTCCCACGCTACGGATTAACAAG -> CTCCCACGCTACGGATTAACAAGC
TGCCCTAAAGTAGGGAGCACGTCC -> GCCCTAAAGTAGGGAGCACGTCCT
AAGACAGCCTGACCACACTCCGTA -> AGACAGCCTGACCACACTCCGTAC
CCAAGGCGTTTTAACTCATGACAA -> CAAGGCGTTTTAACTCATGACAAC
GTATACTCCGGTGTCACAGAGAAG -> TATACTCCGGTGTCACAGAGAAGC
CTTGACTGTGGGGTTCTCAATGCT -> TTGACTGTGGGGTTCTCAATGCTT
GTCACAGAGAAGCCCACCTGATGG -> TCACAGAGAAGCCCACCTGATGGT
CCCCAAATATGAGTGGGCTTGCGC -> CCCAAATATGAGTGGGCTTGCGCT
CACCCATACTTGTTTCAAGCTGCT -> ACCCATACTTGTTTCAAGCTGCTT
GCTACGAGGGATTTTAGATGCAAT -> CTACGAGGGATTTTAGATGCAATC
GGGCGTTTCGACTGTTAGTCAAAT -> GGCGTTTCGACTGTTAGTCAAATG
ACCACCCTAACCAATGGTGGACAT -> CCACCCTAACCAATGGTGGACATA
CTGTGGTACATGGACCCTTTTCGA -> TGTGGTACATGGACCCTTTTCGAA
GCGCCGATGCCCTAAAGTAGGGAG -> CGCCGATGCCCTAAAGTAGGGAGC
GCAGCGGGATAATTTGGCTTAACC -> CAGCGGGATAATTTGGCTTAACCC
TCACTAGTTCCTTCCGGGGCCCGG -> CACTAGTTCCTTCCGGGGCCCGGT
CCCGGCGGGGAGATGCTGCTATTA -> CCGGCGGGGAGATGCTGCTATTAT
GTGGACATAATGGTTTCGATAGCG -> TGGACATAATGGTTTCGATAGCGG
ACACTTACCCCTCAACTACACACG -> CACTTACCCCTCAACTACACACGG
AAGACACGTTTCCGCTGTGGAAGA -> AGACACGTTTCCGCTGTGGAAGAC
ACGGAGCAGACAAATGAATCCCGG -> CGGAGCAGACAAATGAATCCCGGA
TGTAATATGATCATGGAGCCCCTC -> GTAATATGATCATGGAGCCCCTCT
AGACGTGTCCTTACGAAAGACGGG -> GACGTGTCCTTACGAAAGACGGGT
GAGCTGGATTGTGCCCGCTCTAAC -> AGCTGGATTGTGCCCGCTCTAACT
CATTAGCTGTTCAAACGACCGTGC -> ATTAGCTGTTCAAACGACCGTGCG
GGGGCTACGGCAAAGACAGCCTGA -> GGGCTACGGCAAAGACAGCCTGAC
AAATGTATACTCCGGTGTCACAGA -> AATGTATACTCCGGTGTCACAGAG
GTTCTGCGAATCAATTGGTTGGAT -> TTCTGCGAATCAATTGGTTGGATG
GCTAGGATTTCAACGGCAAACACA -> CTAGGATTTCAACGGCAAACACAA
CACGGCAGGAACGCCCTGCGAACA -> ACGGCAGGAACGCCCTGCGAACAC
CAATGAGGTATTTCCCATATGCAG -> AATGAGGTATTTCCCATATGCAGC
TATAGGACACGCGGAGCCTCTGGC -> ATAGGACACGCGGAGCCTCTGGCT
GACACGTTTCCGCTGTGGAAGACA -> ACACGTTTCCGCTGTGGAAGACAT
CCATCAGCTTGTGATGCCATTCTT -> CATCAGCTTGTGATGCCATTCTTT
GCTGCCAAGGCGTTTTAACTCATG -> CTGCCAAGGCGTTTTAACTCATGA
CGACTGCGATCCGCACTCATTAGG -> GACTGCGATCCGCACTCATTAGGT
CGTAGACGGAGCAGACAAATGAAT -> GTAGACGGAGCAGACAAATGAATC
GACGGTAGTAGCTAGACTTAGCTA -> ACGGTAGTAGCTAGACTTAGCTAA
GACAGCCTGACCACACTCCGTACA -> ACAGCCTGACCACACTCCGTACAG
CAGGCAGTTGGGACTTCGTAGACG -> AGGCAGTTGGGACTTCGTAGACGG
CGGGGCTACGGCAAAGACAGCCTG -> GGGGCTACGGCAAAGACAGCCTGA
TGATATGCTTTCTCCACAATCTAT -> GATATGCTTTCTCCACAATCTATA
GTTTCAAGCTGCTTTAGCCCCGGG -> TTTCAAGCTGCTTTAGCCCCGGGG
ACGGTTGTGCTCCGATAGCGCAGT -> CGGTTGTGCTCCGATAGCGCAGTG
TTTAGCCCCGGGGCTACGGCAAAG -> TTAGCCCCGGGGCTACGGCAAAGA
TGCCACACCTCGGCAGTGATATGC -> GCCACACCTCGGCAGTGATATGCT
CCCTCTTGACTGTGGGGTTCTCAA -> CCTCTTGACTGTGGGGTTCTCAAT
GAGAGCGATCTAGCCATGCGCTCC -> AGAGCGATCTAGCCATGCGCTCCT
AAAACTAGGTACACGGTTGTGCTC -> AAACTAGGTACACGGTTGTGCTCC
TAGATGCAATCGTTCTGCGAATCA -> AGATGCAATCGTTCTGCGAATCAA
CGTGGAGTTGAAGGGGGATCTTCA -> GTGGAGTTGAAGGGGGATCTTCAA
GCAGCCCCCGGGACCTGCCGAGAG -> CAGCCCCCGGGACCTGCCGAGAGC
TTTAAACCTTGTGTTGTCCGCTAA -> TTAAACCTTGTGTTGTCCGCTAAA
CAAATGAATCCCGGAGTCACCCCT -> AAATGAATCCCGGAGTCACCCCTG
GCACACAATGTCAGCGCCGTCACC -> CACACAATGTCAGCGCCGTCACCA
AAGAGCTATTTGGCAGACGCGCTA -> AGAGCTATTTGGCAGACGCGCTAG
CATGTTATTTAAATGTATACTCCG -> ATGTTATTTAAATGTATACTCCGG
GCTGCTATTATTTTTTACATGACT -> CTGCTATTATTTTTTACATGACTC
CCGTATACCTGCAAGTCCACTCAT -> CGTATACCTGCAAGTCCACTCATC
CGAAAGACGGGTCGCTCCCACGCT -> GAAAGACGGGTCGCTCCCACGCTA
TCAGTCTTCGGAACCTCCACCCAC -> CAGTCTTCGGAACCTCCACCCACA
GATAGCGCGTTCCTCAAAGTTGAG -> ATAGCGCGTTCCTCAAAGTTGAGG
ACTAGAAATATGGTATGTCTGAGC -> CTAGAAATATGGTATGTCTGAGCA
GCTGGGGTGCGCCGATGCCCTAAA -> CTGGGGTGCGCCGATGCCCTAAAG
GACCGTGCGACTCGTGTGGCAGCC -> ACCGTGCGACTCGTGTGGCAGCCC
CTGCACATAACCTACGGTGAAACG -> TGCACATAACCTACGGTGAAACGC
CCTATAGGACACGCGGAGCCTCTG -> CTATAGGACACGCGGAGCCTCTGG
TATCTAGGACCCCTAGCCTGCGCC -> ATCTAGGACCCCTAGCCTGCGCCG
CTTTTAAACCTTGTGTTGTCCGCT -> TTTTAAACCTTGTGTTGTCCGCTA
GTTGTAATATGATCATGGAGCCCC -> TTGTAATATGATCATGGAGCCCCT
CTTTCAGCCCGTTATTCCCAACAA -> TTTCAGCCCGTTATTCCCAACAAT
GGGATTATGGGTCACGTGTAGTGC -> GGATTATGGGTCACGTGTAGTGCA
TTCCCAACAATATCCCCAAATATG -> TCCCAACAATATCCCCAAATATGA
CATAAGAGCTGCCGTATACCTGCA -> ATAAGAGCTGCCGTATACCTGCAA
CACTCTAGTAAATACCTGTGCACA -> ACTCTAGTAAATACCTGTGCACAC
ATGGGCCCCGGCGGGGAGATGCTG -> TGGGCCCCGGCGGGGAGATGCTGC
CCATGCGCTCCTAATCGCTACTTT -> CATGCGCTCCTAATCGCTACTTTT
GCTTTTATCTAGGACCCCTAGCCT -> CTTTTATCTAGGACCCCTAGCCTG
TAATCGCTACTTTTTATGGGAAGC -> AATCGCTACTTTTTATGGGAAGCA
TGCACATAACCTACGGTGAAACGC -> GCACATAACCTACGGTGAAACGCG
CGCTACTTTTTATGGGAAGCAACA -> GCTACTTTTTATGGGAAGCAACAT
