AAAAAAATGACGTTCCGCA -> AAAAAATGACGTTCCGCAC
AAAAAATGACGTTCCGCAC -> AAAAATGACGTTCCGCACT
AAAAATGACGTTCCGCACT -> AAAATGACGTTCCGCACTG
AAAACTGATGCACATCGCT -> AAACTGATGCACATCGCTA
AAAAGGTTAGATCACGGGA -> AAAGGTTAGATCACGGGAA
AAAATGACGTTCCGCACTG -> AAATGACGTTCCGCACTGT
AAAATGTTTTTCATCTTCT -> AAATGTTTTTCATCTTCTA
AAAATTTCCCCATCCGCCT -> AAATTTCCCCATCCGCCTA
AAACATTCAGCTTTGACCA -> AACATTCAGCTTTGACCAA
AAACGAGCAATAGGGAACT -> AACGAGCAATAGGGAACTA
AAACGAGCAATAGGGCACT -> AACGAGCAATAGGGCACTA
AAACGAGCAATAGGGGAAT -> AACGAGCAATAGGGGAATT
AAACGAGCAATAGGGTTGT -> AACGAGCAATAGGGTTGTG
AAACTATTTGGCTGGGGGC -> AACTATTTGGCTGGGGGCT
AAACTGATGCACATCGCTA -> AACTGATGCACATCGCTAC
AAACTTGCGTGTAATGATT -> AACTTGCGTGTAATGATTT
AAACTTTGTACAAGAAAGG -> AACTTTGTACAAGAAAGGC
AAAGAGGCCTTCGAGACCT -> AAGAGGCCTTCGAGACCTC
AAAGGAAGTAACCAAGTAC -> AAGGAAGTAACCAAGTACC
AAAGGAGCTGGTAAGACGG -> AAGGAGCTGGTAAGACGGT
AAAGGCCATAACCAGGGAT -> AAGGCCATAACCAGGGATT
AAAGGCCGCGTTGAGGAAC -> AAGGCCGCGTTGAGGAACT
AAAGGCTAACGAGTTGTTC -> AAGGCTAACGAGTTGTTCT
AAAGGTTAGATCACGGGAA -> AAGGTTAGATCACGGGAAA
AAAGTAGGAAATCAACGGG -> AAGTAGGAAATCAACGGGG
AAAGTCCGGCGCAATTACG -> AAGTCCGGCGCAATTACGT
AAAGTGCTCTCTTTGGCCT -> AAGTGCTCTCTTTGGCCTT
AAATAGAGCGGATGGCCAC -> AATAGAGCGGATGGCCACC
AAATATTAAGACGATTTAC -> AATATTAAGACGATTTACT
AAATCAACGGGGGCGGAAA -> AATCAACGGGGGCGGAAAA
AAATCCGCGGCTAACGCTC -> AATCCGCGGCTAACGCTCT
AAATCGTAAGCAGCAGAAG -> AATCGTAAGCAGCAGAAGC
AAATGACGTTCCGCACTGT -> AATGACGTTCCGCACTGTT
AAATGGATAATGAGCTACC -> AATGGATAATGAGCTACCG
AAATGTTTTTCATCTTCTA -> AATGTTTTTCATCTTCTAA
AAATTTCCCCATCCGCCTA -> AATTTCCCCATCCGCCTAC
AACAACTGCGCACTCTGTT -> ACAACTGCGCACTCTGTTC
AACACCTGGTGGAACCACG -> ACACCTGGTGGAACCACGA
AACAGACTAAAGGCCATAA -> ACAGACTAAAGGCCATAAC
AACAGAGCTTGAGTATACG -> ACAGAGCTTGAGTATACGT
AACAGCTCCATGCTTCGGG -> ACAGCTCCATGCTTCGGGT
AACAGGAGTCATTGGTAAA -> ACAGGAGTCATTGGTAAAA
AACATTCAGCTTTGACCAA -> ACATTCAGCTTTGACCAAA
AACCAAGAATGCGTGCGAC -> ACCAAGAATGCGTGCGACG,ACCAAGAATGCGTGCGACC,ACCAAGAATGCGTGCGACC,ACCAAGAATGCGTGCGACT
AACCAAGTACCATCTAACT -> ACCAAGTACCATCTAACTA
AACCACGAGGTGCGTAGAG -> ACCACGAGGTGCGTAGAGA
AACCAGGGATTCTAACGCA -> ACCAGGGATTCTAACGCAG
AACCCCAGCGCCCGAGGCT -> ACCCCAGCGCCCGAGGCTC
AACCCCCCCATATTCAAAT -> ACCCCCCCATATTCAAATA
AACCTGTTTTCATGGTCAC -> ACCTGTTTTCATGGTCACG
AACGAGCAATAGGGAACTA -> ACGAGCAATAGGGAACTAA
AACGAGCAATAGGGCACTA -> ACGAGCAATAGGGCACTAG
AACGAGCAATAGGGGAATT -> ACGAGCAATAGGGGAATTG
AACGAGCAATAGGGTTGTG -> ACGAGCAATAGGGTTGTGC
AACGAGTTGTTCTACGCAT -> ACGAGTTGTTCTACGCATA
AACGCAACGGATAATCCAC -> ACGCAACGGATAATCCACT
AACGCAGCTCTTACCAAAG -> ACGCAGCTCTTACCAAAGT
AACGCTCTTAGGGTAAGAG -> ACGCTCTTAGGGTAAGAGG
AACGGAAATCGTAAGCAGC -> ACGGAAATCGTAAGCAGCA
AACGGATAATCCACTTTGC -> ACGGATAATCCACTTTGCG
AACGGATCGTCATCCCACC -> ACGGATCGTCATCCCACCT
AACGGGGGCGGAAAATTTC -> ACGGGGGCGGAAAATTTCC
AACGGGTCGAACGCAACGG -> ACGGGTCGAACGCAACGGA
AACGTTGGCTTGACGAGTG -> ACGTTGGCTTGACGAGTGT
AACGTTTCGGGGCCCATGA -> ACGTTTCGGGGCCCATGAG
AACTAACGGGTCGAACGCA -> ACTAACGGGTCGAACGCAA
AACTAACTTCTATTACACG -> ACTAACTTCTATTACACGT
AACTAAGTTAGAACCAAGA -> ACTAAGTTAGAACCAAGAA
AACTAGACGGTTATATCAA -> ACTAGACGGTTATATCAAG
AACTATTTGGCTGGGGGCT -> ACTATTTGGCTGGGGGCTC
AACTCCCTCATGTGTTGTT -> ACTCCCTCATGTGTTGTTC
AACTCCCTTTCGACCGTTT -> ACTCCCTTTCGACCGTTTT
AACTCGCAGGAAGGGTTAT -> ACTCGCAGGAAGGGTTATA
AACTGATGCACATCGCTAC -> ACTGATGCACATCGCTACA
AACTGCGCACTCTGTTCTA -> ACTGCGCACTCTGTTCTAA
AACTGTCTGCGGTAGTTTC -> ACTGTCTGCGGTAGTTTCT
AACTGTGCGAACACCTGGT -> ACTGTGCGAACACCTGGTG
AACTGTTTCTATGGGTTCC -> ACTGTTTCTATGGGTTCCC
AACTTCTATTACACGTTCG -> ACTTCTATTACACGTTCGA
AACTTGCGTGTAATGATTT -> ACTTGCGTGTAATGATTTT
AACTTGCTACACGAGAACG -> ACTTGCTACACGAGAACGG
AACTTTGTACAAGAAAGGC -> ACTTTGTACAAGAAAGGCC
AAGAAAGGCCGCGTTGAGG -> AGAAAGGCCGCGTTGAGGA
AAGAACTGTGCGAACACCT -> AGAACTGTGCGAACACCTG
AAGAACTTGCTACACGAGA -> AGAACTTGCTACACGAGAA
AAGAATACGGCTGATCAGT -> AGAATACGGCTGATCAGTT
AAGAATGCGTGCGACCGCA -> AGAATGCGTGCGACCGCAT
AAGAATGCGTGCGACCGGA -> AGAATGCGTGCGACCGGAA
AAGAATGCGTGCGACGTTG -> AGAATGCGTGCGACGTTGA
AAGAATGCGTGCGACTAGC -> AGAATGCGTGCGACTAGCC
AAGACATAGTACCATCTCC -> AGACATAGTACCATCTCCT
AAGACGATTTACTACGACT -> AGACGATTTACTACGACTA
AAGACGGTGGAGTATCGCT -> AGACGGTGGAGTATCGCTG
AAGAGCGACCCGACTCGGT -> AGAGCGACCCGACTCGGTC
AAGAGGAGAAACGAGCAAT -> AGAGGAGAAACGAGCAATA
AAGAGGCCTTCGAGACCTC -> AGAGGCCTTCGAGACCTCC
AAGCACCATCAAACATTCA -> AGCACCATCAAACATTCAG
AAGCAGCAGAAGCTTTACA -> AGCAGCAGAAGCTTTACAG
AAGCAGTCAGCATTGCACC -> AGCAGTCAGCATTGCACCC
AAGCTCGGCGGAGGTAGGG -> AGCTCGGCGGAGGTAGGGG
AAGCTTTACAGGGTATAGC -> AGCTTTACAGGGTATAGCT
AAGGAAGTAACCAAGTACC -> AGGAAGTAACCAAGTACCA
AAGGAGCTGGTAAGACGGT -> AGGAGCTGGTAAGACGGTG
AAGGAGCTTTATGAACTCC -> AGGAGCTTTATGAACTCCC
AAGGATGCCGGTAACCTGT -> AGGATGCCGGTAACCTGTT
AAGGCACTCCAAAGTCCGG -> AGGCACTCCAAAGTCCGGC
AAGGCCATAACCAGGGATT -> AGGCCATAACCAGGGATTC
AAGGCCGCGTTGAGGAACT -> AGGCCGCGTTGAGGAACTC
AAGGCGTGAATGAAGTCAG -> AGGCGTGAATGAAGTCAGG
AAGGCTAACGAGTTGTTCT -> AGGCTAACGAGTTGTTCTA
AAGGGTTATAACGTTGGCT -> AGGGTTATAACGTTGGCTT
AAGGTAACAGGAGTCATTG -> AGGTAACAGGAGTCATTGG
AAGGTAGTTGTATCCGGCG -> AGGTAGTTGTATCCGGCGC
AAGGTTAGATCACGGGAAA -> AGGTTAGATCACGGGAAAT
AAGTAACCAAGTACCATCT -> AGTAACCAAGTACCATCTA
AAGTACCATCTAACTAACT -> AGTACCATCTAACTAACTT
AAGTAGGAAATCAACGGGG -> AGTAGGAAATCAACGGGGG
AAGTCAGGGGACGAAGTTA -> AGTCAGGGGACGAAGTTAT
AAGTCCGGCGCAATTACGT -> AGTCCGGCGCAATTACGTC
AAGTGCTCTCTTTGGCCTT -> AGTGCTCTCTTTGGCCTTT
AAGTGTCATAGCGCCATCG -> AGTGTCATAGCGCCATCGT
AAGTTAGAACCAAGAATGC -> AGTTAGAACCAAGAATGCG
AAGTTATTCTTGCACAAAG -> AGTTATTCTTGCACAAAGG
AAGTTTCTTAAGTGTCATA -> AGTTTCTTAAGTGTCATAG
AATACGGCTGATCAGTTAT -> ATACGGCTGATCAGTTATG
AATAGAGCGGATGGCCACC -> ATAGAGCGGATGGCCACCC
AATAGGGAACTAAGTTAGA -> ATAGGGAACTAAGTTAGAA
AATAGGGCACTAGCAGGGA -> ATAGGGCACTAGCAGGGAA
AATAGGGGAATTGCTTACA -> ATAGGGGAATTGCTTACAA
AATAGGGTTGTGCAGCGCA -> ATAGGGTTGTGCAGCGCAA
AATATTAAGACGATTTACT -> ATATTAAGACGATTTACTA
AATCAACGGGGGCGGAAAA -> ATCAACGGGGGCGGAAAAT
AATCCACTTTGCGTTTGTA -> ATCCACTTTGCGTTTGTAG
AATCCCCGCGTCCAGGCTA -> ATCCCCGCGTCCAGGCTAT
AATCCGCGGCTAACGCTCT -> ATCCGCGGCTAACGCTCTT
AATCGTAAGCAGCAGAAGC -> ATCGTAAGCAGCAGAAGCT
AATGAAGTCAGGGGACGAA -> ATGAAGTCAGGGGACGAAG
AATGACGTTCCGCACTGTT -> ATGACGTTCCGCACTGTTA
AATGAGCTACCGGACCAGA -> ATGAGCTACCGGACCAGAT
AATGAGTAGATTCCCAACC -> ATGAGTAGATTCCCAACCC
AATGATTTTCGCGCAAAGT -> ATGATTTTCGCGCAAAGTA
AATGCGTGCGACCGCATGT -> ATGCGTGCGACCGCATGTC
AATGCGTGCGACCGGAATT -> ATGCGTGCGACCGGAATTT
AATGCGTGCGACGTTGATA -> ATGCGTGCGACGTTGATAC
AATGCGTGCGACTAGCCGA -> ATGCGTGCGACTAGCCGAA
AATGGATAATGAGCTACCG -> ATGGATAATGAGCTACCGG
AATGGCCATCAGAGCGTTT -> ATGGCCATCAGAGCGTTTA
AATGTATACATTTGTTCCT -> ATGTATACATTTGTTCCTT
AATGTTTTTCATCTTCTAA -> ATGTTTTTCATCTTCTAAT
AATTACGTCCTAGTTTAAC -> ATTACGTCCTAGTTTAACT
AATTAGGATTTTCGAAATC -> ATTAGGATTTTCGAAATCC
AATTCGTCCAGCGTACAGC -> ATTCGTCCAGCGTACAGCA
AATTGCTTACAACCAAGAA -> ATTGCTTACAACCAAGAAT
AATTTAGACGAGAAACGAG -> ATTTAGACGAGAAACGAGC
AATTTCCCCATCCGCCTAC -> ATTTCCCCATCCGCCTACT
AATTTCTAACTAGACGGTT -> ATTTCTAACTAGACGGTTA
AATTTGAAGGTAACAGGAG -> ATTTGAAGGTAACAGGAGT
ACAAAGGAGCTGGTAAGAC -> CAAAGGAGCTGGTAAGACG
ACAACCAAGAATGCGTGCG -> CAACCAAGAATGCGTGCGA
ACAACTGCGCACTCTGTTC -> CAACTGCGCACTCTGTTCT
ACAAGAAAGGCCGCGTTGA -> CAAGAAAGGCCGCGTTGAG
ACAAGGCACTCCAAAGTCC -> CAAGGCACTCCAAAGTCCG
ACAAGGTAGTTGTATCCGG -> CAAGGTAGTTGTATCCGGC
ACACACACATAGTCCCCCA -> CACACACATAGTCCCCCAA
ACACACATAGTCCCCCAAT -> CACACATAGTCCCCCAATT
ACACAGCAAAGGAAGTAAC -> CACAGCAAAGGAAGTAACC
ACACATAGTCCCCCAATTT -> CACATAGTCCCCCAATTTC
ACACCCGGCTCTTGCCGCG -> CACCCGGCTCTTGCCGCGA
ACACCTGGTGGAACCACGA -> CACCTGGTGGAACCACGAG
ACACCTTGAAGTTTCTTAA -> CACCTTGAAGTTTCTTAAG
ACACGAGAACGGATCGTCA -> CACGAGAACGGATCGTCAT
ACACGTTCGATGCCATAGA -> CACGTTCGATGCCATAGAA
ACAGAACAGACTAAAGGCC -> CAGAACAGACTAAAGGCCA
ACAGACTAAAGGCCATAAC -> CAGACTAAAGGCCATAACC
ACAGAGCTTGAGTATACGT -> CAGAGCTTGAGTATACGTT
ACAGCAAAGGAAGTAACCA -> CAGCAAAGGAAGTAACCAA
ACAGCACACACACATAGTC -> CAGCACACACACATAGTCC
ACAGCATCTCAACAGCTCC -> CAGCATCTCAACAGCTCCA
ACAGCTCCATGCTTCGGGT -> CAGCTCCATGCTTCGGGTC
ACAGGAGTCATTGGTAAAA -> CAGGAGTCATTGGTAAAAT
ACAGGGTATAGCTGAGAGA -> CAGGGTATAGCTGAGAGAG
ACAGGTACCACCGACTGTC -> CAGGTACCACCGACTGTCA
ACAGTGAGAGTCAATGTAT -> CAGTGAGAGTCAATGTATA
ACATAGTACCATCTCCTTA -> CATAGTACCATCTCCTTAT
ACATAGTCCCCCAATTTCT -> CATAGTCCCCCAATTTCTA
ACATCGCTACACAGCAAAG -> CATCGCTACACAGCAAAGG
ACATTCAGCTTTGACCAAA -> CATTCAGCTTTGACCAAAA
ACATTTGTTCCTTCATAGC -> CATTTGTTCCTTCATAGCT
ACCAAAACTGATGCACATC -> CCAAAACTGATGCACATCG
ACCAAAGTGCTCTCTTTGG -> CCAAAGTGCTCTCTTTGGC
ACCAAGAATGCGTGCGACC -> CCAAGAATGCGTGCGACCG,CCAAGAATGCGTGCGACCG
ACCAAGAATGCGTGCGACG -> CCAAGAATGCGTGCGACGT
ACCAAGAATGCGTGCGACT -> CCAAGAATGCGTGCGACTA
ACCAAGTACCATCTAACTA -> CCAAGTACCATCTAACTAA
ACCACCGACTGTCAGGGTG -> CCACCGACTGTCAGGGTGA
ACCACGAGGTGCGTAGAGA -> CCACGAGGTGCGTAGAGAA
ACCAGATCATAACTGTCTG -> CCAGATCATAACTGTCTGC
ACCAGGAGGTAGTCTAGAA -> CCAGGAGGTAGTCTAGAAC
ACCAGGGATTCTAACGCAG -> CCAGGGATTCTAACGCAGC
ACCATCAAACATTCAGCTT -> CCATCAAACATTCAGCTTT
ACCATCTAACTAACTTCTA -> CCATCTAACTAACTTCTAT
ACCATCTCCTTATTCTGTT -> CCATCTCCTTATTCTGTTA
ACCCACTCACCGCGCTGGA -> CCCACTCACCGCGCTGGAC
ACCCCAGCGCCCGAGGCTC -> CCCCAGCGCCCGAGGCTCC
ACCCCCCCATATTCAAATA -> CCCCCCCATATTCAAATAT
ACCCGACTCGGTCTTCGGA -> CCCGACTCGGTCTTCGGAA
ACCCGGCTCTTGCCGCGAT -> CCCGGCTCTTGCCGCGATA
ACCCTAGGTTTATTACTGC -> CCCTAGGTTTATTACTGCC
ACCCTGAACTCGCAGGAAG -> CCCTGAACTCGCAGGAAGG
ACCGACTGTCAGGGTGAAA -> CCGACTGTCAGGGTGAAAG
ACCGCATGTCCGCGTGTTA -> CCGCATGTCCGCGTGTTAT
ACCGCGCTGGACCTATAAC -> CCGCGCTGGACCTATAACG
ACCGGAATTTGAAGGTAAC -> CCGGAATTTGAAGGTAACA
ACCGGACCAGATCATAACT -> CCGGACCAGATCATAACTG
ACCGGTTCAAGCAGTCAGC -> CCGGTTCAAGCAGTCAGCA
ACCGTATCCGAGGCTGCTG -> CCGTATCCGAGGCTGCTGC
ACCGTCAGCGAGGAGGGAC -> CCGTCAGCGAGGAGGGACA
ACCGTTTTGGGAAGGTACA -> CCGTTTTGGGAAGGTACAA
ACCTATAACGTTTCGGGGC -> CCTATAACGTTTCGGGGCC
ACCTCCCAAGAACTGTGCG -> CCTCCCAAGAACTGTGCGA
ACCTGGTGGAACCACGAGG -> CCTGGTGGAACCACGAGGT
ACCTGTTTTCATGGTCACG -> CCTGTTTTCATGGTCACGA
ACCTTATAAGGCGTGAATG -> CCTTATAAGGCGTGAATGA
ACCTTGAAGTTTCTTAAGT -> CCTTGAAGTTTCTTAAGTG
ACGAAGTTATTCTTGCACA -> CGAAGTTATTCTTGCACAA
ACGACCAGGAGGTAGTCTA -> CGACCAGGAGGTAGTCTAG
ACGACTATCTCTCCGACTG -> CGACTATCTCTCCGACTGA
ACGAGAAACGAGCAATAGG -> CGAGAAACGAGCAATAGGG
ACGAGAACGGATCGTCATC -> CGAGAACGGATCGTCATCC
ACGAGAGAAACGAGCAATA -> CGAGAGAAACGAGCAATAG
ACGAGCAATAGGGAACTAA -> CGAGCAATAGGGAACTAAG
ACGAGCAATAGGGCACTAG -> CGAGCAATAGGGCACTAGC
ACGAGCAATAGGGGAATTG -> CGAGCAATAGGGGAATTGC
ACGAGCAATAGGGTTGTGC -> CGAGCAATAGGGTTGTGCA
ACGAGGTGCGTAGAGAAGC -> CGAGGTGCGTAGAGAAGCA
ACGAGTGTTAAAAAAATGA -> CGAGTGTTAAAAAAATGAC
ACGAGTTGTTCTACGCATA -> CGAGTTGTTCTACGCATAG
ACGATTAATGAGTAGATTC -> CGATTAATGAGTAGATTCC
ACGATTTACTAAGCTCGGC -> CGATTTACTAAGCTCGGCG
ACGATTTACTACGACTATC -> CGATTTACTACGACTATCT
ACGCAACGGATAATCCACT -> CGCAACGGATAATCCACTT
ACGCAGCTCTTACCAAAGT -> CGCAGCTCTTACCAAAGTG
ACGCATAGGGACGATTTAC -> CGCATAGGGACGATTTACT
ACGCTCTTAGGGTAAGAGG -> CGCTCTTAGGGTAAGAGGA
ACGCTCTTCGGTTAGACCG -> CGCTCTTCGGTTAGACCGT
ACGGAAATCGTAAGCAGCA -> CGGAAATCGTAAGCAGCAG
ACGGATAATCCACTTTGCG -> CGGATAATCCACTTTGCGT
ACGGATCGTCATCCCACCT -> CGGATCGTCATCCCACCTT
ACGGCTGATCAGTTATGCC -> CGGCTGATCAGTTATGCCC
ACGGGAAATGGATAATGAG -> CGGGAAATGGATAATGAGC
ACGGGGGCGGAAAATTTCC -> CGGGGGCGGAAAATTTCCC
ACGGGTCGAACGCAACGGA -> CGGGTCGAACGCAACGGAT
ACGGTCTTGCCATTTTGTA -> CGGTCTTGCCATTTTGTAT
ACGGTGGAGTATCGCTGAG -> CGGTGGAGTATCGCTGAGA
ACGGTTATATCAAGGAGCT -> CGGTTATATCAAGGAGCTT
ACGTCCTAGTTTAACTAAC -> CGTCCTAGTTTAACTAACG
ACGTTCCGCACTGTTATGT -> CGTTCCGCACTGTTATGTG
ACGTTCGATGCCATAGAAC -> CGTTCGATGCCATAGAACA
ACGTTGATACTTCGTTGGT -> CGTTGATACTTCGTTGGTA
ACGTTGGCTTGACGAGTGT -> CGTTGGCTTGACGAGTGTT
ACGTTGTAAATAGAGCGGA -> CGTTGTAAATAGAGCGGAT
ACGTTTCGGGGCCCATGAG -> CGTTTCGGGGCCCATGAGT
ACTAAAGGCCATAACCAGG -> CTAAAGGCCATAACCAGGG
ACTAACGGGTCGAACGCAA -> CTAACGGGTCGAACGCAAC
ACTAACTTCTATTACACGT -> CTAACTTCTATTACACGTT
ACTAAGAACTTGCTACACG -> CTAAGAACTTGCTACACGA
ACTAAGCTCGGCGGAGGTA -> CTAAGCTCGGCGGAGGTAG
ACTAAGTTAGAACCAAGAA -> CTAAGTTAGAACCAAGAAT
ACTACGACTATCTCTCCGA -> CTACGACTATCTCTCCGAC
ACTAGACGGTCTTGCCATT -> CTAGACGGTCTTGCCATTT
ACTAGACGGTTATATCAAG -> CTAGACGGTTATATCAAGG
ACTAGCAGGGAACCAAGAA -> CTAGCAGGGAACCAAGAAT
ACTAGCCGAAACTTTGTAC -> CTAGCCGAAACTTTGTACA
ACTATCTCTCCGACTGACA -> CTATCTCTCCGACTGACAG
ACTATTTGGCTGGGGGCTC -> CTATTTGGCTGGGGGCTCT
ACTCACCGCGCTGGACCTA -> CTCACCGCGCTGGACCTAT
ACTCCAAAGTCCGGCGCAA -> CTCCAAAGTCCGGCGCAAT
ACTCCCTCATGTGTTGTTC -> CTCCCTCATGTGTTGTTCC
ACTCCCTTTCGACCGTTTT -> CTCCCTTTCGACCGTTTTG
ACTCGCAGGAAGGGTTATA -> CTCGCAGGAAGGGTTATAA
ACTCGGTCTTCGGAAGAAT -> CTCGGTCTTCGGAAGAATA
ACTCTGTAGAGTAGAGTGT -> CTCTGTAGAGTAGAGTGTG
ACTCTGTTCTAATTTAGAC -> CTCTGTTCTAATTTAGACG
ACTGACAGGTACCACCGAC -> CTGACAGGTACCACCGACT
ACTGATGCACATCGCTACA -> CTGATGCACATCGCTACAC
ACTGCCGCGCTTCCTAGGG -> CTGCCGCGCTTCCTAGGGG
ACTGCGCACTCTGTTCTAA -> CTGCGCACTCTGTTCTAAT
ACTGTCAGGGTGAAAGAGG -> CTGTCAGGGTGAAAGAGGC
ACTGTCTGCGGTAGTTTCT -> CTGTCTGCGGTAGTTTCTA
ACTGTGCGAACACCTGGTG -> CTGTGCGAACACCTGGTGG
ACTGTTATGTGCAAGGATG -> CTGTTATGTGCAAGGATGC
ACTGTTTCTATGGGTTCCC -> CTGTTTCTATGGGTTCCCC
ACTTCGTTGGTAGTGCTGT -> CTTCGTTGGTAGTGCTGTC
ACTTCTATTACACGTTCGA -> CTTCTATTACACGTTCGAT
ACTTGCGTGTAATGATTTT -> CTTGCGTGTAATGATTTTC
ACTTGCTACACGAGAACGG -> CTTGCTACACGAGAACGGA
ACTTGTCATATCTAGATCA -> CTTGTCATATCTAGATCAA
ACTTTGCGTTTGTAGGTTG -> CTTTGCGTTTGTAGGTTGG
ACTTTGTACAAGAAAGGCC -> CTTTGTACAAGAAAGGCCG
AGAAACGAGCAATAGGGAA -> GAAACGAGCAATAGGGAAC
AGAAACGAGCAATAGGGCA -> GAAACGAGCAATAGGGCAC
AGAAACGAGCAATAGGGGA -> GAAACGAGCAATAGGGGAA
AGAAACGAGCAATAGGGTT -> GAAACGAGCAATAGGGTTG
AGAAACTTGCGTGTAATGA -> GAAACTTGCGTGTAATGAT
AGAAAGGCCGCGTTGAGGA -> GAAAGGCCGCGTTGAGGAA
AGAACAACTGCGCACTCTG -> GAACAACTGCGCACTCTGT
AGAACAGACTAAAGGCCAT -> GAACAGACTAAAGGCCATA
AGAACAGAGCTTGAGTATA -> GAACAGAGCTTGAGTATAC
AGAACCAAGAATGCGTGCG -> GAACCAAGAATGCGTGCGA
AGAACGGATCGTCATCCCA -> GAACGGATCGTCATCCCAC
AGAACTGTGCGAACACCTG -> GAACTGTGCGAACACCTGG
AGAACTGTTTCTATGGGTT -> GAACTGTTTCTATGGGTTC
AGAACTTGCTACACGAGAA -> GAACTTGCTACACGAGAAC
AGAAGCACCATCAAACATT -> GAAGCACCATCAAACATTC
AGAAGCTTTACAGGGTATA -> GAAGCTTTACAGGGTATAG
AGAATACGGCTGATCAGTT -> GAATACGGCTGATCAGTTA
AGAATGCGTGCGACCGCAT -> GAATGCGTGCGACCGCATG
AGAATGCGTGCGACCGGAA -> GAATGCGTGCGACCGGAAT
AGAATGCGTGCGACGTTGA -> GAATGCGTGCGACGTTGAT
AGAATGCGTGCGACTAGCC -> GAATGCGTGCGACTAGCCG
AGACATAGTACCATCTCCT -> GACATAGTACCATCTCCTT
AGACCCACTCACCGCGCTG -> GACCCACTCACCGCGCTGG
AGACCGTCAGCGAGGAGGG -> GACCGTCAGCGAGGAGGGA
AGACCTCCCAAGAACTGTG -> GACCTCCCAAGAACTGTGC
AGACGACCAGGAGGTAGTC -> GACGACCAGGAGGTAGTCT
AGACGAGAAACGAGCAATA -> GACGAGAAACGAGCAATAG
AGACGATTTACTACGACTA -> GACGATTTACTACGACTAT
AGACGGTCTTGCCATTTTG -> GACGGTCTTGCCATTTTGT
AGACGGTGGAGTATCGCTG -> GACGGTGGAGTATCGCTGA
AGACGGTTATATCAAGGAG -> GACGGTTATATCAAGGAGC
AGACTAAAGGCCATAACCA -> GACTAAAGGCCATAACCAG
AGAGAAACGAGCAATAGGG -> GAGAAACGAGCAATAGGGA
AGAGAAGCACCATCAAACA -> GAGAAGCACCATCAAACAT
AGAGACCCACTCACCGCGC -> GAGACCCACTCACCGCGCT
AGAGAGACCCACTCACCGC -> GAGAGACCCACTCACCGCG
AGAGAGAGACCCACTCACC -> GAGAGAGACCCACTCACCG
AGAGCGACCCGACTCGGTC -> GAGCGACCCGACTCGGTCT
AGAGCGGATGGCCACCCTA -> GAGCGGATGGCCACCCTAG
AGAGCGTTTATACAGCACA -> GAGCGTTTATACAGCACAC
AGAGCTTGAGTATACGTTG -> GAGCTTGAGTATACGTTGT
AGAGGAGAAACGAGCAATA -> GAGGAGAAACGAGCAATAG
AGAGGCCTTCGAGACCTCC -> GAGGCCTTCGAGACCTCCC
AGAGTAGAGTGTGTGCTAC -> GAGTAGAGTGTGTGCTACT
AGAGTCAATGTATACATTT -> GAGTCAATGTATACATTTG
AGAGTGTGTGCTACTAAGA -> GAGTGTGTGCTACTAAGAA
AGATCAAAAGGTTAGATCA -> GATCAAAAGGTTAGATCAC
AGATCACGGGAAATGGATA -> GATCACGGGAAATGGATAA
AGATCATAACTGTCTGCGG -> GATCATAACTGTCTGCGGT
AGATTCCCAACCCCAGCGC -> GATTCCCAACCCCAGCGCC
AGCAAAGGAAGTAACCAAG -> GCAAAGGAAGTAACCAAGT
AGCAATAGGGAACTAAGTT -> GCAATAGGGAACTAAGTTA
AGCAATAGGGCACTAGCAG -> GCAATAGGGCACTAGCAGG
AGCAATAGGGGAATTGCTT -> GCAATAGGGGAATTGCTTA
AGCAATAGGGTTGTGCAGC -> GCAATAGGGTTGTGCAGCG
AGCACACACACATAGTCCC -> GCACACACACATAGTCCCC
AGCACACCCGGCTCTTGCC -> GCACACCCGGCTCTTGCCG
AGCACCATCAAACATTCAG -> GCACCATCAAACATTCAGC
AGCAGAAGCTTTACAGGGT -> GCAGAAGCTTTACAGGGTA
AGCAGCAGAAGCTTTACAG -> GCAGCAGAAGCTTTACAGG
AGCAGGGAACCAAGAATGC -> GCAGGGAACCAAGAATGCG
AGCAGTCAGCATTGCACCC -> GCAGTCAGCATTGCACCCT
AGCATCTCAACAGCTCCAT -> GCATCTCAACAGCTCCATG
AGCATTGCACCCTGAACTC -> GCATTGCACCCTGAACTCG
AGCCGAAACTTTGTACAAG -> GCCGAAACTTTGTACAAGA
AGCGACCCGACTCGGTCTT -> GCGACCCGACTCGGTCTTC
AGCGAGGAGGGACACCTTG -> GCGAGGAGGGACACCTTGA
AGCGCAACCAAGAATGCGT -> GCGCAACCAAGAATGCGTG
AGCGCCATCGTAGCGGTTA -> GCGCCATCGTAGCGGTTAT
AGCGCCCGAGGCTCCAGTC -> GCGCCCGAGGCTCCAGTCC
AGCGGATGGCCACCCTAGG -> GCGGATGGCCACCCTAGGT
AGCGGTTATCCTTATCTGT -> GCGGTTATCCTTATCTGTA
AGCGTACAGCATCTCAACA -> GCGTACAGCATCTCAACAG
AGCGTGGTGTTTACTCTGT -> GCGTGGTGTTTACTCTGTA
AGCGTTTATACAGCACACA -> GCGTTTATACAGCACACAC
AGCTAATGGCCATCAGAGC -> GCTAATGGCCATCAGAGCG
AGCTACCGGACCAGATCAT -> GCTACCGGACCAGATCATA
AGCTAGCGTGGTGTTTACT -> GCTAGCGTGGTGTTTACTC
AGCTCCATGCTTCGGGTCC -> GCTCCATGCTTCGGGTCCC
AGCTCGGCGGAGGTAGGGG -> GCTCGGCGGAGGTAGGGGC
AGCTCTTACCAAAGTGCTC -> GCTCTTACCAAAGTGCTCT
AGCTGAGAGAGAGACCCAC -> GCTGAGAGAGAGACCCACT
AGCTGGTAAGACGGTGGAG -> GCTGGTAAGACGGTGGAGT
AGCTTGAGTATACGTTGTA -> GCTTGAGTATACGTTGTAA
AGCTTTACAGGGTATAGCT -> GCTTTACAGGGTATAGCTG
AGCTTTATGAACTCCCTTT -> GCTTTATGAACTCCCTTTC
AGCTTTGACCAAAACTGAT -> GCTTTGACCAAAACTGATG
AGGAAATCAACGGGGGCGG -> GGAAATCAACGGGGGCGGA
AGGAACTCCCTCATGTGTT -> GGAACTCCCTCATGTGTTG
AGGAAGGGTTATAACGTTG -> GGAAGGGTTATAACGTTGG
AGGAAGTAACCAAGTACCA -> GGAAGTAACCAAGTACCAT
AGGAGAAACGAGCAATAGG -> GGAGAAACGAGCAATAGGG
AGGAGAAACTTGCGTGTAA -> GGAGAAACTTGCGTGTAAT
AGGAGCTGGTAAGACGGTG -> GGAGCTGGTAAGACGGTGG
AGGAGCTTTATGAACTCCC -> GGAGCTTTATGAACTCCCT
AGGAGGGACACCTTGAAGT -> GGAGGGACACCTTGAAGTT
AGGAGGTAGTCTAGAACTG -> GGAGGTAGTCTAGAACTGT
AGGAGTCATTGGTAAAATG -> GGAGTCATTGGTAAAATGT
AGGATGCCGGTAACCTGTT -> GGATGCCGGTAACCTGTTT
AGGATTTCAGGTTCCAAAC -> GGATTTCAGGTTCCAAACT
AGGATTTTCGAAATCCGCG -> GGATTTTCGAAATCCGCGG
AGGCACTCCAAAGTCCGGC -> GGCACTCCAAAGTCCGGCG
AGGCCATAACCAGGGATTC -> GGCCATAACCAGGGATTCT
AGGCCGCGTTGAGGAACTC -> GGCCGCGTTGAGGAACTCC
AGGCCTTCGAGACCTCCCA -> GGCCTTCGAGACCTCCCAA
AGGCGTGAATGAAGTCAGG -> GGCGTGAATGAAGTCAGGG
AGGCTAACGAGTTGTTCTA -> GGCTAACGAGTTGTTCTAC
AGGCTATAGACGACCAGGA -> GGCTATAGACGACCAGGAG
AGGCTCCAGTCCAACCCCC -> GGCTCCAGTCCAACCCCCC
AGGCTGCTGCAGAACAGAG -> GGCTGCTGCAGAACAGAGC
AGGGAACCAAGAATGCGTG -> GGGAACCAAGAATGCGTGC
AGGGAACTAAGTTAGAACC -> GGGAACTAAGTTAGAACCA
AGGGACACCTTGAAGTTTC -> GGGACACCTTGAAGTTTCT
AGGGACGATTTACTAAGCT -> GGGACGATTTACTAAGCTC
AGGGATTCTAACGCAGCTC -> GGGATTCTAACGCAGCTCT
AGGGCACTAGCAGGGAACC -> GGGCACTAGCAGGGAACCA
AGGGCCAACGGAAATCGTA -> GGGCCAACGGAAATCGTAA
AGGGGAATTGCTTACAACC -> GGGGAATTGCTTACAACCA
AGGGGACGAAGTTATTCTT -> GGGGACGAAGTTATTCTTG
AGGGGCAAGAGCGACCCGA -> GGGGCAAGAGCGACCCGAC
AGGGGCAATTAGGATTTTC -> GGGGCAATTAGGATTTTCG
AGGGTAAGAGGAGAAACGA -> GGGTAAGAGGAGAAACGAG
AGGGTATAGCTGAGAGAGA -> GGGTATAGCTGAGAGAGAG
AGGGTGAAAGAGGCCTTCG -> GGGTGAAAGAGGCCTTCGA
AGGGTTATAACGTTGGCTT -> GGGTTATAACGTTGGCTTG
AGGGTTGTGCAGCGCAACC -> GGGTTGTGCAGCGCAACCA
AGGTAACAGGAGTCATTGG -> GGTAACAGGAGTCATTGGT
AGGTACCACCGACTGTCAG -> GGTACCACCGACTGTCAGG
AGGTAGGGGCAATTAGGAT -> GGTAGGGGCAATTAGGATT
AGGTAGTCTAGAACTGTTT -> GGTAGTCTAGAACTGTTTC
AGGTAGTTGTATCCGGCGC -> GGTAGTTGTATCCGGCGCA
AGGTGCGTAGAGAAGCACC -> GGTGCGTAGAGAAGCACCA
AGGTTAGATCACGGGAAAT -> GGTTAGATCACGGGAAATG
AGGTTCCAAACTATTTGGC -> GGTTCCAAACTATTTGGCT
AGGTTGGGTTACAGTGAGA -> GGTTGGGTTACAGTGAGAG
AGGTTTATTACTGCCGCGC -> GGTTTATTACTGCCGCGCT
AGTAACCAAGTACCATCTA -> GTAACCAAGTACCATCTAA
AGTACCATCTAACTAACTT -> GTACCATCTAACTAACTTC
AGTACCATCTCCTTATTCT -> GTACCATCTCCTTATTCTG
AGTAGAGTGTGTGCTACTA -> GTAGAGTGTGTGCTACTAA
AGTAGATTCCCAACCCCAG -> GTAGATTCCCAACCCCAGC
AGTAGCACACCCGGCTCTT -> GTAGCACACCCGGCTCTTG
AGTAGGAAATCAACGGGGG -> GTAGGAAATCAACGGGGGC
AGTATACGTTGTAAATAGA -> GTATACGTTGTAAATAGAG
AGTATCGCTGAGAAACGAG -> GTATCGCTGAGAAACGAGC
AGTCAATGTATACATTTGT -> GTCAATGTATACATTTGTT
AGTCAGCATTGCACCCTGA -> GTCAGCATTGCACCCTGAA
AGTCAGGGGACGAAGTTAT -> GTCAGGGGACGAAGTTATT
AGTCATTGGTAAAATGTTT -> GTCATTGGTAAAATGTTTT
AGTCCAACCCCCCCATATT -> GTCCAACCCCCCCATATTC
AGTCCCCCAATTTCTAACT -> GTCCCCCAATTTCTAACTA
AGTCCGGCGCAATTACGTC -> GTCCGGCGCAATTACGTCC
AGTCTAGAACTGTTTCTAT -> GTCTAGAACTGTTTCTATG
AGTGAGAGTCAATGTATAC -> GTGAGAGTCAATGTATACA
AGTGCTCTCTTTGGCCTTT -> GTGCTCTCTTTGGCCTTTA
AGTGCTGTCACAGAACAGA -> GTGCTGTCACAGAACAGAC
AGTGTCATAGCGCCATCGT -> GTGTCATAGCGCCATCGTA
AGTGTGTGCTACTAAGAAC -> GTGTGTGCTACTAAGAACT
AGTGTTAAAAAAATGACGT -> GTGTTAAAAAAATGACGTT
AGTTAGAACCAAGAATGCG -> GTTAGAACCAAGAATGCGT
AGTTATGCCCGTGATATAG -> GTTATGCCCGTGATATAGG
AGTTATTCTTGCACAAAGG -> GTTATTCTTGCACAAAGGA
AGTTGTATCCGGCGCACTA -> GTTGTATCCGGCGCACTAG
AGTTGTTCTACGCATAGGG -> GTTGTTCTACGCATAGGGA
AGTTTAACTAACGGGTCGA -> GTTTAACTAACGGGTCGAA
AGTTTCTAAGACATAGTAC -> GTTTCTAAGACATAGTACC
AGTTTCTTAAGTGTCATAG -> GTTTCTTAAGTGTCATAGC
ATAACCAGGGATTCTAACG -> TAACCAGGGATTCTAACGC
ATAACGTTGGCTTGACGAG -> TAACGTTGGCTTGACGAGT
ATAACGTTTCGGGGCCCAT -> TAACGTTTCGGGGCCCATG
ATAACTGTCTGCGGTAGTT -> TAACTGTCTGCGGTAGTTT
ATAAGGCGTGAATGAAGTC -> TAAGGCGTGAATGAAGTCA
ATAATCCACTTTGCGTTTG -> TAATCCACTTTGCGTTTGT
ATAATGAGCTACCGGACCA -> TAATGAGCTACCGGACCAG
ATACAGCACACACACATAG -> TACAGCACACACACATAGT
ATACATTTGTTCCTTCATA -> TACATTTGTTCCTTCATAG
ATACCGGTTCAAGCAGTCA -> TACCGGTTCAAGCAGTCAG
ATACGGCTGATCAGTTATG -> TACGGCTGATCAGTTATGC
ATACGTTGTAAATAGAGCG -> TACGTTGTAAATAGAGCGG
ATACTTCGTTGGTAGTGCT -> TACTTCGTTGGTAGTGCTG
ATAGAACAACTGCGCACTC -> TAGAACAACTGCGCACTCT
ATAGACGACCAGGAGGTAG -> TAGACGACCAGGAGGTAGT
ATAGAGCGGATGGCCACCC -> TAGAGCGGATGGCCACCCT
ATAGCGCCATCGTAGCGGT -> TAGCGCCATCGTAGCGGTT
ATAGCTAATGGCCATCAGA -> TAGCTAATGGCCATCAGAG
ATAGCTGAGAGAGAGACCC -> TAGCTGAGAGAGAGACCCA
ATAGGATTTCAGGTTCCAA -> TAGGATTTCAGGTTCCAAA
ATAGGGAACTAAGTTAGAA -> TAGGGAACTAAGTTAGAAC
ATAGGGACGATTTACTAAG -> TAGGGACGATTTACTAAGC
ATAGGGCACTAGCAGGGAA -> TAGGGCACTAGCAGGGAAC
ATAGGGGAATTGCTTACAA -> TAGGGGAATTGCTTACAAC
ATAGGGTTGTGCAGCGCAA -> TAGGGTTGTGCAGCGCAAC
ATAGTACCATCTCCTTATT -> TAGTACCATCTCCTTATTC
ATAGTCCCCCAATTTCTAA -> TAGTCCCCCAATTTCTAAC
ATATAGGATTTCAGGTTCC -> TATAGGATTTCAGGTTCCA
ATATCAAGGAGCTTTATGA -> TATCAAGGAGCTTTATGAA
ATATCTAGATCAAAAGGTT -> TATCTAGATCAAAAGGTTA
ATATGCCATACCGGTTCAA -> TATGCCATACCGGTTCAAG
ATATTAAGACGATTTACTA -> TATTAAGACGATTTACTAC
ATATTCAAATATTAAGACG -> TATTCAAATATTAAGACGA
ATCAAAAGGTTAGATCACG -> TCAAAAGGTTAGATCACGG
ATCAAACATTCAGCTTTGA -> TCAAACATTCAGCTTTGAC
ATCAACGGGGGCGGAAAAT -> TCAACGGGGGCGGAAAATT
ATCAAGGAGCTTTATGAAC -> TCAAGGAGCTTTATGAACT
ATCACGGGAAATGGATAAT -> TCACGGGAAATGGATAATG
ATCAGAGCGTTTATACAGC -> TCAGAGCGTTTATACAGCA
ATCAGTTATGCCCGTGATA -> TCAGTTATGCCCGTGATAT
ATCATAACTGTCTGCGGTA -> TCATAACTGTCTGCGGTAG
ATCCACTTTGCGTTTGTAG -> TCCACTTTGCGTTTGTAGG
ATCCCACCTTATAAGGCGT -> TCCCACCTTATAAGGCGTG
ATCCCCGCGTCCAGGCTAT -> TCCCCGCGTCCAGGCTATA
ATCCGAGGCTGCTGCAGAA -> TCCGAGGCTGCTGCAGAAC
ATCCGCCTACTTGTCATAT -> TCCGCCTACTTGTCATATC
ATCCGCGGCTAACGCTCTT -> TCCGCGGCTAACGCTCTTA
ATCCGGCGCACTAGACGGT -> TCCGGCGCACTAGACGGTC
ATCCGTCTTCCACGCTCTT -> TCCGTCTTCCACGCTCTTC
ATCCTGGATGTGTGTACGA -> TCCTGGATGTGTGTACGAG
ATCCTTATCTGTATCTGTC -> TCCTTATCTGTATCTGTCC
ATCGCTACACAGCAAAGGA -> TCGCTACACAGCAAAGGAA
ATCGCTGAGAAACGAGCAA -> TCGCTGAGAAACGAGCAAT
ATCGTAAGCAGCAGAAGCT -> TCGTAAGCAGCAGAAGCTT
ATCGTAGCGGTTATCCTTA -> TCGTAGCGGTTATCCTTAT
ATCGTCATCCCACCTTATA -> TCGTCATCCCACCTTATAA
ATCGTTTTAATCCCCGCGT -> TCGTTTTAATCCCCGCGTC
ATCTAACTAACTTCTATTA -> TCTAACTAACTTCTATTAC
ATCTAGATCAAAAGGTTAG -> TCTAGATCAAAAGGTTAGA
ATCTCAACAGCTCCATGCT -> TCTCAACAGCTCCATGCTT
ATCTCCTTATTCTGTTAGC -> TCTCCTTATTCTGTTAGCT
ATCTCTCCGACTGACAGGT -> TCTCTCCGACTGACAGGTA
ATCTGTATCTGTCCCAGGG -> TCTGTATCTGTCCCAGGGC
ATCTGTCCCAGGGCCAACG -> TCTGTCCCAGGGCCAACGG
ATCTTCTAATTCGTCCAGC -> TCTTCTAATTCGTCCAGCG
ATGAACTCCCTTTCGACCG -> TGAACTCCCTTTCGACCGT
ATGAAGTCAGGGGACGAAG -> TGAAGTCAGGGGACGAAGT
ATGACGTTCCGCACTGTTA -> TGACGTTCCGCACTGTTAT
ATGAGCTACCGGACCAGAT -> TGAGCTACCGGACCAGATC
ATGAGTAGATTCCCAACCC -> TGAGTAGATTCCCAACCCC
ATGAGTAGCACACCCGGCT -> TGAGTAGCACACCCGGCTC
ATGATTTTCGCGCAAAGTA -> TGATTTTCGCGCAAAGTAG
ATGCACATCGCTACACAGC -> TGCACATCGCTACACAGCA
ATGCCATACCGGTTCAAGC -> TGCCATACCGGTTCAAGCA
ATGCCATAGAACAACTGCG -> TGCCATAGAACAACTGCGC
ATGCCCGTGATATAGGATT -> TGCCCGTGATATAGGATTT
ATGCCGGTAACCTGTTTTC -> TGCCGGTAACCTGTTTTCA
ATGCGTGCGACCGCATGTC -> TGCGTGCGACCGCATGTCC
ATGCGTGCGACCGGAATTT -> TGCGTGCGACCGGAATTTG
ATGCGTGCGACGTTGATAC -> TGCGTGCGACGTTGATACT
ATGCGTGCGACTAGCCGAA -> TGCGTGCGACTAGCCGAAA
ATGCTTCGGGTCCCGCAAA -> TGCTTCGGGTCCCGCAAAG
ATGGATAATGAGCTACCGG -> TGGATAATGAGCTACCGGA
ATGGCCACCCTAGGTTTAT -> TGGCCACCCTAGGTTTATT
ATGGCCATCAGAGCGTTTA -> TGGCCATCAGAGCGTTTAT
ATGGGTTCCCCTCAGGAGA -> TGGGTTCCCCTCAGGAGAA
ATGGTCACGATTAATGAGT -> TGGTCACGATTAATGAGTA
ATGTATACATTTGTTCCTT -> TGTATACATTTGTTCCTTC
ATGTCCGCGTGTTATCGTT -> TGTCCGCGTGTTATCGTTT
ATGTGCAAGGATGCCGGTA -> TGTGCAAGGATGCCGGTAA
ATGTGTGTACGAGAGAAAC -> TGTGTGTACGAGAGAAACG
ATGTGTTGTTCCTGTGTAT -> TGTGTTGTTCCTGTGTATC
ATGTTTTTCATCTTCTAAT -> TGTTTTTCATCTTCTAATT
ATTAAGACGATTTACTACG -> TTAAGACGATTTACTACGA
ATTAATGAGTAGATTCCCA -> TTAATGAGTAGATTCCCAA
ATTACACGTTCGATGCCAT -> TTACACGTTCGATGCCATA
ATTACGTCCTAGTTTAACT -> TTACGTCCTAGTTTAACTA
ATTACTGCCGCGCTTCCTA -> TTACTGCCGCGCTTCCTAG
ATTAGGATTTTCGAAATCC -> TTAGGATTTTCGAAATCCG
ATTCAAATATTAAGACGAT -> TTCAAATATTAAGACGATT
ATTCAGCTTTGACCAAAAC -> TTCAGCTTTGACCAAAACT
ATTCCCAACCCCAGCGCCC -> TTCCCAACCCCAGCGCCCG
ATTCGTCCAGCGTACAGCA -> TTCGTCCAGCGTACAGCAT
ATTCTAACGCAGCTCTTAC -> TTCTAACGCAGCTCTTACC
ATTCTGTTAGCTAGCGTGG -> TTCTGTTAGCTAGCGTGGT
ATTCTTGCACAAAGGAGCT -> TTCTTGCACAAAGGAGCTG
ATTGCACCCTGAACTCGCA -> TTGCACCCTGAACTCGCAG
ATTGCTTACAACCAAGAAT -> TTGCTTACAACCAAGAATG
ATTGGTAAAATGTTTTTCA -> TTGGTAAAATGTTTTTCAT
ATTTACTAAGCTCGGCGGA -> TTTACTAAGCTCGGCGGAG
ATTTACTACGACTATCTCT -> TTTACTACGACTATCTCTC
ATTTAGACGAGAAACGAGC -> TTTAGACGAGAAACGAGCA
ATTTCAGGTTCCAAACTAT -> TTTCAGGTTCCAAACTATT
ATTTCCCCATCCGCCTACT -> TTTCCCCATCCGCCTACTT
ATTTCTAACTAGACGGTTA -> TTTCTAACTAGACGGTTAT
ATTTGAAGGTAACAGGAGT -> TTTGAAGGTAACAGGAGTC
ATTTGGCTGGGGGCTCTTC -> TTTGGCTGGGGGCTCTTCA
ATTTGTTCCTTCATAGCTA -> TTTGTTCCTTCATAGCTAA
ATTTTCGAAATCCGCGGCT -> TTTTCGAAATCCGCGGCTA
ATTTTCGCGCAAAGTAGGA -> TTTTCGCGCAAAGTAGGAA
ATTTTGTATCCGTCTTCCA -> TTTTGTATCCGTCTTCCAC
CAAAACTGATGCACATCGC -> AAAACTGATGCACATCGCT
CAAAAGGTTAGATCACGGG -> AAAAGGTTAGATCACGGGA
CAAACATTCAGCTTTGACC -> AAACATTCAGCTTTGACCA
CAAACTATTTGGCTGGGGG -> AAACTATTTGGCTGGGGGC
CAAAGGAAGTAACCAAGTA -> AAAGGAAGTAACCAAGTAC
CAAAGGAGCTGGTAAGACG -> AAAGGAGCTGGTAAGACGG
CAAAGGCTAACGAGTTGTT -> AAAGGCTAACGAGTTGTTC
CAAAGTAGGAAATCAACGG -> AAAGTAGGAAATCAACGGG
CAAAGTCCGGCGCAATTAC -> AAAGTCCGGCGCAATTACG
CAAAGTGCTCTCTTTGGCC -> AAAGTGCTCTCTTTGGCCT
CAAATATTAAGACGATTTA -> AAATATTAAGACGATTTAC
CAACAGCTCCATGCTTCGG -> AACAGCTCCATGCTTCGGG
CAACCAAGAATGCGTGCGA -> AACCAAGAATGCGTGCGAC,AACCAAGAATGCGTGCGAC
CAACCCCAGCGCCCGAGGC -> AACCCCAGCGCCCGAGGCT
CAACCCCCCCATATTCAAA -> AACCCCCCCATATTCAAAT
CAACGGAAATCGTAAGCAG -> AACGGAAATCGTAAGCAGC
CAACGGATAATCCACTTTG -> AACGGATAATCCACTTTGC
CAACGGGGGCGGAAAATTT -> AACGGGGGCGGAAAATTTC
CAACTGCGCACTCTGTTCT -> AACTGCGCACTCTGTTCTA
CAAGAAAGGCCGCGTTGAG -> AAGAAAGGCCGCGTTGAGG
CAAGAACTGTGCGAACACC -> AAGAACTGTGCGAACACCT
CAAGAATGCGTGCGACCGC -> AAGAATGCGTGCGACCGCA
CAAGAATGCGTGCGACCGG -> AAGAATGCGTGCGACCGGA
CAAGAATGCGTGCGACGTT -> AAGAATGCGTGCGACGTTG
CAAGAATGCGTGCGACTAG -> AAGAATGCGTGCGACTAGC
CAAGAGCGACCCGACTCGG -> AAGAGCGACCCGACTCGGT
CAAGCAGTCAGCATTGCAC -> AAGCAGTCAGCATTGCACC
CAAGGAGCTTTATGAACTC -> AAGGAGCTTTATGAACTCC
CAAGGATGCCGGTAACCTG -> AAGGATGCCGGTAACCTGT
CAAGGCACTCCAAAGTCCG -> AAGGCACTCCAAAGTCCGG
CAAGGTAGTTGTATCCGGC -> AAGGTAGTTGTATCCGGCG
CAAGTACCATCTAACTAAC -> AAGTACCATCTAACTAACT
CAATAGGGAACTAAGTTAG -> AATAGGGAACTAAGTTAGA
CAATAGGGCACTAGCAGGG -> AATAGGGCACTAGCAGGGA
CAATAGGGGAATTGCTTAC -> AATAGGGGAATTGCTTACA
CAATAGGGTTGTGCAGCGC -> AATAGGGTTGTGCAGCGCA
CAATGTATACATTTGTTCC -> AATGTATACATTTGTTCCT
CAATTACGTCCTAGTTTAA -> AATTACGTCCTAGTTTAAC
CAATTAGGATTTTCGAAAT -> AATTAGGATTTTCGAAATC
CAATTTCTAACTAGACGGT -> AATTTCTAACTAGACGGTT
CACAAAGGAGCTGGTAAGA -> ACAAAGGAGCTGGTAAGAC
CACAAGGCACTCCAAAGTC -> ACAAGGCACTCCAAAGTCC
CACAAGGTAGTTGTATCCG -> ACAAGGTAGTTGTATCCGG
CACACACACATAGTCCCCC -> ACACACACATAGTCCCCCA
CACACACATAGTCCCCCAA -> ACACACATAGTCCCCCAAT
CACACATAGTCCCCCAATT -> ACACATAGTCCCCCAATTT
CACACCCGGCTCTTGCCGC -> ACACCCGGCTCTTGCCGCG
CACAGAACAGACTAAAGGC -> ACAGAACAGACTAAAGGCC
CACAGCAAAGGAAGTAACC -> ACAGCAAAGGAAGTAACCA
CACATAGTCCCCCAATTTC -> ACATAGTCCCCCAATTTCT
CACATCGCTACACAGCAAA -> ACATCGCTACACAGCAAAG
CACCATCAAACATTCAGCT -> ACCATCAAACATTCAGCTT
CACCCGGCTCTTGCCGCGA -> ACCCGGCTCTTGCCGCGAT
CACCCTAGGTTTATTACTG -> ACCCTAGGTTTATTACTGC
CACCCTGAACTCGCAGGAA -> ACCCTGAACTCGCAGGAAG
CACCGACTGTCAGGGTGAA -> ACCGACTGTCAGGGTGAAA
CACCGCGCTGGACCTATAA -> ACCGCGCTGGACCTATAAC
CACCTGGTGGAACCACGAG -> ACCTGGTGGAACCACGAGG
CACCTTATAAGGCGTGAAT -> ACCTTATAAGGCGTGAATG
CACCTTGAAGTTTCTTAAG -> ACCTTGAAGTTTCTTAAGT
CACGAGAACGGATCGTCAT -> ACGAGAACGGATCGTCATC
CACGAGGTGCGTAGAGAAG -> ACGAGGTGCGTAGAGAAGC
CACGATTAATGAGTAGATT -> ACGATTAATGAGTAGATTC
CACGCTCTTCGGTTAGACC -> ACGCTCTTCGGTTAGACCG
CACGGGAAATGGATAATGA -> ACGGGAAATGGATAATGAG
CACGTTCGATGCCATAGAA -> ACGTTCGATGCCATAGAAC
CACTAGACGGTCTTGCCAT -> ACTAGACGGTCTTGCCATT
CACTAGCAGGGAACCAAGA -> ACTAGCAGGGAACCAAGAA
CACTCACCGCGCTGGACCT -> ACTCACCGCGCTGGACCTA
CACTCCAAAGTCCGGCGCA -> ACTCCAAAGTCCGGCGCAA
CACTCTGTTCTAATTTAGA -> ACTCTGTTCTAATTTAGAC
CACTGTTATGTGCAAGGAT -> ACTGTTATGTGCAAGGATG
CACTTTGCGTTTGTAGGTT -> ACTTTGCGTTTGTAGGTTG
CAGAACAGACTAAAGGCCA -> AGAACAGACTAAAGGCCAT
CAGAACAGAGCTTGAGTAT -> AGAACAGAGCTTGAGTATA
CAGAAGCTTTACAGGGTAT -> AGAAGCTTTACAGGGTATA
CAGACTAAAGGCCATAACC -> AGACTAAAGGCCATAACCA
CAGAGCGTTTATACAGCAC -> AGAGCGTTTATACAGCACA
CAGAGCTTGAGTATACGTT -> AGAGCTTGAGTATACGTTG
CAGATCATAACTGTCTGCG -> AGATCATAACTGTCTGCGG
CAGCAAAGGAAGTAACCAA -> AGCAAAGGAAGTAACCAAG
CAGCACACACACATAGTCC -> AGCACACACACATAGTCCC
CAGCAGAAGCTTTACAGGG -> AGCAGAAGCTTTACAGGGT
CAGCATCTCAACAGCTCCA -> AGCATCTCAACAGCTCCAT
CAGCATTGCACCCTGAACT -> AGCATTGCACCCTGAACTC
CAGCGAGGAGGGACACCTT -> AGCGAGGAGGGACACCTTG
CAGCGCAACCAAGAATGCG -> AGCGCAACCAAGAATGCGT
CAGCGCCCGAGGCTCCAGT -> AGCGCCCGAGGCTCCAGTC
CAGCGTACAGCATCTCAAC -> AGCGTACAGCATCTCAACA
CAGCTCCATGCTTCGGGTC -> AGCTCCATGCTTCGGGTCC
CAGCTCTTACCAAAGTGCT -> AGCTCTTACCAAAGTGCTC
CAGCTTTGACCAAAACTGA -> AGCTTTGACCAAAACTGAT
CAGGAAGGGTTATAACGTT -> AGGAAGGGTTATAACGTTG
CAGGAGAAACTTGCGTGTA -> AGGAGAAACTTGCGTGTAA
CAGGAGGTAGTCTAGAACT -> AGGAGGTAGTCTAGAACTG
CAGGAGTCATTGGTAAAAT -> AGGAGTCATTGGTAAAATG
CAGGCTATAGACGACCAGG -> AGGCTATAGACGACCAGGA
CAGGGAACCAAGAATGCGT -> AGGGAACCAAGAATGCGTG
CAGGGATTCTAACGCAGCT -> AGGGATTCTAACGCAGCTC
CAGGGCCAACGGAAATCGT -> AGGGCCAACGGAAATCGTA
CAGGGGACGAAGTTATTCT -> AGGGGACGAAGTTATTCTT
CAGGGTATAGCTGAGAGAG -> AGGGTATAGCTGAGAGAGA
CAGGGTGAAAGAGGCCTTC -> AGGGTGAAAGAGGCCTTCG
CAGGTACCACCGACTGTCA -> AGGTACCACCGACTGTCAG
CAGGTTCCAAACTATTTGG -> AGGTTCCAAACTATTTGGC
CAGTCAGCATTGCACCCTG -> AGTCAGCATTGCACCCTGA
CAGTCCAACCCCCCCATAT -> AGTCCAACCCCCCCATATT
CAGTGAGAGTCAATGTATA -> AGTGAGAGTCAATGTATAC
CAGTTATGCCCGTGATATA -> AGTTATGCCCGTGATATAG
CATAACCAGGGATTCTAAC -> ATAACCAGGGATTCTAACG
CATAACTGTCTGCGGTAGT -> ATAACTGTCTGCGGTAGTT
CATACCGGTTCAAGCAGTC -> ATACCGGTTCAAGCAGTCA
CATAGAACAACTGCGCACT -> ATAGAACAACTGCGCACTC
CATAGCGCCATCGTAGCGG -> ATAGCGCCATCGTAGCGGT
CATAGCTAATGGCCATCAG -> ATAGCTAATGGCCATCAGA
CATAGGGACGATTTACTAA -> ATAGGGACGATTTACTAAG
CATAGTACCATCTCCTTAT -> ATAGTACCATCTCCTTATT
CATAGTCCCCCAATTTCTA -> ATAGTCCCCCAATTTCTAA
CATATCTAGATCAAAAGGT -> ATATCTAGATCAAAAGGTT
CATATTCAAATATTAAGAC -> ATATTCAAATATTAAGACG
CATCAAACATTCAGCTTTG -> ATCAAACATTCAGCTTTGA
CATCAGAGCGTTTATACAG -> ATCAGAGCGTTTATACAGC
CATCCCACCTTATAAGGCG -> ATCCCACCTTATAAGGCGT
CATCCGCCTACTTGTCATA -> ATCCGCCTACTTGTCATAT
CATCGCTACACAGCAAAGG -> ATCGCTACACAGCAAAGGA
CATCGTAGCGGTTATCCTT -> ATCGTAGCGGTTATCCTTA
CATCTAACTAACTTCTATT -> ATCTAACTAACTTCTATTA
CATCTCAACAGCTCCATGC -> ATCTCAACAGCTCCATGCT
CATCTCCTTATTCTGTTAG -> ATCTCCTTATTCTGTTAGC
CATCTTCTAATTCGTCCAG -> ATCTTCTAATTCGTCCAGC
CATGAGTAGCACACCCGGC -> ATGAGTAGCACACCCGGCT
CATGCTTCGGGTCCCGCAA -> ATGCTTCGGGTCCCGCAAA
CATGGTCACGATTAATGAG -> ATGGTCACGATTAATGAGT
CATGTCCGCGTGTTATCGT -> ATGTCCGCGTGTTATCGTT
CATGTGTTGTTCCTGTGTA -> ATGTGTTGTTCCTGTGTAT
CATTCAGCTTTGACCAAAA -> ATTCAGCTTTGACCAAAAC
CATTGCACCCTGAACTCGC -> ATTGCACCCTGAACTCGCA
CATTGGTAAAATGTTTTTC -> ATTGGTAAAATGTTTTTCA
CATTTGTTCCTTCATAGCT -> ATTTGTTCCTTCATAGCTA
CATTTTGTATCCGTCTTCC -> ATTTTGTATCCGTCTTCCA
CCAAAACTGATGCACATCG -> CAAAACTGATGCACATCGC
CCAAACTATTTGGCTGGGG -> CAAACTATTTGGCTGGGGG
CCAAAGTCCGGCGCAATTA -> CAAAGTCCGGCGCAATTAC
CCAAAGTGCTCTCTTTGGC -> CAAAGTGCTCTCTTTGGCC
CCAACCCCAGCGCCCGAGG -> CAACCCCAGCGCCCGAGGC
CCAACCCCCCCATATTCAA -> CAACCCCCCCATATTCAAA
CCAACGGAAATCGTAAGCA -> CAACGGAAATCGTAAGCAG
CCAAGAACTGTGCGAACAC -> CAAGAACTGTGCGAACACC
CCAAGAATGCGTGCGACCG -> CAAGAATGCGTGCGACCGG,CAAGAATGCGTGCGACCGC
CCAAGAATGCGTGCGACGT -> CAAGAATGCGTGCGACGTT
CCAAGAATGCGTGCGACTA -> CAAGAATGCGTGCGACTAG
CCAAGTACCATCTAACTAA -> CAAGTACCATCTAACTAAC
CCAATTTCTAACTAGACGG -> CAATTTCTAACTAGACGGT
CCACCCTAGGTTTATTACT -> CACCCTAGGTTTATTACTG
CCACCGACTGTCAGGGTGA -> CACCGACTGTCAGGGTGAA
CCACCTTATAAGGCGTGAA -> CACCTTATAAGGCGTGAAT
CCACGAGGTGCGTAGAGAA -> CACGAGGTGCGTAGAGAAG
CCACGCTCTTCGGTTAGAC -> CACGCTCTTCGGTTAGACC
CCACTCACCGCGCTGGACC -> CACTCACCGCGCTGGACCT
CCACTTTGCGTTTGTAGGT -> CACTTTGCGTTTGTAGGTT
CCAGATCATAACTGTCTGC -> CAGATCATAACTGTCTGCG
CCAGCGCCCGAGGCTCCAG -> CAGCGCCCGAGGCTCCAGT
CCAGCGTACAGCATCTCAA -> CAGCGTACAGCATCTCAAC
CCAGGAGGTAGTCTAGAAC -> CAGGAGGTAGTCTAGAACT
CCAGGCTATAGACGACCAG -> CAGGCTATAGACGACCAGG
CCAGGGATTCTAACGCAGC -> CAGGGATTCTAACGCAGCT
CCAGGGCCAACGGAAATCG -> CAGGGCCAACGGAAATCGT
CCAGTCCAACCCCCCCATA -> CAGTCCAACCCCCCCATAT
CCATAACCAGGGATTCTAA -> CATAACCAGGGATTCTAAC
CCATACCGGTTCAAGCAGT -> CATACCGGTTCAAGCAGTC
CCATAGAACAACTGCGCAC -> CATAGAACAACTGCGCACT
CCATATTCAAATATTAAGA -> CATATTCAAATATTAAGAC
CCATCAAACATTCAGCTTT -> CATCAAACATTCAGCTTTG
CCATCAGAGCGTTTATACA -> CATCAGAGCGTTTATACAG
CCATCCGCCTACTTGTCAT -> CATCCGCCTACTTGTCATA
CCATCGTAGCGGTTATCCT -> CATCGTAGCGGTTATCCTT
CCATCTAACTAACTTCTAT -> CATCTAACTAACTTCTATT
CCATCTCCTTATTCTGTTA -> CATCTCCTTATTCTGTTAG
CCATGAGTAGCACACCCGG -> CATGAGTAGCACACCCGGC
CCATGCTTCGGGTCCCGCA -> CATGCTTCGGGTCCCGCAA
CCATTTTGTATCCGTCTTC -> CATTTTGTATCCGTCTTCC
CCCAACCCCAGCGCCCGAG -> CCAACCCCAGCGCCCGAGG
CCCAAGAACTGTGCGAACA -> CCAAGAACTGTGCGAACAC
CCCAATTTCTAACTAGACG -> CCAATTTCTAACTAGACGG
CCCACCTTATAAGGCGTGA -> CCACCTTATAAGGCGTGAA
CCCACTCACCGCGCTGGAC -> CCACTCACCGCGCTGGACC
CCCAGCGCCCGAGGCTCCA -> CCAGCGCCCGAGGCTCCAG
CCCAGGGCCAACGGAAATC -> CCAGGGCCAACGGAAATCG
CCCATATTCAAATATTAAG -> CCATATTCAAATATTAAGA
CCCATCCGCCTACTTGTCA -> CCATCCGCCTACTTGTCAT
CCCATGAGTAGCACACCCG -> CCATGAGTAGCACACCCGG
CCCCAATTTCTAACTAGAC -> CCCAATTTCTAACTAGACG
CCCCAGCGCCCGAGGCTCC -> CCCAGCGCCCGAGGCTCCA
CCCCATATTCAAATATTAA -> CCCATATTCAAATATTAAG
CCCCATCCGCCTACTTGTC -> CCCATCCGCCTACTTGTCA
CCCCCAATTTCTAACTAGA -> CCCCAATTTCTAACTAGAC
CCCCCATATTCAAATATTA -> CCCCATATTCAAATATTAA
CCCCCCATATTCAAATATT -> CCCCCATATTCAAATATTA
CCCCCCCATATTCAAATAT -> CCCCCCATATTCAAATATT
CCCCGCGTCCAGGCTATAG -> CCCGCGTCCAGGCTATAGA
CCCCTCAGGAGAAACTTGC -> CCCTCAGGAGAAACTTGCG
CCCGACTCGGTCTTCGGAA -> CCGACTCGGTCTTCGGAAG
CCCGAGGCTCCAGTCCAAC -> CCGAGGCTCCAGTCCAACC
CCCGCAAAGGCTAACGAGT -> CCGCAAAGGCTAACGAGTT
CCCGCGTCCAGGCTATAGA -> CCGCGTCCAGGCTATAGAC
CCCGGCTCTTGCCGCGATA -> CCGGCTCTTGCCGCGATAT
CCCGTGATATAGGATTTCA -> CCGTGATATAGGATTTCAG
CCCTAGGTTTATTACTGCC -> CCTAGGTTTATTACTGCCG
CCCTCAGGAGAAACTTGCG -> CCTCAGGAGAAACTTGCGT
CCCTCATGTGTTGTTCCTG -> CCTCATGTGTTGTTCCTGT
CCCTGAACTCGCAGGAAGG -> CCTGAACTCGCAGGAAGGG
CCCTTTCGACCGTTTTGGG -> CCTTTCGACCGTTTTGGGA
CCGAAACTTTGTACAAGAA -> CGAAACTTTGTACAAGAAA
CCGACTCGGTCTTCGGAAG -> CGACTCGGTCTTCGGAAGA
CCGACTGACAGGTACCACC -> CGACTGACAGGTACCACCG
CCGACTGTCAGGGTGAAAG -> CGACTGTCAGGGTGAAAGA
CCGAGGCTCCAGTCCAACC -> CGAGGCTCCAGTCCAACCC
CCGAGGCTGCTGCAGAACA -> CGAGGCTGCTGCAGAACAG
CCGCAAAGGCTAACGAGTT -> CGCAAAGGCTAACGAGTTG
CCGCACTGTTATGTGCAAG -> CGCACTGTTATGTGCAAGG
CCGCATGTCCGCGTGTTAT -> CGCATGTCCGCGTGTTATC
CCGCCTACTTGTCATATCT -> CGCCTACTTGTCATATCTA
CCGCGATATGCCATACCGG -> CGCGATATGCCATACCGGT
CCGCGCTGGACCTATAACG -> CGCGCTGGACCTATAACGT
CCGCGCTTCCTAGGGGCAA -> CGCGCTTCCTAGGGGCAAG
CCGCGGCTAACGCTCTTAG -> CGCGGCTAACGCTCTTAGG
CCGCGTCCAGGCTATAGAC -> CGCGTCCAGGCTATAGACG
CCGCGTGTTATCGTTTTAA -> CGCGTGTTATCGTTTTAAT
CCGCGTTGAGGAACTCCCT -> CGCGTTGAGGAACTCCCTC
CCGGAATTTGAAGGTAACA -> CGGAATTTGAAGGTAACAG
CCGGACCAGATCATAACTG -> CGGACCAGATCATAACTGT
CCGGCGCAATTACGTCCTA -> CGGCGCAATTACGTCCTAG
CCGGCGCACTAGACGGTCT -> CGGCGCACTAGACGGTCTT
CCGGCTCTTGCCGCGATAT -> CGGCTCTTGCCGCGATATG
CCGGTAACCTGTTTTCATG -> CGGTAACCTGTTTTCATGG
CCGGTTCAAGCAGTCAGCA -> CGGTTCAAGCAGTCAGCAT
CCGTATCCGAGGCTGCTGC -> CGTATCCGAGGCTGCTGCA
CCGTCAGCGAGGAGGGACA -> CGTCAGCGAGGAGGGACAC
CCGTCTTCCACGCTCTTCG -> CGTCTTCCACGCTCTTCGG
CCGTGATATAGGATTTCAG -> CGTGATATAGGATTTCAGG
CCGTTTTGGGAAGGTACAA -> CGTTTTGGGAAGGTACAAC
CCTACTTGTCATATCTAGA -> CTACTTGTCATATCTAGAT
CCTAGGGGCAAGAGCGACC -> CTAGGGGCAAGAGCGACCC
CCTAGGTTTATTACTGCCG -> CTAGGTTTATTACTGCCGC
CCTAGTTTAACTAACGGGT -> CTAGTTTAACTAACGGGTC
CCTATAACGTTTCGGGGCC -> CTATAACGTTTCGGGGCCC
CCTCAGGAGAAACTTGCGT -> CTCAGGAGAAACTTGCGTG
CCTCATGTGTTGTTCCTGT -> CTCATGTGTTGTTCCTGTG
CCTCCCAAGAACTGTGCGA -> CTCCCAAGAACTGTGCGAA
CCTGAACTCGCAGGAAGGG -> CTGAACTCGCAGGAAGGGT
CCTGGATGTGTGTACGAGA -> CTGGATGTGTGTACGAGAG
CCTGGTGGAACCACGAGGT -> CTGGTGGAACCACGAGGTG
CCTGTGTATCCTGGATGTG -> CTGTGTATCCTGGATGTGT
CCTGTTTTCATGGTCACGA -> CTGTTTTCATGGTCACGAT
CCTTATAAGGCGTGAATGA -> CTTATAAGGCGTGAATGAA
CCTTATCTGTATCTGTCCC -> CTTATCTGTATCTGTCCCA
CCTTATTCTGTTAGCTAGC -> CTTATTCTGTTAGCTAGCG
CCTTCATAGCTAATGGCCA -> CTTCATAGCTAATGGCCAT
CCTTCGAGACCTCCCAAGA -> CTTCGAGACCTCCCAAGAA
CCTTGAAGTTTCTTAAGTG -> CTTGAAGTTTCTTAAGTGT
CCTTTACCGTATCCGAGGC -> CTTTACCGTATCCGAGGCT
CCTTTCGACCGTTTTGGGA -> CTTTCGACCGTTTTGGGAA
CGAAACTTTGTACAAGAAA -> GAAACTTTGTACAAGAAAG
CGAAATCCGCGGCTAACGC -> GAAATCCGCGGCTAACGCT
CGAACACCTGGTGGAACCA -> GAACACCTGGTGGAACCAC
CGAACGCAACGGATAATCC -> GAACGCAACGGATAATCCA
CGAAGTTATTCTTGCACAA -> GAAGTTATTCTTGCACAAA
CGACCAGGAGGTAGTCTAG -> GACCAGGAGGTAGTCTAGA
CGACCCGACTCGGTCTTCG -> GACCCGACTCGGTCTTCGG
CGACCGCATGTCCGCGTGT -> GACCGCATGTCCGCGTGTT
CGACCGGAATTTGAAGGTA -> GACCGGAATTTGAAGGTAA
CGACCGTTTTGGGAAGGTA -> GACCGTTTTGGGAAGGTAC
CGACGTTGATACTTCGTTG -> GACGTTGATACTTCGTTGG
CGACTAGCCGAAACTTTGT -> GACTAGCCGAAACTTTGTA
CGACTATCTCTCCGACTGA -> GACTATCTCTCCGACTGAC
CGACTCGGTCTTCGGAAGA -> GACTCGGTCTTCGGAAGAA
CGACTGACAGGTACCACCG -> GACTGACAGGTACCACCGA
CGACTGTCAGGGTGAAAGA -> GACTGTCAGGGTGAAAGAG
CGAGAAACGAGCAATAGGG -> GAGAAACGAGCAATAGGGC
CGAGAACGGATCGTCATCC -> GAGAACGGATCGTCATCCC
CGAGACCTCCCAAGAACTG -> GAGACCTCCCAAGAACTGT
CGAGAGAAACGAGCAATAG -> GAGAGAAACGAGCAATAGG
CGAGCAATAGGGAACTAAG -> GAGCAATAGGGAACTAAGT
CGAGCAATAGGGCACTAGC -> GAGCAATAGGGCACTAGCA
CGAGCAATAGGGGAATTGC -> GAGCAATAGGGGAATTGCT
CGAGCAATAGGGTTGTGCA -> GAGCAATAGGGTTGTGCAG
CGAGGAGGGACACCTTGAA -> GAGGAGGGACACCTTGAAG
CGAGGCTCCAGTCCAACCC -> GAGGCTCCAGTCCAACCCC
CGAGGCTGCTGCAGAACAG -> GAGGCTGCTGCAGAACAGA
CGAGGTGCGTAGAGAAGCA -> GAGGTGCGTAGAGAAGCAC
CGAGTGTTAAAAAAATGAC -> GAGTGTTAAAAAAATGACG
CGAGTTGTTCTACGCATAG -> GAGTTGTTCTACGCATAGG
CGATATGCCATACCGGTTC -> GATATGCCATACCGGTTCA
CGATGCCATAGAACAACTG -> GATGCCATAGAACAACTGC
CGATTAATGAGTAGATTCC -> GATTAATGAGTAGATTCCC
CGATTTACTAAGCTCGGCG -> GATTTACTAAGCTCGGCGG
CGATTTACTACGACTATCT -> GATTTACTACGACTATCTC
CGCAAAGGCTAACGAGTTG -> GCAAAGGCTAACGAGTTGT
CGCAAAGTAGGAAATCAAC -> GCAAAGTAGGAAATCAACG
CGCAACCAAGAATGCGTGC -> GCAACCAAGAATGCGTGCG
CGCAACGGATAATCCACTT -> GCAACGGATAATCCACTTT
CGCAATTACGTCCTAGTTT -> GCAATTACGTCCTAGTTTA
CGCACAAGGTAGTTGTATC -> GCACAAGGTAGTTGTATCC
CGCACTAGACGGTCTTGCC -> GCACTAGACGGTCTTGCCA
CGCACTCTGTTCTAATTTA -> GCACTCTGTTCTAATTTAG
CGCACTGTTATGTGCAAGG -> GCACTGTTATGTGCAAGGA
CGCAGCTCTTACCAAAGTG -> GCAGCTCTTACCAAAGTGC
CGCAGGAAGGGTTATAACG -> GCAGGAAGGGTTATAACGT
CGCATAGGGACGATTTACT -> GCATAGGGACGATTTACTA
CGCATGTCCGCGTGTTATC -> GCATGTCCGCGTGTTATCG
CGCCATCGTAGCGGTTATC -> GCCATCGTAGCGGTTATCC
CGCCCGAGGCTCCAGTCCA -> GCCCGAGGCTCCAGTCCAA
CGCCTACTTGTCATATCTA -> GCCTACTTGTCATATCTAG
CGCGATATGCCATACCGGT -> GCGATATGCCATACCGGTT
CGCGCAAAGTAGGAAATCA -> GCGCAAAGTAGGAAATCAA
CGCGCTGGACCTATAACGT -> GCGCTGGACCTATAACGTT
CGCGCTTCCTAGGGGCAAG -> GCGCTTCCTAGGGGCAAGA
CGCGGCTAACGCTCTTAGG -> GCGGCTAACGCTCTTAGGG
CGCGTCCAGGCTATAGACG -> GCGTCCAGGCTATAGACGA
CGCGTGTTATCGTTTTAAT -> GCGTGTTATCGTTTTAATC
CGCGTTGAGGAACTCCCTC -> GCGTTGAGGAACTCCCTCA
CGCTACACAGCAAAGGAAG -> GCTACACAGCAAAGGAAGT
CGCTCTTAGGGTAAGAGGA -> GCTCTTAGGGTAAGAGGAG
CGCTCTTCGGTTAGACCGT -> GCTCTTCGGTTAGACCGTC
CGCTGAGAAACGAGCAATA -> GCTGAGAAACGAGCAATAG
CGCTGGACCTATAACGTTT -> GCTGGACCTATAACGTTTC
CGCTTCCTAGGGGCAAGAG -> GCTTCCTAGGGGCAAGAGC
CGGAAAATTTCCCCATCCG -> GGAAAATTTCCCCATCCGC
CGGAAATCGTAAGCAGCAG -> GGAAATCGTAAGCAGCAGA
CGGAAGAATACGGCTGATC -> GGAAGAATACGGCTGATCA
CGGAATTTGAAGGTAACAG -> GGAATTTGAAGGTAACAGG
CGGACCAGATCATAACTGT -> GGACCAGATCATAACTGTC
CGGAGGTAGGGGCAATTAG -> GGAGGTAGGGGCAATTAGG
CGGATAATCCACTTTGCGT -> GGATAATCCACTTTGCGTT
CGGATCGTCATCCCACCTT -> GGATCGTCATCCCACCTTA
CGGATGGCCACCCTAGGTT -> GGATGGCCACCCTAGGTTT
CGGCGCAATTACGTCCTAG -> GGCGCAATTACGTCCTAGT
CGGCGCACTAGACGGTCTT -> GGCGCACTAGACGGTCTTG
CGGCGGAGGTAGGGGCAAT -> GGCGGAGGTAGGGGCAATT
CGGCTAACGCTCTTAGGGT -> GGCTAACGCTCTTAGGGTA
CGGCTCTTGCCGCGATATG -> GGCTCTTGCCGCGATATGC
CGGCTGATCAGTTATGCCC -> GGCTGATCAGTTATGCCCG
CGGGAAATGGATAATGAGC -> GGGAAATGGATAATGAGCT
CGGGGCCCATGAGTAGCAC -> GGGGCCCATGAGTAGCACA
CGGGGGCGGAAAATTTCCC -> GGGGGCGGAAAATTTCCCC
CGGGTCCCGCAAAGGCTAA -> GGGTCCCGCAAAGGCTAAC
CGGGTCGAACGCAACGGAT -> GGGTCGAACGCAACGGATA
CGGTAACCTGTTTTCATGG -> GGTAACCTGTTTTCATGGT
CGGTAGTTTCTAAGACATA -> GGTAGTTTCTAAGACATAG
CGGTCTTCGGAAGAATACG -> GGTCTTCGGAAGAATACGG
CGGTCTTGCCATTTTGTAT -> GGTCTTGCCATTTTGTATC
CGGTGGAGTATCGCTGAGA -> GGTGGAGTATCGCTGAGAA
CGGTTAGACCGTCAGCGAG -> GGTTAGACCGTCAGCGAGG
CGGTTATATCAAGGAGCTT -> GGTTATATCAAGGAGCTTT
CGGTTATCCTTATCTGTAT -> GGTTATCCTTATCTGTATC
CGGTTCAAGCAGTCAGCAT -> GGTTCAAGCAGTCAGCATT
CGTAAGCAGCAGAAGCTTT -> GTAAGCAGCAGAAGCTTTA
CGTACAGCATCTCAACAGC -> GTACAGCATCTCAACAGCT
CGTAGAGAAGCACCATCAA -> GTAGAGAAGCACCATCAAA
CGTAGCGGTTATCCTTATC -> GTAGCGGTTATCCTTATCT
CGTATCCGAGGCTGCTGCA -> GTATCCGAGGCTGCTGCAG
CGTCAGCGAGGAGGGACAC -> GTCAGCGAGGAGGGACACC
CGTCATCCCACCTTATAAG -> GTCATCCCACCTTATAAGG
CGTCCAGCGTACAGCATCT -> GTCCAGCGTACAGCATCTC
CGTCCAGGCTATAGACGAC -> GTCCAGGCTATAGACGACC
CGTCCTAGTTTAACTAACG -> GTCCTAGTTTAACTAACGG
CGTCTTCCACGCTCTTCGG -> GTCTTCCACGCTCTTCGGT
CGTGAATGAAGTCAGGGGA -> GTGAATGAAGTCAGGGGAC
CGTGATATAGGATTTCAGG -> GTGATATAGGATTTCAGGT
CGTGCGACCGCATGTCCGC -> GTGCGACCGCATGTCCGCG
CGTGCGACCGGAATTTGAA -> GTGCGACCGGAATTTGAAG
CGTGCGACGTTGATACTTC -> GTGCGACGTTGATACTTCG
CGTGCGACTAGCCGAAACT -> GTGCGACTAGCCGAAACTT
CGTGGTGTTTACTCTGTAG -> GTGGTGTTTACTCTGTAGA
CGTGTAATGATTTTCGCGC -> GTGTAATGATTTTCGCGCA
CGTGTTATCGTTTTAATCC -> GTGTTATCGTTTTAATCCC
CGTTCCGCACTGTTATGTG -> GTTCCGCACTGTTATGTGC
CGTTCGATGCCATAGAACA -> GTTCGATGCCATAGAACAA
CGTTGAGGAACTCCCTCAT -> GTTGAGGAACTCCCTCATG
CGTTGATACTTCGTTGGTA -> GTTGATACTTCGTTGGTAG
CGTTGGCTTGACGAGTGTT -> GTTGGCTTGACGAGTGTTA
CGTTGGTAGTGCTGTCACA -> GTTGGTAGTGCTGTCACAG
CGTTGTAAATAGAGCGGAT -> GTTGTAAATAGAGCGGATG
CGTTTATACAGCACACACA -> GTTTATACAGCACACACAC
CGTTTCGGGGCCCATGAGT -> GTTTCGGGGCCCATGAGTA
CGTTTGTAGGTTGGGTTAC -> GTTTGTAGGTTGGGTTACA
CGTTTTAATCCCCGCGTCC -> GTTTTAATCCCCGCGTCCA
CTAAAGGCCATAACCAGGG -> TAAAGGCCATAACCAGGGA
CTAACGAGTTGTTCTACGC -> TAACGAGTTGTTCTACGCA
CTAACGCAGCTCTTACCAA -> TAACGCAGCTCTTACCAAA
CTAACGCTCTTAGGGTAAG -> TAACGCTCTTAGGGTAAGA
CTAACGGGTCGAACGCAAC -> TAACGGGTCGAACGCAACG
CTAACTAACTTCTATTACA -> TAACTAACTTCTATTACAC
CTAACTAGACGGTTATATC -> TAACTAGACGGTTATATCA
CTAACTTCTATTACACGTT -> TAACTTCTATTACACGTTC
CTAAGAACTTGCTACACGA -> TAAGAACTTGCTACACGAG
CTAAGACATAGTACCATCT -> TAAGACATAGTACCATCTC
CTAAGCTCGGCGGAGGTAG -> TAAGCTCGGCGGAGGTAGG
CTAAGTTAGAACCAAGAAT -> TAAGTTAGAACCAAGAATG
CTAATGGCCATCAGAGCGT -> TAATGGCCATCAGAGCGTT
CTAATTCGTCCAGCGTACA -> TAATTCGTCCAGCGTACAG
CTAATTTAGACGAGAAACG -> TAATTTAGACGAGAAACGA
CTACACAGCAAAGGAAGTA -> TACACAGCAAAGGAAGTAA
CTACACGAGAACGGATCGT -> TACACGAGAACGGATCGTC
CTACCGGACCAGATCATAA -> TACCGGACCAGATCATAAC
CTACGACTATCTCTCCGAC -> TACGACTATCTCTCCGACT
CTACGCATAGGGACGATTT -> TACGCATAGGGACGATTTA
CTACTAAGAACTTGCTACA -> TACTAAGAACTTGCTACAC
CTACTTGTCATATCTAGAT -> TACTTGTCATATCTAGATC
CTAGAACTGTTTCTATGGG -> TAGAACTGTTTCTATGGGT
CTAGACGGTCTTGCCATTT -> TAGACGGTCTTGCCATTTT
CTAGACGGTTATATCAAGG -> TAGACGGTTATATCAAGGA
CTAGATCAAAAGGTTAGAT -> TAGATCAAAAGGTTAGATC
CTAGCAGGGAACCAAGAAT -> TAGCAGGGAACCAAGAATG
CTAGCCGAAACTTTGTACA -> TAGCCGAAACTTTGTACAA
CTAGCGTGGTGTTTACTCT -> TAGCGTGGTGTTTACTCTG
CTAGGGGCAAGAGCGACCC -> TAGGGGCAAGAGCGACCCG
CTAGGTTTATTACTGCCGC -> TAGGTTTATTACTGCCGCG
CTAGTTTAACTAACGGGTC -> TAGTTTAACTAACGGGTCG
CTATAACGTTTCGGGGCCC -> TATAACGTTTCGGGGCCCA
CTATAGACGACCAGGAGGT -> TATAGACGACCAGGAGGTA
CTATCTCTCCGACTGACAG -> TATCTCTCCGACTGACAGG
CTATGGGTTCCCCTCAGGA -> TATGGGTTCCCCTCAGGAG
CTATTACACGTTCGATGCC -> TATTACACGTTCGATGCCA
CTATTTGGCTGGGGGCTCT -> TATTTGGCTGGGGGCTCTT
CTCAACAGCTCCATGCTTC -> TCAACAGCTCCATGCTTCG
CTCACCGCGCTGGACCTAT -> TCACCGCGCTGGACCTATA
CTCAGGAGAAACTTGCGTG -> TCAGGAGAAACTTGCGTGT
CTCATGTGTTGTTCCTGTG -> TCATGTGTTGTTCCTGTGT
CTCCAAAGTCCGGCGCAAT -> TCCAAAGTCCGGCGCAATT
CTCCAGTCCAACCCCCCCA -> TCCAGTCCAACCCCCCCAT
CTCCATGCTTCGGGTCCCG -> TCCATGCTTCGGGTCCCGC
CTCCCAAGAACTGTGCGAA -> TCCCAAGAACTGTGCGAAC
CTCCCTCATGTGTTGTTCC -> TCCCTCATGTGTTGTTCCT
CTCCCTTTCGACCGTTTTG -> TCCCTTTCGACCGTTTTGG
CTCCGACTGACAGGTACCA -> TCCGACTGACAGGTACCAC
CTCCTTATTCTGTTAGCTA -> TCCTTATTCTGTTAGCTAG
CTCGCAGGAAGGGTTATAA -> TCGCAGGAAGGGTTATAAC
CTCGGCGGAGGTAGGGGCA -> TCGGCGGAGGTAGGGGCAA
CTCGGTCTTCGGAAGAATA -> TCGGTCTTCGGAAGAATAC
CTCTCCGACTGACAGGTAC -> TCTCCGACTGACAGGTACC
CTCTCTTTGGCCTTTACCG -> TCTCTTTGGCCTTTACCGT
CTCTGTAGAGTAGAGTGTG -> TCTGTAGAGTAGAGTGTGT
CTCTGTTCTAATTTAGACG -> TCTGTTCTAATTTAGACGA
CTCTTACCAAAGTGCTCTC -> TCTTACCAAAGTGCTCTCT
CTCTTAGGGTAAGAGGAGA -> TCTTAGGGTAAGAGGAGAA
CTCTTCACAAGGCACTCCA -> TCTTCACAAGGCACTCCAA
CTCTTCGGTTAGACCGTCA -> TCTTCGGTTAGACCGTCAG
CTCTTGCCGCGATATGCCA -> TCTTGCCGCGATATGCCAT
CTCTTTGGCCTTTACCGTA -> TCTTTGGCCTTTACCGTAT
CTGAACTCGCAGGAAGGGT -> TGAACTCGCAGGAAGGGTT
CTGACAGGTACCACCGACT -> TGACAGGTACCACCGACTG
CTGAGAAACGAGCAATAGG -> TGAGAAACGAGCAATAGGG
CTGAGAGAGAGACCCACTC -> TGAGAGAGAGACCCACTCA
CTGATCAGTTATGCCCGTG -> TGATCAGTTATGCCCGTGA
CTGATGCACATCGCTACAC -> TGATGCACATCGCTACACA
CTGCAGAACAGAGCTTGAG -> TGCAGAACAGAGCTTGAGT
CTGCCGCGCTTCCTAGGGG -> TGCCGCGCTTCCTAGGGGC
CTGCGCACTCTGTTCTAAT -> TGCGCACTCTGTTCTAATT
CTGCGGTAGTTTCTAAGAC -> TGCGGTAGTTTCTAAGACA
CTGCTGCAGAACAGAGCTT -> TGCTGCAGAACAGAGCTTG
CTGGACCTATAACGTTTCG -> TGGACCTATAACGTTTCGG
CTGGATGTGTGTACGAGAG -> TGGATGTGTGTACGAGAGA
CTGGGGGCTCTTCACAAGG -> TGGGGGCTCTTCACAAGGC
CTGGTAAGACGGTGGAGTA -> TGGTAAGACGGTGGAGTAT
CTGGTGGAACCACGAGGTG -> TGGTGGAACCACGAGGTGC
CTGTAGAGTAGAGTGTGTG -> TGTAGAGTAGAGTGTGTGC
CTGTATCTGTCCCAGGGCC -> TGTATCTGTCCCAGGGCCA
CTGTCACAGAACAGACTAA -> TGTCACAGAACAGACTAAA
CTGTCAGGGTGAAAGAGGC -> TGTCAGGGTGAAAGAGGCC
CTGTCCCAGGGCCAACGGA -> TGTCCCAGGGCCAACGGAA
CTGTCTGCGGTAGTTTCTA -> TGTCTGCGGTAGTTTCTAA
CTGTGCGAACACCTGGTGG -> TGTGCGAACACCTGGTGGA
CTGTGTATCCTGGATGTGT -> TGTGTATCCTGGATGTGTG
CTGTTAGCTAGCGTGGTGT -> TGTTAGCTAGCGTGGTGTT
CTGTTATGTGCAAGGATGC -> TGTTATGTGCAAGGATGCC
CTGTTCTAATTTAGACGAG -> TGTTCTAATTTAGACGAGA
CTGTTTCTATGGGTTCCCC -> TGTTTCTATGGGTTCCCCT
CTGTTTTCATGGTCACGAT -> TGTTTTCATGGTCACGATT
CTTAAGTGTCATAGCGCCA -> TTAAGTGTCATAGCGCCAT
CTTACAACCAAGAATGCGT -> TTACAACCAAGAATGCGTG
CTTACCAAAGTGCTCTCTT -> TTACCAAAGTGCTCTCTTT
CTTAGGGTAAGAGGAGAAA -> TTAGGGTAAGAGGAGAAAC
CTTATAAGGCGTGAATGAA -> TTATAAGGCGTGAATGAAG
CTTATCTGTATCTGTCCCA -> TTATCTGTATCTGTCCCAG
CTTATTCTGTTAGCTAGCG -> TTATTCTGTTAGCTAGCGT
CTTCACAAGGCACTCCAAA -> TTCACAAGGCACTCCAAAG
CTTCATAGCTAATGGCCAT -> TTCATAGCTAATGGCCATC
CTTCCACGCTCTTCGGTTA -> TTCCACGCTCTTCGGTTAG
CTTCCTAGGGGCAAGAGCG -> TTCCTAGGGGCAAGAGCGA
CTTCGAGACCTCCCAAGAA -> TTCGAGACCTCCCAAGAAC
CTTCGGAAGAATACGGCTG -> TTCGGAAGAATACGGCTGA
CTTCGGGTCCCGCAAAGGC -> TTCGGGTCCCGCAAAGGCT
CTTCGGTTAGACCGTCAGC -> TTCGGTTAGACCGTCAGCG
CTTCGTTGGTAGTGCTGTC -> TTCGTTGGTAGTGCTGTCA
CTTCTAATTCGTCCAGCGT -> TTCTAATTCGTCCAGCGTA
CTTCTATTACACGTTCGAT -> TTCTATTACACGTTCGATG
CTTGAAGTTTCTTAAGTGT -> TTGAAGTTTCTTAAGTGTC
CTTGACGAGTGTTAAAAAA -> TTGACGAGTGTTAAAAAAA
CTTGAGTATACGTTGTAAA -> TTGAGTATACGTTGTAAAT
CTTGCACAAAGGAGCTGGT -> TTGCACAAAGGAGCTGGTA
CTTGCCATTTTGTATCCGT -> TTGCCATTTTGTATCCGTC
CTTGCCGCGATATGCCATA -> TTGCCGCGATATGCCATAC
CTTGCGTGTAATGATTTTC -> TTGCGTGTAATGATTTTCG
CTTGCTACACGAGAACGGA -> TTGCTACACGAGAACGGAT
CTTGTCATATCTAGATCAA -> TTGTCATATCTAGATCAAA
CTTTACAGGGTATAGCTGA -> TTTACAGGGTATAGCTGAG
CTTTACCGTATCCGAGGCT -> TTTACCGTATCCGAGGCTG
CTTTATGAACTCCCTTTCG -> TTTATGAACTCCCTTTCGA
CTTTCGACCGTTTTGGGAA -> TTTCGACCGTTTTGGGAAG
CTTTGACCAAAACTGATGC -> TTTGACCAAAACTGATGCA
CTTTGCGTTTGTAGGTTGG -> TTTGCGTTTGTAGGTTGGG
CTTTGGCCTTTACCGTATC -> TTTGGCCTTTACCGTATCC
CTTTGTACAAGAAAGGCCG -> TTTGTACAAGAAAGGCCGC
GAAAATTTCCCCATCCGCC -> AAAATTTCCCCATCCGCCT
GAAACGAGCAATAGGGAAC -> AAACGAGCAATAGGGAACT
GAAACGAGCAATAGGGCAC -> AAACGAGCAATAGGGCACT
GAAACGAGCAATAGGGGAA -> AAACGAGCAATAGGGGAAT
GAAACGAGCAATAGGGTTG -> AAACGAGCAATAGGGTTGT
GAAACTTGCGTGTAATGAT -> AAACTTGCGTGTAATGATT
GAAACTTTGTACAAGAAAG -> AAACTTTGTACAAGAAAGG
GAAAGAGGCCTTCGAGACC -> AAAGAGGCCTTCGAGACCT
GAAAGGCCGCGTTGAGGAA -> AAAGGCCGCGTTGAGGAAC
GAAATCAACGGGGGCGGAA -> AAATCAACGGGGGCGGAAA
GAAATCCGCGGCTAACGCT -> AAATCCGCGGCTAACGCTC
GAAATCGTAAGCAGCAGAA -> AAATCGTAAGCAGCAGAAG
GAAATGGATAATGAGCTAC -> AAATGGATAATGAGCTACC
GAACAACTGCGCACTCTGT -> AACAACTGCGCACTCTGTT
GAACACCTGGTGGAACCAC -> AACACCTGGTGGAACCACG
GAACAGACTAAAGGCCATA -> AACAGACTAAAGGCCATAA
GAACAGAGCTTGAGTATAC -> AACAGAGCTTGAGTATACG
GAACCAAGAATGCGTGCGA -> AACCAAGAATGCGTGCGAC,AACCAAGAATGCGTGCGAC
GAACCACGAGGTGCGTAGA -> AACCACGAGGTGCGTAGAG
GAACGCAACGGATAATCCA -> AACGCAACGGATAATCCAC
GAACGGATCGTCATCCCAC -> AACGGATCGTCATCCCACC
GAACTAAGTTAGAACCAAG -> AACTAAGTTAGAACCAAGA
GAACTCCCTCATGTGTTGT -> AACTCCCTCATGTGTTGTT
GAACTCCCTTTCGACCGTT -> AACTCCCTTTCGACCGTTT
GAACTCGCAGGAAGGGTTA -> AACTCGCAGGAAGGGTTAT
GAACTGTGCGAACACCTGG -> AACTGTGCGAACACCTGGT
GAACTGTTTCTATGGGTTC -> AACTGTTTCTATGGGTTCC
GAACTTGCTACACGAGAAC -> AACTTGCTACACGAGAACG
GAAGAATACGGCTGATCAG -> AAGAATACGGCTGATCAGT
GAAGCACCATCAAACATTC -> AAGCACCATCAAACATTCA
GAAGCTTTACAGGGTATAG -> AAGCTTTACAGGGTATAGC
GAAGGGTTATAACGTTGGC -> AAGGGTTATAACGTTGGCT
GAAGGTAACAGGAGTCATT -> AAGGTAACAGGAGTCATTG
GAAGTAACCAAGTACCATC -> AAGTAACCAAGTACCATCT
GAAGTCAGGGGACGAAGTT -> AAGTCAGGGGACGAAGTTA
GAAGTTATTCTTGCACAAA -> AAGTTATTCTTGCACAAAG
GAAGTTTCTTAAGTGTCAT -> AAGTTTCTTAAGTGTCATA
GAATACGGCTGATCAGTTA -> AATACGGCTGATCAGTTAT
GAATGAAGTCAGGGGACGA -> AATGAAGTCAGGGGACGAA
GAATGCGTGCGACCGCATG -> AATGCGTGCGACCGCATGT
GAATGCGTGCGACCGGAAT -> AATGCGTGCGACCGGAATT
GAATGCGTGCGACGTTGAT -> AATGCGTGCGACGTTGATA
GAATGCGTGCGACTAGCCG -> AATGCGTGCGACTAGCCGA
GAATTGCTTACAACCAAGA -> AATTGCTTACAACCAAGAA
GAATTTGAAGGTAACAGGA -> AATTTGAAGGTAACAGGAG
GACACCTTGAAGTTTCTTA -> ACACCTTGAAGTTTCTTAA
GACAGGTACCACCGACTGT -> ACAGGTACCACCGACTGTC
GACATAGTACCATCTCCTT -> ACATAGTACCATCTCCTTA
GACCAAAACTGATGCACAT -> ACCAAAACTGATGCACATC
GACCAGATCATAACTGTCT -> ACCAGATCATAACTGTCTG
GACCAGGAGGTAGTCTAGA -> ACCAGGAGGTAGTCTAGAA
GACCCACTCACCGCGCTGG -> ACCCACTCACCGCGCTGGA
GACCCGACTCGGTCTTCGG -> ACCCGACTCGGTCTTCGGA
GACCGCATGTCCGCGTGTT -> ACCGCATGTCCGCGTGTTA
GACCGGAATTTGAAGGTAA -> ACCGGAATTTGAAGGTAAC
GACCGTCAGCGAGGAGGGA -> ACCGTCAGCGAGGAGGGAC
GACCGTTTTGGGAAGGTAC -> ACCGTTTTGGGAAGGTACA
GACCTATAACGTTTCGGGG -> ACCTATAACGTTTCGGGGC
GACCTCCCAAGAACTGTGC -> ACCTCCCAAGAACTGTGCG
GACGAAGTTATTCTTGCAC -> ACGAAGTTATTCTTGCACA
GACGACCAGGAGGTAGTCT -> ACGACCAGGAGGTAGTCTA
GACGAGAAACGAGCAATAG -> ACGAGAAACGAGCAATAGG
GACGAGTGTTAAAAAAATG -> ACGAGTGTTAAAAAAATGA
GACGATTTACTAAGCTCGG -> ACGATTTACTAAGCTCGGC
GACGATTTACTACGACTAT -> ACGATTTACTACGACTATC
GACGGTCTTGCCATTTTGT -> ACGGTCTTGCCATTTTGTA
GACGGTGGAGTATCGCTGA -> ACGGTGGAGTATCGCTGAG
GACGGTTATATCAAGGAGC -> ACGGTTATATCAAGGAGCT
GACGTTCCGCACTGTTATG -> ACGTTCCGCACTGTTATGT
GACGTTGATACTTCGTTGG -> ACGTTGATACTTCGTTGGT
GACTAAAGGCCATAACCAG -> ACTAAAGGCCATAACCAGG
GACTAGCCGAAACTTTGTA -> ACTAGCCGAAACTTTGTAC
GACTATCTCTCCGACTGAC -> ACTATCTCTCCGACTGACA
GACTCGGTCTTCGGAAGAA -> ACTCGGTCTTCGGAAGAAT
GACTGACAGGTACCACCGA -> ACTGACAGGTACCACCGAC
GACTGTCAGGGTGAAAGAG -> ACTGTCAGGGTGAAAGAGG
GAGAAACGAGCAATAGGGA -> AGAAACGAGCAATAGGGAA
GAGAAACGAGCAATAGGGC -> AGAAACGAGCAATAGGGCA
GAGAAACGAGCAATAGGGG -> AGAAACGAGCAATAGGGGA
GAGAAACGAGCAATAGGGT -> AGAAACGAGCAATAGGGTT
GAGAAACTTGCGTGTAATG -> AGAAACTTGCGTGTAATGA
GAGAACGGATCGTCATCCC -> AGAACGGATCGTCATCCCA
GAGAAGCACCATCAAACAT -> AGAAGCACCATCAAACATT
GAGACCCACTCACCGCGCT -> AGACCCACTCACCGCGCTG
GAGACCTCCCAAGAACTGT -> AGACCTCCCAAGAACTGTG
GAGAGAAACGAGCAATAGG -> AGAGAAACGAGCAATAGGG
GAGAGACCCACTCACCGCG -> AGAGACCCACTCACCGCGC
GAGAGAGACCCACTCACCG -> AGAGAGACCCACTCACCGC
GAGAGAGAGACCCACTCAC -> AGAGAGAGACCCACTCACC
GAGAGTCAATGTATACATT -> AGAGTCAATGTATACATTT
GAGCAATAGGGAACTAAGT -> AGCAATAGGGAACTAAGTT
GAGCAATAGGGCACTAGCA -> AGCAATAGGGCACTAGCAG
GAGCAATAGGGGAATTGCT -> AGCAATAGGGGAATTGCTT
GAGCAATAGGGTTGTGCAG -> AGCAATAGGGTTGTGCAGC
GAGCGACCCGACTCGGTCT -> AGCGACCCGACTCGGTCTT
GAGCGGATGGCCACCCTAG -> AGCGGATGGCCACCCTAGG
GAGCGTTTATACAGCACAC -> AGCGTTTATACAGCACACA
GAGCTACCGGACCAGATCA -> AGCTACCGGACCAGATCAT
GAGCTGGTAAGACGGTGGA -> AGCTGGTAAGACGGTGGAG
GAGCTTGAGTATACGTTGT -> AGCTTGAGTATACGTTGTA
GAGCTTTATGAACTCCCTT -> AGCTTTATGAACTCCCTTT
GAGGAACTCCCTCATGTGT -> AGGAACTCCCTCATGTGTT
GAGGAGAAACGAGCAATAG -> AGGAGAAACGAGCAATAGG
GAGGAGGGACACCTTGAAG -> AGGAGGGACACCTTGAAGT
GAGGCCTTCGAGACCTCCC -> AGGCCTTCGAGACCTCCCA
GAGGCTCCAGTCCAACCCC -> AGGCTCCAGTCCAACCCCC
GAGGCTGCTGCAGAACAGA -> AGGCTGCTGCAGAACAGAG
GAGGGACACCTTGAAGTTT -> AGGGACACCTTGAAGTTTC
GAGGTAGGGGCAATTAGGA -> AGGTAGGGGCAATTAGGAT
GAGGTAGTCTAGAACTGTT -> AGGTAGTCTAGAACTGTTT
GAGGTGCGTAGAGAAGCAC -> AGGTGCGTAGAGAAGCACC
GAGTAGAGTGTGTGCTACT -> AGTAGAGTGTGTGCTACTA
GAGTAGATTCCCAACCCCA -> AGTAGATTCCCAACCCCAG
GAGTAGCACACCCGGCTCT -> AGTAGCACACCCGGCTCTT
GAGTATACGTTGTAAATAG -> AGTATACGTTGTAAATAGA
GAGTATCGCTGAGAAACGA -> AGTATCGCTGAGAAACGAG
GAGTCAATGTATACATTTG -> AGTCAATGTATACATTTGT
GAGTCATTGGTAAAATGTT -> AGTCATTGGTAAAATGTTT
GAGTGTGTGCTACTAAGAA -> AGTGTGTGCTACTAAGAAC
GAGTGTTAAAAAAATGACG -> AGTGTTAAAAAAATGACGT
GAGTTGTTCTACGCATAGG -> AGTTGTTCTACGCATAGGG
GATAATCCACTTTGCGTTT -> ATAATCCACTTTGCGTTTG
GATAATGAGCTACCGGACC -> ATAATGAGCTACCGGACCA
GATACTTCGTTGGTAGTGC -> ATACTTCGTTGGTAGTGCT
GATATAGGATTTCAGGTTC -> ATATAGGATTTCAGGTTCC
GATATGCCATACCGGTTCA -> ATATGCCATACCGGTTCAA
GATCAAAAGGTTAGATCAC -> ATCAAAAGGTTAGATCACG
GATCACGGGAAATGGATAA -> ATCACGGGAAATGGATAAT
GATCAGTTATGCCCGTGAT -> ATCAGTTATGCCCGTGATA
GATCATAACTGTCTGCGGT -> ATCATAACTGTCTGCGGTA
GATCGTCATCCCACCTTAT -> ATCGTCATCCCACCTTATA
GATGCACATCGCTACACAG -> ATGCACATCGCTACACAGC
GATGCCATAGAACAACTGC -> ATGCCATAGAACAACTGCG
GATGCCGGTAACCTGTTTT -> ATGCCGGTAACCTGTTTTC
GATGGCCACCCTAGGTTTA -> ATGGCCACCCTAGGTTTAT
GATGTGTGTACGAGAGAAA -> ATGTGTGTACGAGAGAAAC
GATTAATGAGTAGATTCCC -> ATTAATGAGTAGATTCCCA
GATTCCCAACCCCAGCGCC -> ATTCCCAACCCCAGCGCCC
GATTCTAACGCAGCTCTTA -> ATTCTAACGCAGCTCTTAC
GATTTACTAAGCTCGGCGG -> ATTTACTAAGCTCGGCGGA
GATTTACTACGACTATCTC -> ATTTACTACGACTATCTCT
GATTTCAGGTTCCAAACTA -> ATTTCAGGTTCCAAACTAT
GATTTTCGAAATCCGCGGC -> ATTTTCGAAATCCGCGGCT
GATTTTCGCGCAAAGTAGG -> ATTTTCGCGCAAAGTAGGA
GCAAAGGAAGTAACCAAGT -> CAAAGGAAGTAACCAAGTA
GCAAAGGCTAACGAGTTGT -> CAAAGGCTAACGAGTTGTT
GCAAAGTAGGAAATCAACG -> CAAAGTAGGAAATCAACGG
GCAACCAAGAATGCGTGCG -> CAACCAAGAATGCGTGCGA
GCAACGGATAATCCACTTT -> CAACGGATAATCCACTTTG
GCAAGAGCGACCCGACTCG -> CAAGAGCGACCCGACTCGG
GCAAGGATGCCGGTAACCT -> CAAGGATGCCGGTAACCTG
GCAATAGGGAACTAAGTTA -> CAATAGGGAACTAAGTTAG
GCAATAGGGCACTAGCAGG -> CAATAGGGCACTAGCAGGG
GCAATAGGGGAATTGCTTA -> CAATAGGGGAATTGCTTAC
GCAATAGGGTTGTGCAGCG -> CAATAGGGTTGTGCAGCGC
GCAATTACGTCCTAGTTTA -> CAATTACGTCCTAGTTTAA
GCAATTAGGATTTTCGAAA -> CAATTAGGATTTTCGAAAT
GCACAAAGGAGCTGGTAAG -> CACAAAGGAGCTGGTAAGA
GCACAAGGTAGTTGTATCC -> CACAAGGTAGTTGTATCCG
GCACACACACATAGTCCCC -> CACACACACATAGTCCCCC
GCACACCCGGCTCTTGCCG -> CACACCCGGCTCTTGCCGC
GCACATCGCTACACAGCAA -> CACATCGCTACACAGCAAA
GCACCATCAAACATTCAGC -> CACCATCAAACATTCAGCT
GCACCCTGAACTCGCAGGA -> CACCCTGAACTCGCAGGAA
GCACTAGACGGTCTTGCCA -> CACTAGACGGTCTTGCCAT
GCACTAGCAGGGAACCAAG -> CACTAGCAGGGAACCAAGA
GCACTCCAAAGTCCGGCGC -> CACTCCAAAGTCCGGCGCA
GCACTCTGTTCTAATTTAG -> CACTCTGTTCTAATTTAGA
GCACTGTTATGTGCAAGGA -> CACTGTTATGTGCAAGGAT
GCAGAACAGAGCTTGAGTA -> CAGAACAGAGCTTGAGTAT
GCAGAAGCTTTACAGGGTA -> CAGAAGCTTTACAGGGTAT
GCAGCAGAAGCTTTACAGG -> CAGCAGAAGCTTTACAGGG
GCAGCGCAACCAAGAATGC -> CAGCGCAACCAAGAATGCG
GCAGCTCTTACCAAAGTGC -> CAGCTCTTACCAAAGTGCT
GCAGGAAGGGTTATAACGT -> CAGGAAGGGTTATAACGTT
GCAGGGAACCAAGAATGCG -> CAGGGAACCAAGAATGCGT
GCAGTCAGCATTGCACCCT -> CAGTCAGCATTGCACCCTG
GCATAGGGACGATTTACTA -> CATAGGGACGATTTACTAA
GCATCTCAACAGCTCCATG -> CATCTCAACAGCTCCATGC
GCATGTCCGCGTGTTATCG -> CATGTCCGCGTGTTATCGT
GCATTGCACCCTGAACTCG -> CATTGCACCCTGAACTCGC
GCCAACGGAAATCGTAAGC -> CCAACGGAAATCGTAAGCA
GCCACCCTAGGTTTATTAC -> CCACCCTAGGTTTATTACT
GCCATAACCAGGGATTCTA -> CCATAACCAGGGATTCTAA
GCCATACCGGTTCAAGCAG -> CCATACCGGTTCAAGCAGT
GCCATAGAACAACTGCGCA -> CCATAGAACAACTGCGCAC
GCCATCAGAGCGTTTATAC -> CCATCAGAGCGTTTATACA
GCCATCGTAGCGGTTATCC -> CCATCGTAGCGGTTATCCT
GCCATTTTGTATCCGTCTT -> CCATTTTGTATCCGTCTTC
GCCCATGAGTAGCACACCC -> CCCATGAGTAGCACACCCG
GCCCGAGGCTCCAGTCCAA -> CCCGAGGCTCCAGTCCAAC
GCCCGTGATATAGGATTTC -> CCCGTGATATAGGATTTCA
GCCGAAACTTTGTACAAGA -> CCGAAACTTTGTACAAGAA
GCCGCGATATGCCATACCG -> CCGCGATATGCCATACCGG
GCCGCGCTTCCTAGGGGCA -> CCGCGCTTCCTAGGGGCAA
GCCGCGTTGAGGAACTCCC -> CCGCGTTGAGGAACTCCCT
GCCGGTAACCTGTTTTCAT -> CCGGTAACCTGTTTTCATG
GCCTACTTGTCATATCTAG -> CCTACTTGTCATATCTAGA
GCCTTCGAGACCTCCCAAG -> CCTTCGAGACCTCCCAAGA
GCCTTTACCGTATCCGAGG -> CCTTTACCGTATCCGAGGC
GCGAACACCTGGTGGAACC -> CGAACACCTGGTGGAACCA
GCGACCCGACTCGGTCTTC -> CGACCCGACTCGGTCTTCG
GCGACCGCATGTCCGCGTG -> CGACCGCATGTCCGCGTGT
GCGACCGGAATTTGAAGGT -> CGACCGGAATTTGAAGGTA
GCGACGTTGATACTTCGTT -> CGACGTTGATACTTCGTTG
GCGACTAGCCGAAACTTTG -> CGACTAGCCGAAACTTTGT
GCGAGGAGGGACACCTTGA -> CGAGGAGGGACACCTTGAA
GCGATATGCCATACCGGTT -> CGATATGCCATACCGGTTC
GCGCAAAGTAGGAAATCAA -> CGCAAAGTAGGAAATCAAC
GCGCAACCAAGAATGCGTG -> CGCAACCAAGAATGCGTGC
GCGCAATTACGTCCTAGTT -> CGCAATTACGTCCTAGTTT
GCGCACTAGACGGTCTTGC -> CGCACTAGACGGTCTTGCC
GCGCACTCTGTTCTAATTT -> CGCACTCTGTTCTAATTTA
GCGCCATCGTAGCGGTTAT -> CGCCATCGTAGCGGTTATC
GCGCCCGAGGCTCCAGTCC -> CGCCCGAGGCTCCAGTCCA
GCGCTGGACCTATAACGTT -> CGCTGGACCTATAACGTTT
GCGCTTCCTAGGGGCAAGA -> CGCTTCCTAGGGGCAAGAG
GCGGAAAATTTCCCCATCC -> CGGAAAATTTCCCCATCCG
GCGGAGGTAGGGGCAATTA -> CGGAGGTAGGGGCAATTAG
GCGGATGGCCACCCTAGGT -> CGGATGGCCACCCTAGGTT
GCGGCTAACGCTCTTAGGG -> CGGCTAACGCTCTTAGGGT
GCGGTAGTTTCTAAGACAT -> CGGTAGTTTCTAAGACATA
GCGGTTATCCTTATCTGTA -> CGGTTATCCTTATCTGTAT
GCGTACAGCATCTCAACAG -> CGTACAGCATCTCAACAGC
GCGTAGAGAAGCACCATCA -> CGTAGAGAAGCACCATCAA
GCGTCCAGGCTATAGACGA -> CGTCCAGGCTATAGACGAC
GCGTGAATGAAGTCAGGGG -> CGTGAATGAAGTCAGGGGA
GCGTGCGACCGCATGTCCG -> CGTGCGACCGCATGTCCGC
GCGTGCGACCGGAATTTGA -> CGTGCGACCGGAATTTGAA
GCGTGCGACGTTGATACTT -> CGTGCGACGTTGATACTTC
GCGTGCGACTAGCCGAAAC -> CGTGCGACTAGCCGAAACT
GCGTGGTGTTTACTCTGTA -> CGTGGTGTTTACTCTGTAG
GCGTGTAATGATTTTCGCG -> CGTGTAATGATTTTCGCGC
GCGTGTTATCGTTTTAATC -> CGTGTTATCGTTTTAATCC
GCGTTGAGGAACTCCCTCA -> CGTTGAGGAACTCCCTCAT
GCGTTTATACAGCACACAC -> CGTTTATACAGCACACACA
GCGTTTGTAGGTTGGGTTA -> CGTTTGTAGGTTGGGTTAC
GCTAACGAGTTGTTCTACG -> CTAACGAGTTGTTCTACGC
GCTAACGCTCTTAGGGTAA -> CTAACGCTCTTAGGGTAAG
GCTAATGGCCATCAGAGCG -> CTAATGGCCATCAGAGCGT
GCTACACAGCAAAGGAAGT -> CTACACAGCAAAGGAAGTA
GCTACACGAGAACGGATCG -> CTACACGAGAACGGATCGT
GCTACCGGACCAGATCATA -> CTACCGGACCAGATCATAA
GCTACTAAGAACTTGCTAC -> CTACTAAGAACTTGCTACA
GCTAGCGTGGTGTTTACTC -> CTAGCGTGGTGTTTACTCT
GCTATAGACGACCAGGAGG -> CTATAGACGACCAGGAGGT
GCTCCAGTCCAACCCCCCC -> CTCCAGTCCAACCCCCCCA
GCTCCATGCTTCGGGTCCC -> CTCCATGCTTCGGGTCCCG
GCTCGGCGGAGGTAGGGGC -> CTCGGCGGAGGTAGGGGCA
GCTCTCTTTGGCCTTTACC -> CTCTCTTTGGCCTTTACCG
GCTCTTACCAAAGTGCTCT -> CTCTTACCAAAGTGCTCTC
GCTCTTAGGGTAAGAGGAG -> CTCTTAGGGTAAGAGGAGA
GCTCTTCACAAGGCACTCC -> CTCTTCACAAGGCACTCCA
GCTCTTCGGTTAGACCGTC -> CTCTTCGGTTAGACCGTCA
GCTCTTGCCGCGATATGCC -> CTCTTGCCGCGATATGCCA
GCTGAGAAACGAGCAATAG -> CTGAGAAACGAGCAATAGG
GCTGAGAGAGAGACCCACT -> CTGAGAGAGAGACCCACTC
GCTGATCAGTTATGCCCGT -> CTGATCAGTTATGCCCGTG
GCTGCAGAACAGAGCTTGA -> CTGCAGAACAGAGCTTGAG
GCTGCTGCAGAACAGAGCT -> CTGCTGCAGAACAGAGCTT
GCTGGACCTATAACGTTTC -> CTGGACCTATAACGTTTCG
GCTGGGGGCTCTTCACAAG -> CTGGGGGCTCTTCACAAGG
GCTGGTAAGACGGTGGAGT -> CTGGTAAGACGGTGGAGTA
GCTGTCACAGAACAGACTA -> CTGTCACAGAACAGACTAA
GCTTACAACCAAGAATGCG -> CTTACAACCAAGAATGCGT
GCTTCCTAGGGGCAAGAGC -> CTTCCTAGGGGCAAGAGCG
GCTTCGGGTCCCGCAAAGG -> CTTCGGGTCCCGCAAAGGC
GCTTGACGAGTGTTAAAAA -> CTTGACGAGTGTTAAAAAA
GCTTGAGTATACGTTGTAA -> CTTGAGTATACGTTGTAAA
GCTTTACAGGGTATAGCTG -> CTTTACAGGGTATAGCTGA
GCTTTATGAACTCCCTTTC -> CTTTATGAACTCCCTTTCG
GCTTTGACCAAAACTGATG -> CTTTGACCAAAACTGATGC
GGAAAATTTCCCCATCCGC -> GAAAATTTCCCCATCCGCC
GGAAATCAACGGGGGCGGA -> GAAATCAACGGGGGCGGAA
GGAAATCGTAAGCAGCAGA -> GAAATCGTAAGCAGCAGAA
GGAAATGGATAATGAGCTA -> GAAATGGATAATGAGCTAC
GGAACCAAGAATGCGTGCG -> GAACCAAGAATGCGTGCGA
GGAACCACGAGGTGCGTAG -> GAACCACGAGGTGCGTAGA
GGAACTAAGTTAGAACCAA -> GAACTAAGTTAGAACCAAG
GGAACTCCCTCATGTGTTG -> GAACTCCCTCATGTGTTGT
GGAAGAATACGGCTGATCA -> GAAGAATACGGCTGATCAG
GGAAGGGTTATAACGTTGG -> GAAGGGTTATAACGTTGGC
GGAAGTAACCAAGTACCAT -> GAAGTAACCAAGTACCATC
GGAATTGCTTACAACCAAG -> GAATTGCTTACAACCAAGA
GGAATTTGAAGGTAACAGG -> GAATTTGAAGGTAACAGGA
GGACACCTTGAAGTTTCTT -> GACACCTTGAAGTTTCTTA
GGACCAGATCATAACTGTC -> GACCAGATCATAACTGTCT
GGACCTATAACGTTTCGGG -> GACCTATAACGTTTCGGGG
GGACGAAGTTATTCTTGCA -> GACGAAGTTATTCTTGCAC
GGACGATTTACTAAGCTCG -> GACGATTTACTAAGCTCGG
GGAGAAACGAGCAATAGGG -> GAGAAACGAGCAATAGGGG
GGAGAAACTTGCGTGTAAT -> GAGAAACTTGCGTGTAATG
GGAGCTGGTAAGACGGTGG -> GAGCTGGTAAGACGGTGGA
GGAGCTTTATGAACTCCCT -> GAGCTTTATGAACTCCCTT
GGAGGGACACCTTGAAGTT -> GAGGGACACCTTGAAGTTT
GGAGGTAGGGGCAATTAGG -> GAGGTAGGGGCAATTAGGA
GGAGGTAGTCTAGAACTGT -> GAGGTAGTCTAGAACTGTT
GGAGTATCGCTGAGAAACG -> GAGTATCGCTGAGAAACGA
GGAGTCATTGGTAAAATGT -> GAGTCATTGGTAAAATGTT
GGATAATCCACTTTGCGTT -> GATAATCCACTTTGCGTTT
GGATAATGAGCTACCGGAC -> GATAATGAGCTACCGGACC
GGATCGTCATCCCACCTTA -> GATCGTCATCCCACCTTAT
GGATGCCGGTAACCTGTTT -> GATGCCGGTAACCTGTTTT
GGATGGCCACCCTAGGTTT -> GATGGCCACCCTAGGTTTA
GGATGTGTGTACGAGAGAA -> GATGTGTGTACGAGAGAAA
GGATTCTAACGCAGCTCTT -> GATTCTAACGCAGCTCTTA
GGATTTCAGGTTCCAAACT -> GATTTCAGGTTCCAAACTA
GGATTTTCGAAATCCGCGG -> GATTTTCGAAATCCGCGGC
GGCAAGAGCGACCCGACTC -> GCAAGAGCGACCCGACTCG
GGCAATTAGGATTTTCGAA -> GCAATTAGGATTTTCGAAA
GGCACTAGCAGGGAACCAA -> GCACTAGCAGGGAACCAAG
GGCACTCCAAAGTCCGGCG -> GCACTCCAAAGTCCGGCGC
GGCCAACGGAAATCGTAAG -> GCCAACGGAAATCGTAAGC
GGCCACCCTAGGTTTATTA -> GCCACCCTAGGTTTATTAC
GGCCATAACCAGGGATTCT -> GCCATAACCAGGGATTCTA
GGCCATCAGAGCGTTTATA -> GCCATCAGAGCGTTTATAC
GGCCCATGAGTAGCACACC -> GCCCATGAGTAGCACACCC
GGCCGCGTTGAGGAACTCC -> GCCGCGTTGAGGAACTCCC
GGCCTTCGAGACCTCCCAA -> GCCTTCGAGACCTCCCAAG
GGCCTTTACCGTATCCGAG -> GCCTTTACCGTATCCGAGG
GGCGCAATTACGTCCTAGT -> GCGCAATTACGTCCTAGTT
GGCGCACTAGACGGTCTTG -> GCGCACTAGACGGTCTTGC
GGCGGAAAATTTCCCCATC -> GCGGAAAATTTCCCCATCC
GGCGGAGGTAGGGGCAATT -> GCGGAGGTAGGGGCAATTA
GGCGTGAATGAAGTCAGGG -> GCGTGAATGAAGTCAGGGG
GGCTAACGAGTTGTTCTAC -> GCTAACGAGTTGTTCTACG
GGCTAACGCTCTTAGGGTA -> GCTAACGCTCTTAGGGTAA
GGCTATAGACGACCAGGAG -> GCTATAGACGACCAGGAGG
GGCTCCAGTCCAACCCCCC -> GCTCCAGTCCAACCCCCCC
GGCTCTTCACAAGGCACTC -> GCTCTTCACAAGGCACTCC
GGCTCTTGCCGCGATATGC -> GCTCTTGCCGCGATATGCC
GGCTGATCAGTTATGCCCG -> GCTGATCAGTTATGCCCGT
GGCTGCTGCAGAACAGAGC -> GCTGCTGCAGAACAGAGCT
GGCTGGGGGCTCTTCACAA -> GCTGGGGGCTCTTCACAAG
GGCTTGACGAGTGTTAAAA -> GCTTGACGAGTGTTAAAAA
GGGAAATGGATAATGAGCT -> GGAAATGGATAATGAGCTA
GGGAACCAAGAATGCGTGC -> GGAACCAAGAATGCGTGCG
GGGAACTAAGTTAGAACCA -> GGAACTAAGTTAGAACCAA
GGGAATTGCTTACAACCAA -> GGAATTGCTTACAACCAAG
GGGACACCTTGAAGTTTCT -> GGACACCTTGAAGTTTCTT
GGGACGAAGTTATTCTTGC -> GGACGAAGTTATTCTTGCA
GGGACGATTTACTAAGCTC -> GGACGATTTACTAAGCTCG
GGGATTCTAACGCAGCTCT -> GGATTCTAACGCAGCTCTT
GGGCAAGAGCGACCCGACT -> GGCAAGAGCGACCCGACTC
GGGCAATTAGGATTTTCGA -> GGCAATTAGGATTTTCGAA
GGGCACTAGCAGGGAACCA -> GGCACTAGCAGGGAACCAA
GGGCCAACGGAAATCGTAA -> GGCCAACGGAAATCGTAAG
GGGCCCATGAGTAGCACAC -> GGCCCATGAGTAGCACACC
GGGCGGAAAATTTCCCCAT -> GGCGGAAAATTTCCCCATC
GGGCTCTTCACAAGGCACT -> GGCTCTTCACAAGGCACTC
GGGGAATTGCTTACAACCA -> GGGAATTGCTTACAACCAA
GGGGACGAAGTTATTCTTG -> GGGACGAAGTTATTCTTGC
GGGGCAAGAGCGACCCGAC -> GGGCAAGAGCGACCCGACT
GGGGCAATTAGGATTTTCG -> GGGCAATTAGGATTTTCGA
GGGGCCCATGAGTAGCACA -> GGGCCCATGAGTAGCACAC
GGGGCGGAAAATTTCCCCA -> GGGCGGAAAATTTCCCCAT
GGGGCTCTTCACAAGGCAC -> GGGCTCTTCACAAGGCACT
GGGGGCGGAAAATTTCCCC -> GGGGCGGAAAATTTCCCCA
GGGGGCTCTTCACAAGGCA -> GGGGCTCTTCACAAGGCAC
GGGTAAGAGGAGAAACGAG -> GGTAAGAGGAGAAACGAGC
GGGTATAGCTGAGAGAGAG -> GGTATAGCTGAGAGAGAGA
GGGTCCCGCAAAGGCTAAC -> GGTCCCGCAAAGGCTAACG
GGGTCGAACGCAACGGATA -> GGTCGAACGCAACGGATAA
GGGTGAAAGAGGCCTTCGA -> GGTGAAAGAGGCCTTCGAG
GGGTTACAGTGAGAGTCAA -> GGTTACAGTGAGAGTCAAT
GGGTTATAACGTTGGCTTG -> GGTTATAACGTTGGCTTGA
GGGTTCCCCTCAGGAGAAA -> GGTTCCCCTCAGGAGAAAC
GGGTTGTGCAGCGCAACCA -> GGTTGTGCAGCGCAACCAA
GGTAAAATGTTTTTCATCT -> GTAAAATGTTTTTCATCTT
GGTAACAGGAGTCATTGGT -> GTAACAGGAGTCATTGGTA
GGTAACCTGTTTTCATGGT -> GTAACCTGTTTTCATGGTC
GGTAAGACGGTGGAGTATC -> GTAAGACGGTGGAGTATCG
GGTAAGAGGAGAAACGAGC -> GTAAGAGGAGAAACGAGCA
GGTACCACCGACTGTCAGG -> GTACCACCGACTGTCAGGG
GGTAGGGGCAATTAGGATT -> GTAGGGGCAATTAGGATTT
GGTAGTCTAGAACTGTTTC -> GTAGTCTAGAACTGTTTCT
GGTAGTGCTGTCACAGAAC -> GTAGTGCTGTCACAGAACA
GGTAGTTGTATCCGGCGCA -> GTAGTTGTATCCGGCGCAC
GGTAGTTTCTAAGACATAG -> GTAGTTTCTAAGACATAGT
GGTATAGCTGAGAGAGAGA -> GTATAGCTGAGAGAGAGAC
GGTCACGATTAATGAGTAG -> GTCACGATTAATGAGTAGA
GGTCCCGCAAAGGCTAACG -> GTCCCGCAAAGGCTAACGA
GGTCGAACGCAACGGATAA -> GTCGAACGCAACGGATAAT
GGTCTTCGGAAGAATACGG -> GTCTTCGGAAGAATACGGC
GGTCTTGCCATTTTGTATC -> GTCTTGCCATTTTGTATCC
GGTGAAAGAGGCCTTCGAG -> GTGAAAGAGGCCTTCGAGA
GGTGCGTAGAGAAGCACCA -> GTGCGTAGAGAAGCACCAT
GGTGGAACCACGAGGTGCG -> GTGGAACCACGAGGTGCGT
GGTGGAGTATCGCTGAGAA -> GTGGAGTATCGCTGAGAAA
GGTGTTTACTCTGTAGAGT -> GTGTTTACTCTGTAGAGTA
GGTTACAGTGAGAGTCAAT -> GTTACAGTGAGAGTCAATG
GGTTAGACCGTCAGCGAGG -> GTTAGACCGTCAGCGAGGA
GGTTAGATCACGGGAAATG -> GTTAGATCACGGGAAATGG
GGTTATAACGTTGGCTTGA -> GTTATAACGTTGGCTTGAC
GGTTATATCAAGGAGCTTT -> GTTATATCAAGGAGCTTTA
GGTTATCCTTATCTGTATC -> GTTATCCTTATCTGTATCT
GGTTCAAGCAGTCAGCATT -> GTTCAAGCAGTCAGCATTG
GGTTCCAAACTATTTGGCT -> GTTCCAAACTATTTGGCTG
GGTTCCCCTCAGGAGAAAC -> GTTCCCCTCAGGAGAAACT
GGTTGGGTTACAGTGAGAG -> GTTGGGTTACAGTGAGAGT
GGTTGTGCAGCGCAACCAA -> GTTGTGCAGCGCAACCAAG
GGTTTATTACTGCCGCGCT -> GTTTATTACTGCCGCGCTT
GTAAAATGTTTTTCATCTT -> TAAAATGTTTTTCATCTTC
GTAAATAGAGCGGATGGCC -> TAAATAGAGCGGATGGCCA
GTAACAGGAGTCATTGGTA -> TAACAGGAGTCATTGGTAA
GTAACCAAGTACCATCTAA -> TAACCAAGTACCATCTAAC
GTAACCTGTTTTCATGGTC -> TAACCTGTTTTCATGGTCA
GTAAGACGGTGGAGTATCG -> TAAGACGGTGGAGTATCGC
GTAAGAGGAGAAACGAGCA -> TAAGAGGAGAAACGAGCAA
GTAAGCAGCAGAAGCTTTA -> TAAGCAGCAGAAGCTTTAC
GTAATGATTTTCGCGCAAA -> TAATGATTTTCGCGCAAAG
GTACAAGAAAGGCCGCGTT -> TACAAGAAAGGCCGCGTTG
GTACAGCATCTCAACAGCT -> TACAGCATCTCAACAGCTC
GTACCACCGACTGTCAGGG -> TACCACCGACTGTCAGGGT
GTACCATCTAACTAACTTC -> TACCATCTAACTAACTTCT
GTACCATCTCCTTATTCTG -> TACCATCTCCTTATTCTGT
GTACGAGAGAAACGAGCAA -> TACGAGAGAAACGAGCAAT
GTAGAGAAGCACCATCAAA -> TAGAGAAGCACCATCAAAC
GTAGAGTAGAGTGTGTGCT -> TAGAGTAGAGTGTGTGCTA
GTAGAGTGTGTGCTACTAA -> TAGAGTGTGTGCTACTAAG
GTAGATTCCCAACCCCAGC -> TAGATTCCCAACCCCAGCG
GTAGCACACCCGGCTCTTG -> TAGCACACCCGGCTCTTGC
GTAGCGGTTATCCTTATCT -> TAGCGGTTATCCTTATCTG
GTAGGAAATCAACGGGGGC -> TAGGAAATCAACGGGGGCG
GTAGGGGCAATTAGGATTT -> TAGGGGCAATTAGGATTTT
GTAGGTTGGGTTACAGTGA -> TAGGTTGGGTTACAGTGAG
GTAGTCTAGAACTGTTTCT -> TAGTCTAGAACTGTTTCTA
GTAGTGCTGTCACAGAACA -> TAGTGCTGTCACAGAACAG
GTAGTTGTATCCGGCGCAC -> TAGTTGTATCCGGCGCACT
GTAGTTTCTAAGACATAGT -> TAGTTTCTAAGACATAGTA
GTATACATTTGTTCCTTCA -> TATACATTTGTTCCTTCAT
GTATACGTTGTAAATAGAG -> TATACGTTGTAAATAGAGC
GTATAGCTGAGAGAGAGAC -> TATAGCTGAGAGAGAGACC
GTATCCGAGGCTGCTGCAG -> TATCCGAGGCTGCTGCAGA
GTATCCGGCGCACTAGACG -> TATCCGGCGCACTAGACGG
GTATCCGTCTTCCACGCTC -> TATCCGTCTTCCACGCTCT
GTATCCTGGATGTGTGTAC -> TATCCTGGATGTGTGTACG
GTATCGCTGAGAAACGAGC -> TATCGCTGAGAAACGAGCA
GTATCTGTCCCAGGGCCAA -> TATCTGTCCCAGGGCCAAC
GTCAATGTATACATTTGTT -> TCAATGTATACATTTGTTC
GTCACAGAACAGACTAAAG -> TCACAGAACAGACTAAAGG
GTCACGATTAATGAGTAGA -> TCACGATTAATGAGTAGAT
GTCAGCATTGCACCCTGAA -> TCAGCATTGCACCCTGAAC
GTCAGCGAGGAGGGACACC -> TCAGCGAGGAGGGACACCT
GTCAGGGGACGAAGTTATT -> TCAGGGGACGAAGTTATTC
GTCAGGGTGAAAGAGGCCT -> TCAGGGTGAAAGAGGCCTT
GTCATAGCGCCATCGTAGC -> TCATAGCGCCATCGTAGCG
GTCATATCTAGATCAAAAG -> TCATATCTAGATCAAAAGG
GTCATCCCACCTTATAAGG -> TCATCCCACCTTATAAGGC
GTCATTGGTAAAATGTTTT -> TCATTGGTAAAATGTTTTT
GTCCAACCCCCCCATATTC -> TCCAACCCCCCCATATTCA
GTCCAGCGTACAGCATCTC -> TCCAGCGTACAGCATCTCA
GTCCAGGCTATAGACGACC -> TCCAGGCTATAGACGACCA
GTCCCAGGGCCAACGGAAA -> TCCCAGGGCCAACGGAAAT
GTCCCCCAATTTCTAACTA -> TCCCCCAATTTCTAACTAG
GTCCCGCAAAGGCTAACGA -> TCCCGCAAAGGCTAACGAG
GTCCGCGTGTTATCGTTTT -> TCCGCGTGTTATCGTTTTA
GTCCGGCGCAATTACGTCC -> TCCGGCGCAATTACGTCCT
GTCCTAGTTTAACTAACGG -> TCCTAGTTTAACTAACGGG
GTCGAACGCAACGGATAAT -> TCGAACGCAACGGATAATC
GTCTAGAACTGTTTCTATG -> TCTAGAACTGTTTCTATGG
GTCTGCGGTAGTTTCTAAG -> TCTGCGGTAGTTTCTAAGA
GTCTTCCACGCTCTTCGGT -> TCTTCCACGCTCTTCGGTT
GTCTTCGGAAGAATACGGC -> TCTTCGGAAGAATACGGCT
GTCTTGCCATTTTGTATCC -> TCTTGCCATTTTGTATCCG
GTGAAAGAGGCCTTCGAGA -> TGAAAGAGGCCTTCGAGAC
GTGAATGAAGTCAGGGGAC -> TGAATGAAGTCAGGGGACG
GTGAGAGTCAATGTATACA -> TGAGAGTCAATGTATACAT
GTGATATAGGATTTCAGGT -> TGATATAGGATTTCAGGTT
GTGCAAGGATGCCGGTAAC -> TGCAAGGATGCCGGTAACC
GTGCAGCGCAACCAAGAAT -> TGCAGCGCAACCAAGAATG
GTGCGAACACCTGGTGGAA -> TGCGAACACCTGGTGGAAC
GTGCGACCGCATGTCCGCG -> TGCGACCGCATGTCCGCGT
GTGCGACCGGAATTTGAAG -> TGCGACCGGAATTTGAAGG
GTGCGACGTTGATACTTCG -> TGCGACGTTGATACTTCGT
GTGCGACTAGCCGAAACTT -> TGCGACTAGCCGAAACTTT
GTGCGTAGAGAAGCACCAT -> TGCGTAGAGAAGCACCATC
GTGCTACTAAGAACTTGCT -> TGCTACTAAGAACTTGCTA
GTGCTCTCTTTGGCCTTTA -> TGCTCTCTTTGGCCTTTAC
GTGCTGTCACAGAACAGAC -> TGCTGTCACAGAACAGACT
GTGGAACCACGAGGTGCGT -> TGGAACCACGAGGTGCGTA
GTGGAGTATCGCTGAGAAA -> TGGAGTATCGCTGAGAAAC
GTGGTGTTTACTCTGTAGA -> TGGTGTTTACTCTGTAGAG
GTGTAATGATTTTCGCGCA -> TGTAATGATTTTCGCGCAA
GTGTACGAGAGAAACGAGC -> TGTACGAGAGAAACGAGCA
GTGTATCCTGGATGTGTGT -> TGTATCCTGGATGTGTGTA
GTGTCATAGCGCCATCGTA -> TGTCATAGCGCCATCGTAG
GTGTGCTACTAAGAACTTG -> TGTGCTACTAAGAACTTGC
GTGTGTACGAGAGAAACGA -> TGTGTACGAGAGAAACGAG
GTGTGTGCTACTAAGAACT -> TGTGTGCTACTAAGAACTT
GTGTTAAAAAAATGACGTT -> TGTTAAAAAAATGACGTTC
GTGTTATCGTTTTAATCCC -> TGTTATCGTTTTAATCCCC
GTGTTGTTCCTGTGTATCC -> TGTTGTTCCTGTGTATCCT
GTGTTTACTCTGTAGAGTA -> TGTTTACTCTGTAGAGTAG
GTTAAAAAAATGACGTTCC -> TTAAAAAAATGACGTTCCG
GTTACAGTGAGAGTCAATG -> TTACAGTGAGAGTCAATGT
GTTAGAACCAAGAATGCGT -> TTAGAACCAAGAATGCGTG
GTTAGACCGTCAGCGAGGA -> TTAGACCGTCAGCGAGGAG
GTTAGATCACGGGAAATGG -> TTAGATCACGGGAAATGGA
GTTAGCTAGCGTGGTGTTT -> TTAGCTAGCGTGGTGTTTA
GTTATAACGTTGGCTTGAC -> TTATAACGTTGGCTTGACG
GTTATATCAAGGAGCTTTA -> TTATATCAAGGAGCTTTAT
GTTATCCTTATCTGTATCT -> TTATCCTTATCTGTATCTG
GTTATCGTTTTAATCCCCG -> TTATCGTTTTAATCCCCGC
GTTATGCCCGTGATATAGG -> TTATGCCCGTGATATAGGA
GTTATGTGCAAGGATGCCG -> TTATGTGCAAGGATGCCGG
GTTATTCTTGCACAAAGGA -> TTATTCTTGCACAAAGGAG
GTTCAAGCAGTCAGCATTG -> TTCAAGCAGTCAGCATTGC
GTTCCAAACTATTTGGCTG -> TTCCAAACTATTTGGCTGG
GTTCCCCTCAGGAGAAACT -> TTCCCCTCAGGAGAAACTT
GTTCCGCACTGTTATGTGC -> TTCCGCACTGTTATGTGCA
GTTCCTGTGTATCCTGGAT -> TTCCTGTGTATCCTGGATG
GTTCCTTCATAGCTAATGG -> TTCCTTCATAGCTAATGGC
GTTCGATGCCATAGAACAA -> TTCGATGCCATAGAACAAC
GTTCTAATTTAGACGAGAA -> TTCTAATTTAGACGAGAAA
GTTCTACGCATAGGGACGA -> TTCTACGCATAGGGACGAT
GTTGAGGAACTCCCTCATG -> TTGAGGAACTCCCTCATGT
GTTGATACTTCGTTGGTAG -> TTGATACTTCGTTGGTAGT
GTTGGCTTGACGAGTGTTA -> TTGGCTTGACGAGTGTTAA
GTTGGGTTACAGTGAGAGT -> TTGGGTTACAGTGAGAGTC
GTTGGTAGTGCTGTCACAG -> TTGGTAGTGCTGTCACAGA
GTTGTAAATAGAGCGGATG -> TTGTAAATAGAGCGGATGG
GTTGTATCCGGCGCACTAG -> TTGTATCCGGCGCACTAGA
GTTGTGCAGCGCAACCAAG -> TTGTGCAGCGCAACCAAGA
GTTGTTCCTGTGTATCCTG -> TTGTTCCTGTGTATCCTGG
GTTGTTCTACGCATAGGGA -> TTGTTCTACGCATAGGGAC
GTTTAACTAACGGGTCGAA -> TTTAACTAACGGGTCGAAC
GTTTACTCTGTAGAGTAGA -> TTTACTCTGTAGAGTAGAG
GTTTATACAGCACACACAC -> TTTATACAGCACACACACA
GTTTATTACTGCCGCGCTT -> TTTATTACTGCCGCGCTTC
GTTTCGGGGCCCATGAGTA -> TTTCGGGGCCCATGAGTAG
GTTTCTAAGACATAGTACC -> TTTCTAAGACATAGTACCA
GTTTCTATGGGTTCCCCTC -> TTTCTATGGGTTCCCCTCA
GTTTCTTAAGTGTCATAGC -> TTTCTTAAGTGTCATAGCG
GTTTGTAGGTTGGGTTACA -> TTTGTAGGTTGGGTTACAG
GTTTTAATCCCCGCGTCCA -> TTTTAATCCCCGCGTCCAG
GTTTTCATGGTCACGATTA -> TTTTCATGGTCACGATTAA
GTTTTTCATCTTCTAATTC -> TTTTTCATCTTCTAATTCG
TAAAAAAATGACGTTCCGC -> AAAAAAATGACGTTCCGCA
TAAAATGTTTTTCATCTTC -> AAAATGTTTTTCATCTTCT
TAAAGGCCATAACCAGGGA -> AAAGGCCATAACCAGGGAT
TAAATAGAGCGGATGGCCA -> AAATAGAGCGGATGGCCAC
TAACAGGAGTCATTGGTAA -> AACAGGAGTCATTGGTAAA
TAACCAAGTACCATCTAAC -> AACCAAGTACCATCTAACT
TAACCAGGGATTCTAACGC -> AACCAGGGATTCTAACGCA
TAACCTGTTTTCATGGTCA -> AACCTGTTTTCATGGTCAC
TAACGAGTTGTTCTACGCA -> AACGAGTTGTTCTACGCAT
TAACGCAGCTCTTACCAAA -> AACGCAGCTCTTACCAAAG
TAACGCTCTTAGGGTAAGA -> AACGCTCTTAGGGTAAGAG
TAACGGGTCGAACGCAACG -> AACGGGTCGAACGCAACGG
TAACGTTGGCTTGACGAGT -> AACGTTGGCTTGACGAGTG
TAACGTTTCGGGGCCCATG -> AACGTTTCGGGGCCCATGA
TAACTAACGGGTCGAACGC -> AACTAACGGGTCGAACGCA
TAACTAACTTCTATTACAC -> AACTAACTTCTATTACACG
TAACTAGACGGTTATATCA -> AACTAGACGGTTATATCAA
TAACTGTCTGCGGTAGTTT -> AACTGTCTGCGGTAGTTTC
TAACTTCTATTACACGTTC -> AACTTCTATTACACGTTCG
TAAGAACTTGCTACACGAG -> AAGAACTTGCTACACGAGA
TAAGACATAGTACCATCTC -> AAGACATAGTACCATCTCC
TAAGACGATTTACTACGAC -> AAGACGATTTACTACGACT
TAAGACGGTGGAGTATCGC -> AAGACGGTGGAGTATCGCT
TAAGAGGAGAAACGAGCAA -> AAGAGGAGAAACGAGCAAT
TAAGCAGCAGAAGCTTTAC -> AAGCAGCAGAAGCTTTACA
TAAGCTCGGCGGAGGTAGG -> AAGCTCGGCGGAGGTAGGG
TAAGGCGTGAATGAAGTCA -> AAGGCGTGAATGAAGTCAG
TAAGTGTCATAGCGCCATC -> AAGTGTCATAGCGCCATCG
TAAGTTAGAACCAAGAATG -> AAGTTAGAACCAAGAATGC
TAATCCACTTTGCGTTTGT -> AATCCACTTTGCGTTTGTA
TAATCCCCGCGTCCAGGCT -> AATCCCCGCGTCCAGGCTA
TAATGAGCTACCGGACCAG -> AATGAGCTACCGGACCAGA
TAATGAGTAGATTCCCAAC -> AATGAGTAGATTCCCAACC
TAATGATTTTCGCGCAAAG -> AATGATTTTCGCGCAAAGT
TAATGGCCATCAGAGCGTT -> AATGGCCATCAGAGCGTTT
TAATTCGTCCAGCGTACAG -> AATTCGTCCAGCGTACAGC
TAATTTAGACGAGAAACGA -> AATTTAGACGAGAAACGAG
TACAACCAAGAATGCGTGC -> ACAACCAAGAATGCGTGCG
TACAAGAAAGGCCGCGTTG -> ACAAGAAAGGCCGCGTTGA
TACACAGCAAAGGAAGTAA -> ACACAGCAAAGGAAGTAAC
TACACGAGAACGGATCGTC -> ACACGAGAACGGATCGTCA
TACACGTTCGATGCCATAG -> ACACGTTCGATGCCATAGA
TACAGCACACACACATAGT -> ACAGCACACACACATAGTC
TACAGCATCTCAACAGCTC -> ACAGCATCTCAACAGCTCC
TACAGGGTATAGCTGAGAG -> ACAGGGTATAGCTGAGAGA
TACAGTGAGAGTCAATGTA -> ACAGTGAGAGTCAATGTAT
TACATTTGTTCCTTCATAG -> ACATTTGTTCCTTCATAGC
TACCAAAGTGCTCTCTTTG -> ACCAAAGTGCTCTCTTTGG
TACCACCGACTGTCAGGGT -> ACCACCGACTGTCAGGGTG
TACCATCTAACTAACTTCT -> ACCATCTAACTAACTTCTA
TACCATCTCCTTATTCTGT -> ACCATCTCCTTATTCTGTT
TACCGGACCAGATCATAAC -> ACCGGACCAGATCATAACT
TACCGGTTCAAGCAGTCAG -> ACCGGTTCAAGCAGTCAGC
TACCGTATCCGAGGCTGCT -> ACCGTATCCGAGGCTGCTG
TACGACTATCTCTCCGACT -> ACGACTATCTCTCCGACTG
TACGAGAGAAACGAGCAAT -> ACGAGAGAAACGAGCAATA
TACGCATAGGGACGATTTA -> ACGCATAGGGACGATTTAC
TACGGCTGATCAGTTATGC -> ACGGCTGATCAGTTATGCC
TACGTCCTAGTTTAACTAA -> ACGTCCTAGTTTAACTAAC
TACGTTGTAAATAGAGCGG -> ACGTTGTAAATAGAGCGGA
TACTAAGAACTTGCTACAC -> ACTAAGAACTTGCTACACG
TACTAAGCTCGGCGGAGGT -> ACTAAGCTCGGCGGAGGTA
TACTACGACTATCTCTCCG -> ACTACGACTATCTCTCCGA
TACTCTGTAGAGTAGAGTG -> ACTCTGTAGAGTAGAGTGT
TACTGCCGCGCTTCCTAGG -> ACTGCCGCGCTTCCTAGGG
TACTTCGTTGGTAGTGCTG -> ACTTCGTTGGTAGTGCTGT
TACTTGTCATATCTAGATC -> ACTTGTCATATCTAGATCA
TAGAACAACTGCGCACTCT -> AGAACAACTGCGCACTCTG
TAGAACCAAGAATGCGTGC -> AGAACCAAGAATGCGTGCG
TAGAACTGTTTCTATGGGT -> AGAACTGTTTCTATGGGTT
TAGACCGTCAGCGAGGAGG -> AGACCGTCAGCGAGGAGGG
TAGACGACCAGGAGGTAGT -> AGACGACCAGGAGGTAGTC
TAGACGAGAAACGAGCAAT -> AGACGAGAAACGAGCAATA
TAGACGGTCTTGCCATTTT -> AGACGGTCTTGCCATTTTG
TAGACGGTTATATCAAGGA -> AGACGGTTATATCAAGGAG
TAGAGAAGCACCATCAAAC -> AGAGAAGCACCATCAAACA
TAGAGCGGATGGCCACCCT -> AGAGCGGATGGCCACCCTA
TAGAGTAGAGTGTGTGCTA -> AGAGTAGAGTGTGTGCTAC
TAGAGTGTGTGCTACTAAG -> AGAGTGTGTGCTACTAAGA
TAGATCAAAAGGTTAGATC -> AGATCAAAAGGTTAGATCA
TAGATCACGGGAAATGGAT -> AGATCACGGGAAATGGATA
TAGATTCCCAACCCCAGCG -> AGATTCCCAACCCCAGCGC
TAGCACACCCGGCTCTTGC -> AGCACACCCGGCTCTTGCC
TAGCAGGGAACCAAGAATG -> AGCAGGGAACCAAGAATGC
TAGCCGAAACTTTGTACAA -> AGCCGAAACTTTGTACAAG
TAGCGCCATCGTAGCGGTT -> AGCGCCATCGTAGCGGTTA
TAGCGGTTATCCTTATCTG -> AGCGGTTATCCTTATCTGT
TAGCGTGGTGTTTACTCTG -> AGCGTGGTGTTTACTCTGT
TAGCTAATGGCCATCAGAG -> AGCTAATGGCCATCAGAGC
TAGCTAGCGTGGTGTTTAC -> AGCTAGCGTGGTGTTTACT
TAGCTGAGAGAGAGACCCA -> AGCTGAGAGAGAGACCCAC
TAGGAAATCAACGGGGGCG -> AGGAAATCAACGGGGGCGG
TAGGATTTCAGGTTCCAAA -> AGGATTTCAGGTTCCAAAC
TAGGATTTTCGAAATCCGC -> AGGATTTTCGAAATCCGCG
TAGGGAACTAAGTTAGAAC -> AGGGAACTAAGTTAGAACC
TAGGGACGATTTACTAAGC -> AGGGACGATTTACTAAGCT
TAGGGCACTAGCAGGGAAC -> AGGGCACTAGCAGGGAACC
TAGGGGAATTGCTTACAAC -> AGGGGAATTGCTTACAACC
TAGGGGCAAGAGCGACCCG -> AGGGGCAAGAGCGACCCGA
TAGGGGCAATTAGGATTTT -> AGGGGCAATTAGGATTTTC
TAGGGTAAGAGGAGAAACG -> AGGGTAAGAGGAGAAACGA
TAGGGTTGTGCAGCGCAAC -> AGGGTTGTGCAGCGCAACC
TAGGTTGGGTTACAGTGAG -> AGGTTGGGTTACAGTGAGA
TAGGTTTATTACTGCCGCG -> AGGTTTATTACTGCCGCGC
TAGTACCATCTCCTTATTC -> AGTACCATCTCCTTATTCT
TAGTCCCCCAATTTCTAAC -> AGTCCCCCAATTTCTAACT
TAGTCTAGAACTGTTTCTA -> AGTCTAGAACTGTTTCTAT
TAGTGCTGTCACAGAACAG -> AGTGCTGTCACAGAACAGA
TAGTTGTATCCGGCGCACT -> AGTTGTATCCGGCGCACTA
TAGTTTAACTAACGGGTCG -> AGTTTAACTAACGGGTCGA
TAGTTTCTAAGACATAGTA -> AGTTTCTAAGACATAGTAC
TATAACGTTGGCTTGACGA -> ATAACGTTGGCTTGACGAG
TATAACGTTTCGGGGCCCA -> ATAACGTTTCGGGGCCCAT
TATAAGGCGTGAATGAAGT -> ATAAGGCGTGAATGAAGTC
TATACAGCACACACACATA -> ATACAGCACACACACATAG
TATACATTTGTTCCTTCAT -> ATACATTTGTTCCTTCATA
TATACGTTGTAAATAGAGC -> ATACGTTGTAAATAGAGCG
TATAGACGACCAGGAGGTA -> ATAGACGACCAGGAGGTAG
TATAGCTGAGAGAGAGACC -> ATAGCTGAGAGAGAGACCC
TATAGGATTTCAGGTTCCA -> ATAGGATTTCAGGTTCCAA
TATATCAAGGAGCTTTATG -> ATATCAAGGAGCTTTATGA
TATCAAGGAGCTTTATGAA -> ATCAAGGAGCTTTATGAAC
TATCCGAGGCTGCTGCAGA -> ATCCGAGGCTGCTGCAGAA
TATCCGGCGCACTAGACGG -> ATCCGGCGCACTAGACGGT
TATCCGTCTTCCACGCTCT -> ATCCGTCTTCCACGCTCTT
TATCCTGGATGTGTGTACG -> ATCCTGGATGTGTGTACGA
TATCCTTATCTGTATCTGT -> ATCCTTATCTGTATCTGTC
TATCGCTGAGAAACGAGCA -> ATCGCTGAGAAACGAGCAA
TATCGTTTTAATCCCCGCG -> ATCGTTTTAATCCCCGCGT
TATCTAGATCAAAAGGTTA -> ATCTAGATCAAAAGGTTAG
TATCTCTCCGACTGACAGG -> ATCTCTCCGACTGACAGGT
TATCTGTATCTGTCCCAGG -> ATCTGTATCTGTCCCAGGG
TATCTGTCCCAGGGCCAAC -> ATCTGTCCCAGGGCCAACG
TATGAACTCCCTTTCGACC -> ATGAACTCCCTTTCGACCG
TATGCCATACCGGTTCAAG -> ATGCCATACCGGTTCAAGC
TATGCCCGTGATATAGGAT -> ATGCCCGTGATATAGGATT
TATGGGTTCCCCTCAGGAG -> ATGGGTTCCCCTCAGGAGA
TATGTGCAAGGATGCCGGT -> ATGTGCAAGGATGCCGGTA
TATTAAGACGATTTACTAC -> ATTAAGACGATTTACTACG
TATTACACGTTCGATGCCA -> ATTACACGTTCGATGCCAT
TATTACTGCCGCGCTTCCT -> ATTACTGCCGCGCTTCCTA
TATTCAAATATTAAGACGA -> ATTCAAATATTAAGACGAT
TATTCTGTTAGCTAGCGTG -> ATTCTGTTAGCTAGCGTGG
TATTCTTGCACAAAGGAGC -> ATTCTTGCACAAAGGAGCT
TATTTGGCTGGGGGCTCTT -> ATTTGGCTGGGGGCTCTTC
TCAAAAGGTTAGATCACGG -> CAAAAGGTTAGATCACGGG
TCAAACATTCAGCTTTGAC -> CAAACATTCAGCTTTGACC
TCAAATATTAAGACGATTT -> CAAATATTAAGACGATTTA
TCAACAGCTCCATGCTTCG -> CAACAGCTCCATGCTTCGG
TCAACGGGGGCGGAAAATT -> CAACGGGGGCGGAAAATTT
TCAAGCAGTCAGCATTGCA -> CAAGCAGTCAGCATTGCAC
TCAAGGAGCTTTATGAACT -> CAAGGAGCTTTATGAACTC
TCAATGTATACATTTGTTC -> CAATGTATACATTTGTTCC
TCACAAGGCACTCCAAAGT -> CACAAGGCACTCCAAAGTC
TCACAGAACAGACTAAAGG -> CACAGAACAGACTAAAGGC
TCACCGCGCTGGACCTATA -> CACCGCGCTGGACCTATAA
TCACGATTAATGAGTAGAT -> CACGATTAATGAGTAGATT
TCACGGGAAATGGATAATG -> CACGGGAAATGGATAATGA
TCAGAGCGTTTATACAGCA -> CAGAGCGTTTATACAGCAC
TCAGCATTGCACCCTGAAC -> CAGCATTGCACCCTGAACT
TCAGCGAGGAGGGACACCT -> CAGCGAGGAGGGACACCTT
TCAGCTTTGACCAAAACTG -> CAGCTTTGACCAAAACTGA
TCAGGAGAAACTTGCGTGT -> CAGGAGAAACTTGCGTGTA
TCAGGGGACGAAGTTATTC -> CAGGGGACGAAGTTATTCT
TCAGGGTGAAAGAGGCCTT -> CAGGGTGAAAGAGGCCTTC
TCAGGTTCCAAACTATTTG -> CAGGTTCCAAACTATTTGG
TCAGTTATGCCCGTGATAT -> CAGTTATGCCCGTGATATA
TCATAACTGTCTGCGGTAG -> CATAACTGTCTGCGGTAGT
TCATAGCGCCATCGTAGCG -> CATAGCGCCATCGTAGCGG
TCATAGCTAATGGCCATCA -> CATAGCTAATGGCCATCAG
TCATATCTAGATCAAAAGG -> CATATCTAGATCAAAAGGT
TCATCCCACCTTATAAGGC -> CATCCCACCTTATAAGGCG
TCATCTTCTAATTCGTCCA -> CATCTTCTAATTCGTCCAG
TCATGGTCACGATTAATGA -> CATGGTCACGATTAATGAG
TCATGTGTTGTTCCTGTGT -> CATGTGTTGTTCCTGTGTA
TCATTGGTAAAATGTTTTT -> CATTGGTAAAATGTTTTTC
TCCAAACTATTTGGCTGGG -> CCAAACTATTTGGCTGGGG
TCCAAAGTCCGGCGCAATT -> CCAAAGTCCGGCGCAATTA
TCCAACCCCCCCATATTCA -> CCAACCCCCCCATATTCAA
TCCACGCTCTTCGGTTAGA -> CCACGCTCTTCGGTTAGAC
TCCACTTTGCGTTTGTAGG -> CCACTTTGCGTTTGTAGGT
TCCAGCGTACAGCATCTCA -> CCAGCGTACAGCATCTCAA
TCCAGGCTATAGACGACCA -> CCAGGCTATAGACGACCAG
TCCAGTCCAACCCCCCCAT -> CCAGTCCAACCCCCCCATA
TCCATGCTTCGGGTCCCGC -> CCATGCTTCGGGTCCCGCA
TCCCAACCCCAGCGCCCGA -> CCCAACCCCAGCGCCCGAG
TCCCAAGAACTGTGCGAAC -> CCCAAGAACTGTGCGAACA
TCCCACCTTATAAGGCGTG -> CCCACCTTATAAGGCGTGA
TCCCAGGGCCAACGGAAAT -> CCCAGGGCCAACGGAAATC
TCCCCATCCGCCTACTTGT -> CCCCATCCGCCTACTTGTC
TCCCCCAATTTCTAACTAG -> CCCCCAATTTCTAACTAGA
TCCCCGCGTCCAGGCTATA -> CCCCGCGTCCAGGCTATAG
TCCCCTCAGGAGAAACTTG -> CCCCTCAGGAGAAACTTGC
TCCCGCAAAGGCTAACGAG -> CCCGCAAAGGCTAACGAGT
TCCCTCATGTGTTGTTCCT -> CCCTCATGTGTTGTTCCTG
TCCCTTTCGACCGTTTTGG -> CCCTTTCGACCGTTTTGGG
TCCGACTGACAGGTACCAC -> CCGACTGACAGGTACCACC
TCCGAGGCTGCTGCAGAAC -> CCGAGGCTGCTGCAGAACA
TCCGCACTGTTATGTGCAA -> CCGCACTGTTATGTGCAAG
TCCGCCTACTTGTCATATC -> CCGCCTACTTGTCATATCT
TCCGCGGCTAACGCTCTTA -> CCGCGGCTAACGCTCTTAG
TCCGCGTGTTATCGTTTTA -> CCGCGTGTTATCGTTTTAA
TCCGGCGCAATTACGTCCT -> CCGGCGCAATTACGTCCTA
TCCGGCGCACTAGACGGTC -> CCGGCGCACTAGACGGTCT
TCCGTCTTCCACGCTCTTC -> CCGTCTTCCACGCTCTTCG
TCCTAGGGGCAAGAGCGAC -> CCTAGGGGCAAGAGCGACC
TCCTAGTTTAACTAACGGG -> CCTAGTTTAACTAACGGGT
TCCTGGATGTGTGTACGAG -> CCTGGATGTGTGTACGAGA
TCCTGTGTATCCTGGATGT -> CCTGTGTATCCTGGATGTG
TCCTTATCTGTATCTGTCC -> CCTTATCTGTATCTGTCCC
TCCTTATTCTGTTAGCTAG -> CCTTATTCTGTTAGCTAGC
TCCTTCATAGCTAATGGCC -> CCTTCATAGCTAATGGCCA
TCGAAATCCGCGGCTAACG -> CGAAATCCGCGGCTAACGC
TCGAACGCAACGGATAATC -> CGAACGCAACGGATAATCC
TCGACCGTTTTGGGAAGGT -> CGACCGTTTTGGGAAGGTA
TCGAGACCTCCCAAGAACT -> CGAGACCTCCCAAGAACTG
TCGATGCCATAGAACAACT -> CGATGCCATAGAACAACTG
TCGCACAAGGTAGTTGTAT -> CGCACAAGGTAGTTGTATC
TCGCAGGAAGGGTTATAAC -> CGCAGGAAGGGTTATAACG
TCGCGCAAAGTAGGAAATC -> CGCGCAAAGTAGGAAATCA
TCGCTACACAGCAAAGGAA -> CGCTACACAGCAAAGGAAG
TCGCTGAGAAACGAGCAAT -> CGCTGAGAAACGAGCAATA
TCGGAAGAATACGGCTGAT -> CGGAAGAATACGGCTGATC
TCGGCGGAGGTAGGGGCAA -> CGGCGGAGGTAGGGGCAAT
TCGGGGCCCATGAGTAGCA -> CGGGGCCCATGAGTAGCAC
TCGGGTCCCGCAAAGGCTA -> CGGGTCCCGCAAAGGCTAA
TCGGTCTTCGGAAGAATAC -> CGGTCTTCGGAAGAATACG
TCGGTTAGACCGTCAGCGA -> CGGTTAGACCGTCAGCGAG
TCGTAAGCAGCAGAAGCTT -> CGTAAGCAGCAGAAGCTTT
TCGTAGCGGTTATCCTTAT -> CGTAGCGGTTATCCTTATC
TCGTCATCCCACCTTATAA -> CGTCATCCCACCTTATAAG
TCGTCCAGCGTACAGCATC -> CGTCCAGCGTACAGCATCT
TCGTTGGTAGTGCTGTCAC -> CGTTGGTAGTGCTGTCACA
TCGTTTTAATCCCCGCGTC -> CGTTTTAATCCCCGCGTCC
TCTAACGCAGCTCTTACCA -> CTAACGCAGCTCTTACCAA
TCTAACTAACTTCTATTAC -> CTAACTAACTTCTATTACA
TCTAACTAGACGGTTATAT -> CTAACTAGACGGTTATATC
TCTAAGACATAGTACCATC -> CTAAGACATAGTACCATCT
TCTAATTCGTCCAGCGTAC -> CTAATTCGTCCAGCGTACA
TCTAATTTAGACGAGAAAC -> CTAATTTAGACGAGAAACG
TCTACGCATAGGGACGATT -> CTACGCATAGGGACGATTT
TCTAGAACTGTTTCTATGG -> CTAGAACTGTTTCTATGGG
TCTAGATCAAAAGGTTAGA -> CTAGATCAAAAGGTTAGAT
TCTATGGGTTCCCCTCAGG -> CTATGGGTTCCCCTCAGGA
TCTATTACACGTTCGATGC -> CTATTACACGTTCGATGCC
TCTCAACAGCTCCATGCTT -> CTCAACAGCTCCATGCTTC
TCTCCGACTGACAGGTACC -> CTCCGACTGACAGGTACCA
TCTCCTTATTCTGTTAGCT -> CTCCTTATTCTGTTAGCTA
TCTCTCCGACTGACAGGTA -> CTCTCCGACTGACAGGTAC
TCTCTTTGGCCTTTACCGT -> CTCTTTGGCCTTTACCGTA
TCTGCGGTAGTTTCTAAGA -> CTGCGGTAGTTTCTAAGAC
TCTGTAGAGTAGAGTGTGT -> CTGTAGAGTAGAGTGTGTG
TCTGTATCTGTCCCAGGGC -> CTGTATCTGTCCCAGGGCC
TCTGTCCCAGGGCCAACGG -> CTGTCCCAGGGCCAACGGA
TCTGTTAGCTAGCGTGGTG -> CTGTTAGCTAGCGTGGTGT
TCTGTTCTAATTTAGACGA -> CTGTTCTAATTTAGACGAG
TCTTAAGTGTCATAGCGCC -> CTTAAGTGTCATAGCGCCA
TCTTACCAAAGTGCTCTCT -> CTTACCAAAGTGCTCTCTT
TCTTAGGGTAAGAGGAGAA -> CTTAGGGTAAGAGGAGAAA
TCTTCACAAGGCACTCCAA -> CTTCACAAGGCACTCCAAA
TCTTCCACGCTCTTCGGTT -> CTTCCACGCTCTTCGGTTA
TCTTCGGAAGAATACGGCT -> CTTCGGAAGAATACGGCTG
TCTTCGGTTAGACCGTCAG -> CTTCGGTTAGACCGTCAGC
TCTTCTAATTCGTCCAGCG -> CTTCTAATTCGTCCAGCGT
TCTTGCACAAAGGAGCTGG -> CTTGCACAAAGGAGCTGGT
TCTTGCCATTTTGTATCCG -> CTTGCCATTTTGTATCCGT
TCTTGCCGCGATATGCCAT -> CTTGCCGCGATATGCCATA
TCTTTGGCCTTTACCGTAT -> CTTTGGCCTTTACCGTATC
TGAAAGAGGCCTTCGAGAC -> GAAAGAGGCCTTCGAGACC
TGAACTCCCTTTCGACCGT -> GAACTCCCTTTCGACCGTT
TGAACTCGCAGGAAGGGTT -> GAACTCGCAGGAAGGGTTA
TGAAGGTAACAGGAGTCAT -> GAAGGTAACAGGAGTCATT
TGAAGTCAGGGGACGAAGT -> GAAGTCAGGGGACGAAGTT
TGAAGTTTCTTAAGTGTCA -> GAAGTTTCTTAAGTGTCAT
TGAATGAAGTCAGGGGACG -> GAATGAAGTCAGGGGACGA
TGACAGGTACCACCGACTG -> GACAGGTACCACCGACTGT
TGACCAAAACTGATGCACA -> GACCAAAACTGATGCACAT
TGACGAGTGTTAAAAAAAT -> GACGAGTGTTAAAAAAATG
TGACGTTCCGCACTGTTAT -> GACGTTCCGCACTGTTATG
TGAGAAACGAGCAATAGGG -> GAGAAACGAGCAATAGGGT
TGAGAGAGAGACCCACTCA -> GAGAGAGAGACCCACTCAC
TGAGAGTCAATGTATACAT -> GAGAGTCAATGTATACATT
TGAGCTACCGGACCAGATC -> GAGCTACCGGACCAGATCA
TGAGGAACTCCCTCATGTG -> GAGGAACTCCCTCATGTGT
TGAGTAGATTCCCAACCCC -> GAGTAGATTCCCAACCCCA
TGAGTAGCACACCCGGCTC -> GAGTAGCACACCCGGCTCT
TGAGTATACGTTGTAAATA -> GAGTATACGTTGTAAATAG
TGATACTTCGTTGGTAGTG -> GATACTTCGTTGGTAGTGC
TGATATAGGATTTCAGGTT -> GATATAGGATTTCAGGTTC
TGATCAGTTATGCCCGTGA -> GATCAGTTATGCCCGTGAT
TGATGCACATCGCTACACA -> GATGCACATCGCTACACAG
TGATTTTCGCGCAAAGTAG -> GATTTTCGCGCAAAGTAGG
TGCAAGGATGCCGGTAACC -> GCAAGGATGCCGGTAACCT
TGCACAAAGGAGCTGGTAA -> GCACAAAGGAGCTGGTAAG
TGCACATCGCTACACAGCA -> GCACATCGCTACACAGCAA
TGCACCCTGAACTCGCAGG -> GCACCCTGAACTCGCAGGA
TGCAGAACAGAGCTTGAGT -> GCAGAACAGAGCTTGAGTA
TGCAGCGCAACCAAGAATG -> GCAGCGCAACCAAGAATGC
TGCCATACCGGTTCAAGCA -> GCCATACCGGTTCAAGCAG
TGCCATAGAACAACTGCGC -> GCCATAGAACAACTGCGCA
TGCCATTTTGTATCCGTCT -> GCCATTTTGTATCCGTCTT
TGCCCGTGATATAGGATTT -> GCCCGTGATATAGGATTTC
TGCCGCGATATGCCATACC -> GCCGCGATATGCCATACCG
TGCCGCGCTTCCTAGGGGC -> GCCGCGCTTCCTAGGGGCA
TGCCGGTAACCTGTTTTCA -> GCCGGTAACCTGTTTTCAT
TGCGAACACCTGGTGGAAC -> GCGAACACCTGGTGGAACC
TGCGACCGCATGTCCGCGT -> GCGACCGCATGTCCGCGTG
TGCGACCGGAATTTGAAGG -> GCGACCGGAATTTGAAGGT
TGCGACGTTGATACTTCGT -> GCGACGTTGATACTTCGTT
TGCGACTAGCCGAAACTTT -> GCGACTAGCCGAAACTTTG
TGCGCACTCTGTTCTAATT -> GCGCACTCTGTTCTAATTT
TGCGGTAGTTTCTAAGACA -> GCGGTAGTTTCTAAGACAT
TGCGTAGAGAAGCACCATC -> GCGTAGAGAAGCACCATCA
TGCGTGCGACCGCATGTCC -> GCGTGCGACCGCATGTCCG
TGCGTGCGACCGGAATTTG -> GCGTGCGACCGGAATTTGA
TGCGTGCGACGTTGATACT -> GCGTGCGACGTTGATACTT
TGCGTGCGACTAGCCGAAA -> GCGTGCGACTAGCCGAAAC
TGCGTGTAATGATTTTCGC -> GCGTGTAATGATTTTCGCG
TGCGTTTGTAGGTTGGGTT -> GCGTTTGTAGGTTGGGTTA
TGCTACACGAGAACGGATC -> GCTACACGAGAACGGATCG
TGCTACTAAGAACTTGCTA -> GCTACTAAGAACTTGCTAC
TGCTCTCTTTGGCCTTTAC -> GCTCTCTTTGGCCTTTACC
TGCTGCAGAACAGAGCTTG -> GCTGCAGAACAGAGCTTGA
TGCTGTCACAGAACAGACT -> GCTGTCACAGAACAGACTA
TGCTTACAACCAAGAATGC -> GCTTACAACCAAGAATGCG
TGCTTCGGGTCCCGCAAAG -> GCTTCGGGTCCCGCAAAGG
TGGAACCACGAGGTGCGTA -> GGAACCACGAGGTGCGTAG
TGGACCTATAACGTTTCGG -> GGACCTATAACGTTTCGGG
TGGAGTATCGCTGAGAAAC -> GGAGTATCGCTGAGAAACG
TGGATAATGAGCTACCGGA -> GGATAATGAGCTACCGGAC
TGGATGTGTGTACGAGAGA -> GGATGTGTGTACGAGAGAA
TGGCCACCCTAGGTTTATT -> GGCCACCCTAGGTTTATTA
TGGCCATCAGAGCGTTTAT -> GGCCATCAGAGCGTTTATA
TGGCCTTTACCGTATCCGA -> GGCCTTTACCGTATCCGAG
TGGCTGGGGGCTCTTCACA -> GGCTGGGGGCTCTTCACAA
TGGCTTGACGAGTGTTAAA -> GGCTTGACGAGTGTTAAAA
TGGGGGCTCTTCACAAGGC -> GGGGGCTCTTCACAAGGCA
TGGGTTACAGTGAGAGTCA -> GGGTTACAGTGAGAGTCAA
TGGGTTCCCCTCAGGAGAA -> GGGTTCCCCTCAGGAGAAA
TGGTAAAATGTTTTTCATC -> GGTAAAATGTTTTTCATCT
TGGTAAGACGGTGGAGTAT -> GGTAAGACGGTGGAGTATC
TGGTAGTGCTGTCACAGAA -> GGTAGTGCTGTCACAGAAC
TGGTCACGATTAATGAGTA -> GGTCACGATTAATGAGTAG
TGGTGGAACCACGAGGTGC -> GGTGGAACCACGAGGTGCG
TGGTGTTTACTCTGTAGAG -> GGTGTTTACTCTGTAGAGT
TGTAAATAGAGCGGATGGC -> GTAAATAGAGCGGATGGCC
TGTAATGATTTTCGCGCAA -> GTAATGATTTTCGCGCAAA
TGTACAAGAAAGGCCGCGT -> GTACAAGAAAGGCCGCGTT
TGTACGAGAGAAACGAGCA -> GTACGAGAGAAACGAGCAA
TGTAGAGTAGAGTGTGTGC -> GTAGAGTAGAGTGTGTGCT
TGTAGGTTGGGTTACAGTG -> GTAGGTTGGGTTACAGTGA
TGTATACATTTGTTCCTTC -> GTATACATTTGTTCCTTCA
TGTATCCGGCGCACTAGAC -> GTATCCGGCGCACTAGACG
TGTATCCGTCTTCCACGCT -> GTATCCGTCTTCCACGCTC
TGTATCCTGGATGTGTGTA -> GTATCCTGGATGTGTGTAC
TGTATCTGTCCCAGGGCCA -> GTATCTGTCCCAGGGCCAA
TGTCACAGAACAGACTAAA -> GTCACAGAACAGACTAAAG
TGTCAGGGTGAAAGAGGCC -> GTCAGGGTGAAAGAGGCCT
TGTCATAGCGCCATCGTAG -> GTCATAGCGCCATCGTAGC
TGTCATATCTAGATCAAAA -> GTCATATCTAGATCAAAAG
TGTCCCAGGGCCAACGGAA -> GTCCCAGGGCCAACGGAAA
TGTCCGCGTGTTATCGTTT -> GTCCGCGTGTTATCGTTTT
TGTCTGCGGTAGTTTCTAA -> GTCTGCGGTAGTTTCTAAG
TGTGCAAGGATGCCGGTAA -> GTGCAAGGATGCCGGTAAC
TGTGCAGCGCAACCAAGAA -> GTGCAGCGCAACCAAGAAT
TGTGCGAACACCTGGTGGA -> GTGCGAACACCTGGTGGAA
TGTGCTACTAAGAACTTGC -> GTGCTACTAAGAACTTGCT
TGTGTACGAGAGAAACGAG -> GTGTACGAGAGAAACGAGC
TGTGTATCCTGGATGTGTG -> GTGTATCCTGGATGTGTGT
TGTGTGCTACTAAGAACTT -> GTGTGCTACTAAGAACTTG
TGTGTGTACGAGAGAAACG -> GTGTGTACGAGAGAAACGA
TGTGTTGTTCCTGTGTATC -> GTGTTGTTCCTGTGTATCC
TGTTAAAAAAATGACGTTC -> GTTAAAAAAATGACGTTCC
TGTTAGCTAGCGTGGTGTT -> GTTAGCTAGCGTGGTGTTT
TGTTATCGTTTTAATCCCC -> GTTATCGTTTTAATCCCCG
TGTTATGTGCAAGGATGCC -> GTTATGTGCAAGGATGCCG
TGTTCCTGTGTATCCTGGA -> GTTCCTGTGTATCCTGGAT
TGTTCCTTCATAGCTAATG -> GTTCCTTCATAGCTAATGG
TGTTCTAATTTAGACGAGA -> GTTCTAATTTAGACGAGAA
TGTTCTACGCATAGGGACG -> GTTCTACGCATAGGGACGA
TGTTGTTCCTGTGTATCCT -> GTTGTTCCTGTGTATCCTG
TGTTTACTCTGTAGAGTAG -> GTTTACTCTGTAGAGTAGA
TGTTTCTATGGGTTCCCCT -> GTTTCTATGGGTTCCCCTC
TGTTTTCATGGTCACGATT -> GTTTTCATGGTCACGATTA
TGTTTTTCATCTTCTAATT -> GTTTTTCATCTTCTAATTC
TTAAAAAAATGACGTTCCG -> TAAAAAAATGACGTTCCGC
TTAACTAACGGGTCGAACG -> TAACTAACGGGTCGAACGC
TTAAGACGATTTACTACGA -> TAAGACGATTTACTACGAC
TTAAGTGTCATAGCGCCAT -> TAAGTGTCATAGCGCCATC
TTAATCCCCGCGTCCAGGC -> TAATCCCCGCGTCCAGGCT
TTAATGAGTAGATTCCCAA -> TAATGAGTAGATTCCCAAC
TTACAACCAAGAATGCGTG -> TACAACCAAGAATGCGTGC
TTACACGTTCGATGCCATA -> TACACGTTCGATGCCATAG
TTACAGGGTATAGCTGAGA -> TACAGGGTATAGCTGAGAG
TTACAGTGAGAGTCAATGT -> TACAGTGAGAGTCAATGTA
TTACCAAAGTGCTCTCTTT -> TACCAAAGTGCTCTCTTTG
TTACCGTATCCGAGGCTGC -> TACCGTATCCGAGGCTGCT
TTACGTCCTAGTTTAACTA -> TACGTCCTAGTTTAACTAA
TTACTAAGCTCGGCGGAGG -> TACTAAGCTCGGCGGAGGT
TTACTACGACTATCTCTCC -> TACTACGACTATCTCTCCG
TTACTCTGTAGAGTAGAGT -> TACTCTGTAGAGTAGAGTG
TTACTGCCGCGCTTCCTAG -> TACTGCCGCGCTTCCTAGG
TTAGAACCAAGAATGCGTG -> TAGAACCAAGAATGCGTGC
TTAGACCGTCAGCGAGGAG -> TAGACCGTCAGCGAGGAGG
TTAGACGAGAAACGAGCAA -> TAGACGAGAAACGAGCAAT
TTAGATCACGGGAAATGGA -> TAGATCACGGGAAATGGAT
TTAGCTAGCGTGGTGTTTA -> TAGCTAGCGTGGTGTTTAC
TTAGGATTTTCGAAATCCG -> TAGGATTTTCGAAATCCGC
TTAGGGTAAGAGGAGAAAC -> TAGGGTAAGAGGAGAAACG
TTATAACGTTGGCTTGACG -> TATAACGTTGGCTTGACGA
TTATAAGGCGTGAATGAAG -> TATAAGGCGTGAATGAAGT
TTATACAGCACACACACAT -> TATACAGCACACACACATA
TTATATCAAGGAGCTTTAT -> TATATCAAGGAGCTTTATG
TTATCCTTATCTGTATCTG -> TATCCTTATCTGTATCTGT
TTATCGTTTTAATCCCCGC -> TATCGTTTTAATCCCCGCG
TTATCTGTATCTGTCCCAG -> TATCTGTATCTGTCCCAGG
TTATGAACTCCCTTTCGAC -> TATGAACTCCCTTTCGACC
TTATGCCCGTGATATAGGA -> TATGCCCGTGATATAGGAT
TTATGTGCAAGGATGCCGG -> TATGTGCAAGGATGCCGGT
TTATTACTGCCGCGCTTCC -> TATTACTGCCGCGCTTCCT
TTATTCTGTTAGCTAGCGT -> TATTCTGTTAGCTAGCGTG
TTATTCTTGCACAAAGGAG -> TATTCTTGCACAAAGGAGC
TTCAAATATTAAGACGATT -> TCAAATATTAAGACGATTT
TTCAAGCAGTCAGCATTGC -> TCAAGCAGTCAGCATTGCA
TTCACAAGGCACTCCAAAG -> TCACAAGGCACTCCAAAGT
TTCAGCTTTGACCAAAACT -> TCAGCTTTGACCAAAACTG
TTCAGGTTCCAAACTATTT -> TCAGGTTCCAAACTATTTG
TTCATAGCTAATGGCCATC -> TCATAGCTAATGGCCATCA
TTCATCTTCTAATTCGTCC -> TCATCTTCTAATTCGTCCA
TTCATGGTCACGATTAATG -> TCATGGTCACGATTAATGA
TTCCAAACTATTTGGCTGG -> TCCAAACTATTTGGCTGGG
TTCCACGCTCTTCGGTTAG -> TCCACGCTCTTCGGTTAGA
TTCCCAACCCCAGCGCCCG -> TCCCAACCCCAGCGCCCGA
TTCCCCATCCGCCTACTTG -> TCCCCATCCGCCTACTTGT
TTCCCCTCAGGAGAAACTT -> TCCCCTCAGGAGAAACTTG
TTCCGCACTGTTATGTGCA -> TCCGCACTGTTATGTGCAA
TTCCTAGGGGCAAGAGCGA -> TCCTAGGGGCAAGAGCGAC
TTCCTGTGTATCCTGGATG -> TCCTGTGTATCCTGGATGT
TTCCTTCATAGCTAATGGC -> TCCTTCATAGCTAATGGCC
TTCGAAATCCGCGGCTAAC -> TCGAAATCCGCGGCTAACG
TTCGACCGTTTTGGGAAGG -> TCGACCGTTTTGGGAAGGT
TTCGAGACCTCCCAAGAAC -> TCGAGACCTCCCAAGAACT
TTCGATGCCATAGAACAAC -> TCGATGCCATAGAACAACT
TTCGCGCAAAGTAGGAAAT -> TCGCGCAAAGTAGGAAATC
TTCGGAAGAATACGGCTGA -> TCGGAAGAATACGGCTGAT
TTCGGGGCCCATGAGTAGC -> TCGGGGCCCATGAGTAGCA
TTCGGGTCCCGCAAAGGCT -> TCGGGTCCCGCAAAGGCTA
TTCGGTTAGACCGTCAGCG -> TCGGTTAGACCGTCAGCGA
TTCGTCCAGCGTACAGCAT -> TCGTCCAGCGTACAGCATC
TTCGTTGGTAGTGCTGTCA -> TCGTTGGTAGTGCTGTCAC
TTCTAACGCAGCTCTTACC -> TCTAACGCAGCTCTTACCA
TTCTAACTAGACGGTTATA -> TCTAACTAGACGGTTATAT
TTCTAAGACATAGTACCAT -> TCTAAGACATAGTACCATC
TTCTAATTCGTCCAGCGTA -> TCTAATTCGTCCAGCGTAC
TTCTAATTTAGACGAGAAA -> TCTAATTTAGACGAGAAAC
TTCTACGCATAGGGACGAT -> TCTACGCATAGGGACGATT
TTCTATGGGTTCCCCTCAG -> TCTATGGGTTCCCCTCAGG
TTCTATTACACGTTCGATG -> TCTATTACACGTTCGATGC
TTCTGTTAGCTAGCGTGGT -> TCTGTTAGCTAGCGTGGTG
TTCTTAAGTGTCATAGCGC -> TCTTAAGTGTCATAGCGCC
TTCTTGCACAAAGGAGCTG -> TCTTGCACAAAGGAGCTGG
TTGAAGGTAACAGGAGTCA -> TGAAGGTAACAGGAGTCAT
TTGAAGTTTCTTAAGTGTC -> TGAAGTTTCTTAAGTGTCA
TTGACCAAAACTGATGCAC -> TGACCAAAACTGATGCACA
TTGACGAGTGTTAAAAAAA -> TGACGAGTGTTAAAAAAAT
TTGAGGAACTCCCTCATGT -> TGAGGAACTCCCTCATGTG
TTGAGTATACGTTGTAAAT -> TGAGTATACGTTGTAAATA
TTGATACTTCGTTGGTAGT -> TGATACTTCGTTGGTAGTG
TTGCACAAAGGAGCTGGTA -> TGCACAAAGGAGCTGGTAA
TTGCACCCTGAACTCGCAG -> TGCACCCTGAACTCGCAGG
TTGCCATTTTGTATCCGTC -> TGCCATTTTGTATCCGTCT
TTGCCGCGATATGCCATAC -> TGCCGCGATATGCCATACC
TTGCGTGTAATGATTTTCG -> TGCGTGTAATGATTTTCGC
TTGCGTTTGTAGGTTGGGT -> TGCGTTTGTAGGTTGGGTT
TTGCTACACGAGAACGGAT -> TGCTACACGAGAACGGATC
TTGCTTACAACCAAGAATG -> TGCTTACAACCAAGAATGC
TTGGCCTTTACCGTATCCG -> TGGCCTTTACCGTATCCGA
TTGGCTGGGGGCTCTTCAC -> TGGCTGGGGGCTCTTCACA
TTGGCTTGACGAGTGTTAA -> TGGCTTGACGAGTGTTAAA
TTGGGTTACAGTGAGAGTC -> TGGGTTACAGTGAGAGTCA
TTGGTAAAATGTTTTTCAT -> TGGTAAAATGTTTTTCATC
TTGGTAGTGCTGTCACAGA -> TGGTAGTGCTGTCACAGAA
TTGTAAATAGAGCGGATGG -> TGTAAATAGAGCGGATGGC
TTGTACAAGAAAGGCCGCG -> TGTACAAGAAAGGCCGCGT
TTGTAGGTTGGGTTACAGT -> TGTAGGTTGGGTTACAGTG
TTGTATCCGGCGCACTAGA -> TGTATCCGGCGCACTAGAC
TTGTATCCGTCTTCCACGC -> TGTATCCGTCTTCCACGCT
TTGTCATATCTAGATCAAA -> TGTCATATCTAGATCAAAA
TTGTGCAGCGCAACCAAGA -> TGTGCAGCGCAACCAAGAA
TTGTTCCTGTGTATCCTGG -> TGTTCCTGTGTATCCTGGA
TTGTTCCTTCATAGCTAAT -> TGTTCCTTCATAGCTAATG
TTGTTCTACGCATAGGGAC -> TGTTCTACGCATAGGGACG
TTTAACTAACGGGTCGAAC -> TTAACTAACGGGTCGAACG
TTTAATCCCCGCGTCCAGG -> TTAATCCCCGCGTCCAGGC
TTTACAGGGTATAGCTGAG -> TTACAGGGTATAGCTGAGA
TTTACCGTATCCGAGGCTG -> TTACCGTATCCGAGGCTGC
TTTACTAAGCTCGGCGGAG -> TTACTAAGCTCGGCGGAGG
TTTACTACGACTATCTCTC -> TTACTACGACTATCTCTCC
TTTACTCTGTAGAGTAGAG -> TTACTCTGTAGAGTAGAGT
TTTAGACGAGAAACGAGCA -> TTAGACGAGAAACGAGCAA
TTTATACAGCACACACACA -> TTATACAGCACACACACAT
TTTATGAACTCCCTTTCGA -> TTATGAACTCCCTTTCGAC
TTTATTACTGCCGCGCTTC -> TTATTACTGCCGCGCTTCC
TTTCAGGTTCCAAACTATT -> TTCAGGTTCCAAACTATTT
TTTCATCTTCTAATTCGTC -> TTCATCTTCTAATTCGTCC
TTTCATGGTCACGATTAAT -> TTCATGGTCACGATTAATG
TTTCCCCATCCGCCTACTT -> TTCCCCATCCGCCTACTTG
TTTCGAAATCCGCGGCTAA -> TTCGAAATCCGCGGCTAAC
TTTCGACCGTTTTGGGAAG -> TTCGACCGTTTTGGGAAGG
TTTCGCGCAAAGTAGGAAA -> TTCGCGCAAAGTAGGAAAT
TTTCGGGGCCCATGAGTAG -> TTCGGGGCCCATGAGTAGC
TTTCTAACTAGACGGTTAT -> TTCTAACTAGACGGTTATA
TTTCTAAGACATAGTACCA -> TTCTAAGACATAGTACCAT
TTTCTATGGGTTCCCCTCA -> TTCTATGGGTTCCCCTCAG
TTTCTTAAGTGTCATAGCG -> TTCTTAAGTGTCATAGCGC
TTTGAAGGTAACAGGAGTC -> TTGAAGGTAACAGGAGTCA
TTTGACCAAAACTGATGCA -> TTGACCAAAACTGATGCAC
TTTGCGTTTGTAGGTTGGG -> TTGCGTTTGTAGGTTGGGT
TTTGGCCTTTACCGTATCC -> TTGGCCTTTACCGTATCCG
TTTGGCTGGGGGCTCTTCA -> TTGGCTGGGGGCTCTTCAC
TTTGTACAAGAAAGGCCGC -> TTGTACAAGAAAGGCCGCG
TTTGTAGGTTGGGTTACAG -> TTGTAGGTTGGGTTACAGT
TTTGTATCCGTCTTCCACG -> TTGTATCCGTCTTCCACGC
TTTGTTCCTTCATAGCTAA -> TTGTTCCTTCATAGCTAAT
TTTTAATCCCCGCGTCCAG -> TTTAATCCCCGCGTCCAGG
TTTTCATCTTCTAATTCGT -> TTTCATCTTCTAATTCGTC
TTTTCATGGTCACGATTAA -> TTTCATGGTCACGATTAAT
TTTTCGAAATCCGCGGCTA -> TTTCGAAATCCGCGGCTAA
TTTTCGCGCAAAGTAGGAA -> TTTCGCGCAAAGTAGGAAA
TTTTGTATCCGTCTTCCAC -> TTTGTATCCGTCTTCCACG
TTTTTCATCTTCTAATTCG -> TTTTCATCTTCTAATTCGT
