CCCGGCCGTGGGGAAAACCG -> CCGGCCGTGGGGAAAACCGA
ACACGAACGGATACCAGACC -> CACGAACGGATACCAGACCC
AGCGTTCCGTACCAGTAGAT -> GCGTTCCGTACCAGTAGATG
GTAACCACTGACACCCAATC -> TAACCACTGACACCCAATCC
GCGGATTGCACTCCAATTAA -> CGGATTGCACTCCAATTAAT
TGCCCCGGCCGTGGGGAAAA -> GCCCCGGCCGTGGGGAAAAC
CATGCTTGTTGCCCCGGCCG -> ATGCTTGTTGCCCCGGCCGT
CCGTCGTGCATTTTAGTCCG -> CGTCGTGCATTTTAGTCCGG
GAATGAATGTTTTGCCAATA -> AATGAATGTTTTGCCAATAA
CGCAATCGTGGATTCCTAAG -> GCAATCGTGGATTCCTAAGC
CTAGGCGCAATCGTGGATTC -> TAGGCGCAATCGTGGATTCC
CTGCCTGCACCCGTGTCAGT -> TGCCTGCACCCGTGTCAGTA
CCCCCAGATAATAGTCAGCC -> CCCCAGATAATAGTCAGCCA
GGATACCAGACCCCCAGATA -> GATACCAGACCCCCAGATAA
ATGGATAGGTGTTCACGGTA -> TGGATAGGTGTTCACGGTAG
GTGGACGATAGGGCGGATTG -> TGGACGATAGGGCGGATTGC
TAGGTGTTCACGGTAGGCAC -> AGGTGTTCACGGTAGGCACC
ATTTGGAACGATTAATACCA -> TTTGGAACGATTAATACCAG
TCACGGAACTCCTTTCCGGG -> CACGGAACTCCTTTCCGGGA
TCCGTACCAGTAGATGGATG -> CCGTACCAGTAGATGGATGA
GATCGGAACAGTCCGACTAT -> ATCGGAACAGTCCGACTATC
ACGGTAAGAGAAAGATCGGA -> CGGTAAGAGAAAGATCGGAA
GGAACTCCTTTCCGGGAAGA -> GAACTCCTTTCCGGGAAGAA
CGGCTTCACCATCGCACTCA -> GGCTTCACCATCGCACTCAG
AATGAATGTTTTGCCAATAA -> ATGAATGTTTTGCCAATAAA
CGGCTAGGGGGCGTTGCACT -> GGCTAGGGGGCGTTGCACTG
CCACTGACACCCAATCCAAA -> CACTGACACCCAATCCAAAC
GGGAAAACCGAGGCGTATAA -> GGAAAACCGAGGCGTATAAA
TATTGTGGACGATAGGGCGG -> ATTGTGGACGATAGGGCGGA
CACCCAGTAACCACTGACAC -> ACCCAGTAACCACTGACACC
TGGACTCGTACGGCCATTAG -> GGACTCGTACGGCCATTAGA
TAAAGGTGCGTCTCGCTTAT -> AAAGGTGCGTCTCGCTTATG
GGCGGTAGACCTGGACCCGC -> GCGGTAGACCTGGACCCGCA
CGCAGAGCGCCCAGGAACCC -> GCAGAGCGCCCAGGAACCCT
CCATTAGAATGAATGTTTTG -> CATTAGAATGAATGTTTTGC
TCACCATCGCACTCAGGACG -> CACCATCGCACTCAGGACGG
CAGTAACCACTGACACCCAA -> AGTAACCACTGACACCCAAT
AAATCCTAGGCGCAATCGTG -> AATCCTAGGCGCAATCGTGG
GCGAAGGTCCGAAACCCTAA -> CGAAGGTCCGAAACCCTAAA
GTCCGGACCGGAGTCAACCA -> TCCGGACCGGAGTCAACCAG
ACACCACCCAGTAACCACTG -> CACCACCCAGTAACCACTGA
TCGCCCCTCTCCGAGAGCGA -> CGCCCCTCTCCGAGAGCGAC
AATAAAGGTGCGTCTCGCTT -> ATAAAGGTGCGTCTCGCTTA
TAACCACTGACACCCAATCC -> AACCACTGACACCCAATCCA
TCCTAAGCCAGAACAGGTAG -> CCTAAGCCAGAACAGGTAGC
GGACCCGCAGAGCGCCCAGG -> GACCCGCAGAGCGCCCAGGA
TCCCGTCTTATGCACACCAC -> CCCGTCTTATGCACACCACC
TGGCTCGCCCCTCTCCGAGA -> GGCTCGCCCCTCTCCGAGAG
CGTAAATCATATAAGACCTC -> GTAAATCATATAAGACCTCT
ACTCGTACGGCCATTAGAAT -> CTCGTACGGCCATTAGAATG
TGATGTGAAATTGGCTCGCC -> GATGTGAAATTGGCTCGCCC
TTTCAAAACTCTTTCGGCTG -> TTCAAAACTCTTTCGGCTGA
GAACGATTAATACCAGTTGA -> AACGATTAATACCAGTTGAA
CACTCTCTTAGCACGAGCGT -> ACTCTCTTAGCACGAGCGTT
TCGCAATGTGAGAGCGAACA -> CGCAATGTGAGAGCGAACAA
GTCGACACGAACGGATACCA -> TCGACACGAACGGATACCAG
CCGGAGTCAACCAGTGGGAC -> CGGAGTCAACCAGTGGGACA
CATTAGAATGAATGTTTTGC -> ATTAGAATGAATGTTTTGCC
GACCCTCGCTAGATCGCAAT -> ACCCTCGCTAGATCGCAATG
GGAGTCAACCAGTGGGACAA -> GAGTCAACCAGTGGGACAAC
GTTTTGCCAATAAAATACCA -> TTTTGCCAATAAAATACCAC
AAAGGTGCGTCTCGCTTATG -> AAGGTGCGTCTCGCTTATGC
CGGATACCAGACCCCCAGAT -> GGATACCAGACCCCCAGATA
GTGATGGATAGGTGTTCACG -> TGATGGATAGGTGTTCACGG
ATTAATACCAGTTGAAGCCT -> TTAATACCAGTTGAAGCCTA
ATTAATTTGGAACGATTAAT -> TTAATTTGGAACGATTAATA
AAGAGAAAGATCGGAACAGT -> AGAGAAAGATCGGAACAGTC
GTAGACCTGGACCCGCAGAG -> TAGACCTGGACCCGCAGAGC
GGTCCGAAACCCTAAAAGCT -> GTCCGAAACCCTAAAAGCTA
GATGTGAAATTGGCTCGCCC -> ATGTGAAATTGGCTCGCCCC
CAATCGTGGATTCCTAAGCC -> AATCGTGGATTCCTAAGCCA
AATGTGAGAGCGAACAAATA -> ATGTGAGAGCGAACAAATAA
GCGTCTCCCACAATGCACTC -> CGTCTCCCACAATGCACTCT
AACCACTGACACCCAATCCA -> ACCACTGACACCCAATCCAA
AACAACGGTAAGAGAAAGAT -> ACAACGGTAAGAGAAAGATC
AGGTGTTCACGGTAGGCACC -> GGTGTTCACGGTAGGCACCC
GTCCCGTCGTGCATTTTAGT -> TCCCGTCGTGCATTTTAGTC
TCGGCGGTAGACCTGGACCC -> CGGCGGTAGACCTGGACCCG
GGACATAGCATCGGACCTTG -> GACATAGCATCGGACCTTGC
AATCGTGGATTCCTAAGCCA -> ATCGTGGATTCCTAAGCCAG
GTTCATTGTCCCGTCTTATG -> TTCATTGTCCCGTCTTATGC
CCTTTCCGGGAAGAAACAAC -> CTTTCCGGGAAGAAACAACG
GACAAGCATGCTTGTTGCCC -> ACAAGCATGCTTGTTGCCCC
ACCCAATCCAAACCTATCGG -> CCCAATCCAAACCTATCGGC
GAAGCCTACGTCGACATAAA -> AAGCCTACGTCGACATAAAA
GGAACGATTAATACCAGTTG -> GAACGATTAATACCAGTTGA
TAGATGGATGAGGACATAGC -> AGATGGATGAGGACATAGCA
GTTGAAGCCTACGTCGACAT -> TTGAAGCCTACGTCGACATA
CGTCTTATGCACACCACCCA -> GTCTTATGCACACCACCCAG
TATGCACACCACCCAGTAAC -> ATGCACACCACCCAGTAACC
CCAGTGGGACAACCGAGTAG -> CAGTGGGACAACCGAGTAGA
CCAATTAATTTGGAACGATT -> CAATTAATTTGGAACGATTA
GCGTTGCACTGCAATTTCTG -> CGTTGCACTGCAATTTCTGC
GCGCAATCGTGGATTCCTAA -> CGCAATCGTGGATTCCTAAG
TTGCGTCGATACCGTAAATC -> TGCGTCGATACCGTAAATCA
ACGCGACGCAGTCCTGTAAA -> CGCGACGCAGTCCTGTAAAG
TTGCCAATAAAATACCACGC -> TGCCAATAAAATACCACGCG
CGGTCCCTTTAGCCTTTCAG -> GGTCCCTTTAGCCTTTCAGG
ATGCAGGGTTGGACTCGTAC -> TGCAGGGTTGGACTCGTACG
TTATGCACACCACCCAGTAA -> TATGCACACCACCCAGTAAC
GGCCGTGGGGAAAACCGAGG -> GCCGTGGGGAAAACCGAGGC
GCCGTGGGGAAAACCGAGGC -> CCGTGGGGAAAACCGAGGCG
GGACCCTCGCTAGATCGCAA -> GACCCTCGCTAGATCGCAAT
TACGAAGCGTGATGGATAGG -> ACGAAGCGTGATGGATAGGT
ATAAAGTTACTAAAGGCGTC -> TAAAGTTACTAAAGGCGTCT
AGACCTCTCCGTACGAAGCG -> GACCTCTCCGTACGAAGCGT
CGTGACATGCAGGGTTGGAC -> GTGACATGCAGGGTTGGACT
CTACGTCGACATAAAAATCC -> TACGTCGACATAAAAATCCT
CACGAACGGATACCAGACCC -> ACGAACGGATACCAGACCCC
GGCGGATTGCACTCCAATTA -> GCGGATTGCACTCCAATTAA
TAATACATTCAAGCCACTGT -> AATACATTCAAGCCACTGTC
AGAGCGCCCAGGAACCCTAA -> GAGCGCCCAGGAACCCTAAC
CCTCATCAGTCAGAATGATG -> CTCATCAGTCAGAATGATGT
ATCGGACCTTGCGTCGATAC -> TCGGACCTTGCGTCGATACC
AGCATGCTTGTTGCCCCGGC -> GCATGCTTGTTGCCCCGGCC
AAGAAACAACGGTAAGAGAA -> AGAAACAACGGTAAGAGAAA
AATACATTCAAGCCACTGTC -> ATACATTCAAGCCACTGTCA
TCACGGTAGGCACCCGTGAC -> CACGGTAGGCACCCGTGACA
GTCAGAATGATGTGAAATTG -> TCAGAATGATGTGAAATTGG
TTACTAAAGGCGTCTCCCAC -> TACTAAAGGCGTCTCCCACA
TGCGTCGATACCGTAAATCA -> GCGTCGATACCGTAAATCAT
TTCAAGCCACTGTCACTACC -> TCAAGCCACTGTCACTACCG
GTTCACGGTAGGCACCCGTG -> TTCACGGTAGGCACCCGTGA
CTTTCAGGTCGACACGAACG -> TTTCAGGTCGACACGAACGG
GACCTCTCCGTACGAAGCGT -> ACCTCTCCGTACGAAGCGTG
ATGCACACCACCCAGTAACC -> TGCACACCACCCAGTAACCA
CTCTTTCGGCTGACAAGCAT -> TCTTTCGGCTGACAAGCATG
GTCCTGTAAAGGGACGTACG -> TCCTGTAAAGGGACGTACGC
AAAGATCGGAACAGTCCGAC -> AAGATCGGAACAGTCCGACT
ACCATCGCACTCAGGACGGC -> CCATCGCACTCAGGACGGCT
AGTAGTTCATTGTCCCGTCT -> GTAGTTCATTGTCCCGTCTT
ATGCTTGTTGCCCCGGCCGT -> TGCTTGTTGCCCCGGCCGTG
CTAAAGGCGTCTCCCACAAT -> TAAAGGCGTCTCCCACAATG
ATAGTCAGCCAGGCCACGGA -> TAGTCAGCCAGGCCACGGAT
GAACTCCTTTCCGGGAAGAA -> AACTCCTTTCCGGGAAGAAA
GTCGGCTTCACCATCGCACT -> TCGGCTTCACCATCGCACTC
GATCGCAATGTGAGAGCGAA -> ATCGCAATGTGAGAGCGAAC
CATAGCATCGGACCTTGCGT -> ATAGCATCGGACCTTGCGTC
CGGCCGTGGGGAAAACCGAG -> GGCCGTGGGGAAAACCGAGG
GGTAGGCACCCGTGACATGC -> GTAGGCACCCGTGACATGCA
TGCACTGCAATTTCTGCCTG -> GCACTGCAATTTCTGCCTGC
TCGCTAGATCGCAATGTGAG -> CGCTAGATCGCAATGTGAGA
CCGAAACCCTAAAAGCTAAA -> CGAAACCCTAAAAGCTAAAT
GCCATTAGAATGAATGTTTT -> CCATTAGAATGAATGTTTTG
CGTCTCGCTTATGCATATGT -> GTCTCGCTTATGCATATGTC
ACGGAACTCCTTTCCGGGAA -> CGGAACTCCTTTCCGGGAAG
GCTAGATCGCAATGTGAGAG -> CTAGATCGCAATGTGAGAGC
TCAGGTCGACACGAACGGAT -> CAGGTCGACACGAACGGATA
GAGCGTTCCGTACCAGTAGA -> AGCGTTCCGTACCAGTAGAT
CACTGTCACTACCGTACCTT -> ACTGTCACTACCGTACCTTG
ATTGTGGACGATAGGGCGGA -> TTGTGGACGATAGGGCGGAT
TGAATGTTTTGCCAATAAAA -> GAATGTTTTGCCAATAAAAT
ACTCTCTTAGCACGAGCGTT -> CTCTCTTAGCACGAGCGTTC
TTTAGCCTTTCAGGTCGACA -> TTAGCCTTTCAGGTCGACAC
ACATATCTTTCAAAACTCTT -> CATATCTTTCAAAACTCTTT
ATGCATATGTCCCGTCGTGC -> TGCATATGTCCCGTCGTGCA
TCTTTCAAAACTCTTTCGGC -> CTTTCAAAACTCTTTCGGCT
CGACATAAAAATCCTAGGCG -> GACATAAAAATCCTAGGCGC
CAACGGTAAGAGAAAGATCG -> AACGGTAAGAGAAAGATCGG
ATTGTCCCGTCTTATGCACA -> TTGTCCCGTCTTATGCACAC
ACCGTACCTTGTAAGTCGGC -> CCGTACCTTGTAAGTCGGCT
ATCGTGGATTCCTAAGCCAG -> TCGTGGATTCCTAAGCCAGA
GCAATCGTGGATTCCTAAGC -> CAATCGTGGATTCCTAAGCC
CGGTAGGCACCCGTGACATG -> GGTAGGCACCCGTGACATGC
TTAGTCCGGACCGGAGTCAA -> TAGTCCGGACCGGAGTCAAC
ACCGTAAATCATATAAGACC -> CCGTAAATCATATAAGACCT
CCGTCTTATGCACACCACCC -> CGTCTTATGCACACCACCCA
ACCACTGACACCCAATCCAA -> CCACTGACACCCAATCCAAA
GTACGAAGCGTGATGGATAG -> TACGAAGCGTGATGGATAGG
AGAACAGGTAGCGAAGGTCC -> GAACAGGTAGCGAAGGTCCG
CGGCGGTAGACCTGGACCCG -> GGCGGTAGACCTGGACCCGC
GTACGCGGTCCCTTTAGCCT -> TACGCGGTCCCTTTAGCCTT
GTGCATTTTAGTCCGGACCG -> TGCATTTTAGTCCGGACCGG
CTCATCAGTCAGAATGATGT -> TCATCAGTCAGAATGATGTG
AAATACCACGCGACGCAGTC -> AATACCACGCGACGCAGTCC
CCCGCAGAGCGCCCAGGAAC -> CCGCAGAGCGCCCAGGAACC
ATGGATGAGGACATAGCATC -> TGGATGAGGACATAGCATCG
ACCAGTTGAAGCCTACGTCG -> CCAGTTGAAGCCTACGTCGA
TAGAGCCTCATCAGTCAGAA -> AGAGCCTCATCAGTCAGAAT
TAAGACCTCTCCGTACGAAG -> AAGACCTCTCCGTACGAAGC
CGACACGAACGGATACCAGA -> GACACGAACGGATACCAGAC
GGCGTTGCACTGCAATTTCT -> GCGTTGCACTGCAATTTCTG
GTACGGCCATTAGAATGAAT -> TACGGCCATTAGAATGAATG
TTCTGCCTGCACCCGTGTCA -> TCTGCCTGCACCCGTGTCAG
TTGCACTCCAATTAATTTGG -> TGCACTCCAATTAATTTGGA
TCTCTTAGCACGAGCGTTCC -> CTCTTAGCACGAGCGTTCCG
CGCTTATGCATATGTCCCGT -> GCTTATGCATATGTCCCGTC
CAGTAGTTCATTGTCCCGTC -> AGTAGTTCATTGTCCCGTCT
AAGCCTACGTCGACATAAAA -> AGCCTACGTCGACATAAAAA
GTAAAGGGACGTACGCGGTC -> TAAAGGGACGTACGCGGTCC
TTTTAGTCCGGACCGGAGTC -> TTTAGTCCGGACCGGAGTCA
TGACAAGCATGCTTGTTGCC -> GACAAGCATGCTTGTTGCCC
TCATCAGTCAGAATGATGTG -> CATCAGTCAGAATGATGTGA
TACTAAAGGCGTCTCCCACA -> ACTAAAGGCGTCTCCCACAA
GTAGTTCATTGTCCCGTCTT -> TAGTTCATTGTCCCGTCTTA
TGGGACAACCGAGTAGAGCC -> GGGACAACCGAGTAGAGCCT
AACGGTAAGAGAAAGATCGG -> ACGGTAAGAGAAAGATCGGA
ATTTTAGTCCGGACCGGAGT -> TTTTAGTCCGGACCGGAGTC
CACGGAACTCCTTTCCGGGA -> ACGGAACTCCTTTCCGGGAA
AAAATACCACGCGACGCAGT -> AAATACCACGCGACGCAGTC
AATACCAGTTGAAGCCTACG -> ATACCAGTTGAAGCCTACGT
ACTATCAATGTCCAGGGACC -> CTATCAATGTCCAGGGACCC
CACGGATCACGGAACTCCTT -> ACGGATCACGGAACTCCTTT
GAAGGTCCGAAACCCTAAAA -> AAGGTCCGAAACCCTAAAAG
CTTATGCATATGTCCCGTCG -> TTATGCATATGTCCCGTCGT
AGCTAAATAAAGGTGCGTCT -> GCTAAATAAAGGTGCGTCTC
GACATAAAAATCCTAGGCGC -> ACATAAAAATCCTAGGCGCA
GGCACCCGTGACATGCAGGG -> GCACCCGTGACATGCAGGGT
ACCTTGTAAGTCGGCTTCAC -> CCTTGTAAGTCGGCTTCACC
CGAAACCCTAAAAGCTAAAT -> GAAACCCTAAAAGCTAAATA
TGTGAGAGCGAACAAATAAT -> GTGAGAGCGAACAAATAATA
GTGAAATTGGCTCGCCCCTC -> TGAAATTGGCTCGCCCCTCT
TTGCACTGCAATTTCTGCCT -> TGCACTGCAATTTCTGCCTG
GAAGCGTGATGGATAGGTGT -> AAGCGTGATGGATAGGTGTT
GGATAGGTGTTCACGGTAGG -> GATAGGTGTTCACGGTAGGC
TTGGACTCGTACGGCCATTA -> TGGACTCGTACGGCCATTAG
AGATGGATGAGGACATAGCA -> GATGGATGAGGACATAGCAT
GTGCGTCTCGCTTATGCATA -> TGCGTCTCGCTTATGCATAT
GCGTTCCGTACCAGTAGATG -> CGTTCCGTACCAGTAGATGG
ACACCCAATCCAAACCTATC -> CACCCAATCCAAACCTATCG
GCTTGTTGCCCCGGCCGTGG -> CTTGTTGCCCCGGCCGTGGG
AACAGTCCGACTATCAATGT -> ACAGTCCGACTATCAATGTC
GTCACTACCGTACCTTGTAA -> TCACTACCGTACCTTGTAAG
CTCCCACAATGCACTCTCTT -> TCCCACAATGCACTCTCTTA
CTTATGCACACCACCCAGTA -> TTATGCACACCACCCAGTAA
AACAGGTAGCGAAGGTCCGA -> ACAGGTAGCGAAGGTCCGAA
TAGATCGCAATGTGAGAGCG -> AGATCGCAATGTGAGAGCGA
TTCACCATCGCACTCAGGAC -> TCACCATCGCACTCAGGACG
GGGGAAAACCGAGGCGTATA -> GGGAAAACCGAGGCGTATAA
TTCAGGTCGACACGAACGGA -> TCAGGTCGACACGAACGGAT
CTGCACCCGTGTCAGTAGTT -> TGCACCCGTGTCAGTAGTTC
CCAGATAATAGTCAGCCAGG -> CAGATAATAGTCAGCCAGGC
TATAAAGTTACTAAAGGCGT -> ATAAAGTTACTAAAGGCGTC
CGATTAATACCAGTTGAAGC -> GATTAATACCAGTTGAAGCC
CATTTTAGTCCGGACCGGAG -> ATTTTAGTCCGGACCGGAGT
TGAAATTGGCTCGCCCCTCT -> GAAATTGGCTCGCCCCTCTC
AGAAACAACGGTAAGAGAAA -> GAAACAACGGTAAGAGAAAG
GAATGTTTTGCCAATAAAAT -> AATGTTTTGCCAATAAAATA
ATGTGAGAGCGAACAAATAA -> TGTGAGAGCGAACAAATAAT
CTCGTACGGCCATTAGAATG -> TCGTACGGCCATTAGAATGA
GTCAGTAGTTCATTGTCCCG -> TCAGTAGTTCATTGTCCCGT
ACCCTAAAAGCTAAATAAAG -> CCCTAAAAGCTAAATAAAGG
TTAGAATGAATGTTTTGCCA -> TAGAATGAATGTTTTGCCAA
CTTTCGGCTGACAAGCATGC -> TTTCGGCTGACAAGCATGCT
AAGGGACGTACGCGGTCCCT -> AGGGACGTACGCGGTCCCTT
TAGACCTGGACCCGCAGAGC -> AGACCTGGACCCGCAGAGCG
GGTCCCTTTAGCCTTTCAGG -> GTCCCTTTAGCCTTTCAGGT
TGCACACCACCCAGTAACCA -> GCACACCACCCAGTAACCAC
TACCAGTAGATGGATGAGGA -> ACCAGTAGATGGATGAGGAC
TTTCGGCTGACAAGCATGCT -> TTCGGCTGACAAGCATGCTT
CAGGACGGCTAGGGGGCGTT -> AGGACGGCTAGGGGGCGTTG
TGTAAAGGGACGTACGCGGT -> GTAAAGGGACGTACGCGGTC
CTCGCTAGATCGCAATGTGA -> TCGCTAGATCGCAATGTGAG
TCCGGACCGGAGTCAACCAG -> CCGGACCGGAGTCAACCAGT
CCACGGATCACGGAACTCCT -> CACGGATCACGGAACTCCTT
CTCGCTTATGCATATGTCCC -> TCGCTTATGCATATGTCCCG
CCTAAGCCAGAACAGGTAGC -> CTAAGCCAGAACAGGTAGCG
CAGTCCTGTAAAGGGACGTA -> AGTCCTGTAAAGGGACGTAC
GGGTTGGACTCGTACGGCCA -> GGTTGGACTCGTACGGCCAT
GCACACCACCCAGTAACCAC -> CACACCACCCAGTAACCACT
GAATGATGTGAAATTGGCTC -> AATGATGTGAAATTGGCTCG
CTAGATCGCAATGTGAGAGC -> TAGATCGCAATGTGAGAGCG
CACTCCAATTAATTTGGAAC -> ACTCCAATTAATTTGGAACG
GAAATTGGCTCGCCCCTCTC -> AAATTGGCTCGCCCCTCTCC
TGTCCAGGGACCCTCGCTAG -> GTCCAGGGACCCTCGCTAGA
GACCTTGCGTCGATACCGTA -> ACCTTGCGTCGATACCGTAA
GAAACAACGGTAAGAGAAAG -> AAACAACGGTAAGAGAAAGA
GAGAAAGATCGGAACAGTCC -> AGAAAGATCGGAACAGTCCG
CACGAGCGTTCCGTACCAGT -> ACGAGCGTTCCGTACCAGTA
TGCCAATAAAATACCACGCG -> GCCAATAAAATACCACGCGA
AGGGGGCGTTGCACTGCAAT -> GGGGGCGTTGCACTGCAATT
CGGCCATTAGAATGAATGTT -> GGCCATTAGAATGAATGTTT
CCCGTCTTATGCACACCACC -> CCGTCTTATGCACACCACCC
TAGCATCGGACCTTGCGTCG -> AGCATCGGACCTTGCGTCGA
AGCGTGATGGATAGGTGTTC -> GCGTGATGGATAGGTGTTCA
ATCATATAAGACCTCTCCGT -> TCATATAAGACCTCTCCGTA
ATGTCCCGTCGTGCATTTTA -> TGTCCCGTCGTGCATTTTAG
AGAGCGAACAAATAATACAT -> GAGCGAACAAATAATACATT
GCTAAATAAAGGTGCGTCTC -> CTAAATAAAGGTGCGTCTCG
CCATCGCACTCAGGACGGCT -> CATCGCACTCAGGACGGCTA
GTCAGCCAGGCCACGGATCA -> TCAGCCAGGCCACGGATCAC
GCCTTTCAGGTCGACACGAA -> CCTTTCAGGTCGACACGAAC
AAGCGTGATGGATAGGTGTT -> AGCGTGATGGATAGGTGTTC
CTCCAATTAATTTGGAACGA -> TCCAATTAATTTGGAACGAT
AATTTGGAACGATTAATACC -> ATTTGGAACGATTAATACCA
AGAGCCTCATCAGTCAGAAT -> GAGCCTCATCAGTCAGAATG
TCCAATTAATTTGGAACGAT -> CCAATTAATTTGGAACGATT
AGCCTACGTCGACATAAAAA -> GCCTACGTCGACATAAAAAT
CGTATAAAGTTACTAAAGGC -> GTATAAAGTTACTAAAGGCG
ACTCCTTTCCGGGAAGAAAC -> CTCCTTTCCGGGAAGAAACA
GACCGGAGTCAACCAGTGGG -> ACCGGAGTCAACCAGTGGGA
ACCCGTGACATGCAGGGTTG -> CCCGTGACATGCAGGGTTGG
ACCACCCAGTAACCACTGAC -> CCACCCAGTAACCACTGACA
TTGTCCCGTCTTATGCACAC -> TGTCCCGTCTTATGCACACC
GGCGTCTCCCACAATGCACT -> GCGTCTCCCACAATGCACTC
GCGAACAAATAATACATTCA -> CGAACAAATAATACATTCAA
CCTACGTCGACATAAAAATC -> CTACGTCGACATAAAAATCC
GGCTAGGGGGCGTTGCACTG -> GCTAGGGGGCGTTGCACTGC
TACCGTAAATCATATAAGAC -> ACCGTAAATCATATAAGACC
TCGTGCATTTTAGTCCGGAC -> CGTGCATTTTAGTCCGGACC
GGGCGGATTGCACTCCAATT -> GGCGGATTGCACTCCAATTA
TCCAGGGACCCTCGCTAGAT -> CCAGGGACCCTCGCTAGATC
GACAACCGAGTAGAGCCTCA -> ACAACCGAGTAGAGCCTCAT
CGTGATGGATAGGTGTTCAC -> GTGATGGATAGGTGTTCACG
GCGACGCAGTCCTGTAAAGG -> CGACGCAGTCCTGTAAAGGG
ACGGCTAGGGGGCGTTGCAC -> CGGCTAGGGGGCGTTGCACT
ACGGCCATTAGAATGAATGT -> CGGCCATTAGAATGAATGTT
TCAGAATGATGTGAAATTGG -> CAGAATGATGTGAAATTGGC
ACATAAAAATCCTAGGCGCA -> CATAAAAATCCTAGGCGCAA
TGCTTGTTGCCCCGGCCGTG -> GCTTGTTGCCCCGGCCGTGG
ACTGCAATTTCTGCCTGCAC -> CTGCAATTTCTGCCTGCACC
ATAAAATACCACGCGACGCA -> TAAAATACCACGCGACGCAG
AGCGACATATCTTTCAAAAC -> GCGACATATCTTTCAAAACT
CATCGCACTCAGGACGGCTA -> ATCGCACTCAGGACGGCTAG
AAAGTTACTAAAGGCGTCTC -> AAGTTACTAAAGGCGTCTCC
ATAAAGGTGCGTCTCGCTTA -> TAAAGGTGCGTCTCGCTTAT
AGAGAAAGATCGGAACAGTC -> GAGAAAGATCGGAACAGTCC
TCCTAGGCGCAATCGTGGAT -> CCTAGGCGCAATCGTGGATT
ACCAGTGGGACAACCGAGTA -> CCAGTGGGACAACCGAGTAG
TGCACTCTCTTAGCACGAGC -> GCACTCTCTTAGCACGAGCG
AGAATGATGTGAAATTGGCT -> GAATGATGTGAAATTGGCTC
GTTGGACTCGTACGGCCATT -> TTGGACTCGTACGGCCATTA
AAAGCTAAATAAAGGTGCGT -> AAGCTAAATAAAGGTGCGTC
GGACCGGAGTCAACCAGTGG -> GACCGGAGTCAACCAGTGGG
ACCTATCGGCGGTAGACCTG -> CCTATCGGCGGTAGACCTGG
TCCGAGAGCGACATATCTTT -> CCGAGAGCGACATATCTTTC
CGTCGACATAAAAATCCTAG -> GTCGACATAAAAATCCTAGG
CAGTCCGACTATCAATGTCC -> AGTCCGACTATCAATGTCCA
CCACTGTCACTACCGTACCT -> CACTGTCACTACCGTACCTT
TCCAAACCTATCGGCGGTAG -> CCAAACCTATCGGCGGTAGA
GCGTCTCGCTTATGCATATG -> CGTCTCGCTTATGCATATGT
ACCAGTAGATGGATGAGGAC -> CCAGTAGATGGATGAGGACA
GTATAAAGTTACTAAAGGCG -> TATAAAGTTACTAAAGGCGT
TGGATGAGGACATAGCATCG -> GGATGAGGACATAGCATCGG
CCCGTGTCAGTAGTTCATTG -> CCGTGTCAGTAGTTCATTGT
AACCAGTGGGACAACCGAGT -> ACCAGTGGGACAACCGAGTA
ACTCAGGACGGCTAGGGGGC -> CTCAGGACGGCTAGGGGGCG
GGAACAGTCCGACTATCAAT -> GAACAGTCCGACTATCAATG
GTCGATACCGTAAATCATAT -> TCGATACCGTAAATCATATA
GACATAGCATCGGACCTTGC -> ACATAGCATCGGACCTTGCG
GCTTCACCATCGCACTCAGG -> CTTCACCATCGCACTCAGGA
TTAATTTGGAACGATTAATA -> TAATTTGGAACGATTAATAC
TGCGTCTCGCTTATGCATAT -> GCGTCTCGCTTATGCATATG
AAACCTATCGGCGGTAGACC -> AACCTATCGGCGGTAGACCT
GTAGGCACCCGTGACATGCA -> TAGGCACCCGTGACATGCAG
AGATCGCAATGTGAGAGCGA -> GATCGCAATGTGAGAGCGAA
CTTTCCGGGAAGAAACAACG -> TTTCCGGGAAGAAACAACGG
TGTCAGTAGTTCATTGTCCC -> GTCAGTAGTTCATTGTCCCG
AAACCCTAAAAGCTAAATAA -> AACCCTAAAAGCTAAATAAA
TTGTTGCCCCGGCCGTGGGG -> TGTTGCCCCGGCCGTGGGGA
CACTCAGGACGGCTAGGGGG -> ACTCAGGACGGCTAGGGGGC
AGAAAGATCGGAACAGTCCG -> GAAAGATCGGAACAGTCCGA
ACGAGCGTTCCGTACCAGTA -> CGAGCGTTCCGTACCAGTAG
TATAAGACCTCTCCGTACGA -> ATAAGACCTCTCCGTACGAA
AAATAATACATTCAAGCCAC -> AATAATACATTCAAGCCACT
CCCAATCCAAACCTATCGGC -> CCAATCCAAACCTATCGGCG
CACGCGACGCAGTCCTGTAA -> ACGCGACGCAGTCCTGTAAA
AAGTTACTAAAGGCGTCTCC -> AGTTACTAAAGGCGTCTCCC
CGAACGGATACCAGACCCCC -> GAACGGATACCAGACCCCCA
ACTCTTTCGGCTGACAAGCA -> CTCTTTCGGCTGACAAGCAT
ATGTTTTGCCAATAAAATAC -> TGTTTTGCCAATAAAATACC
AGGACGGCTAGGGGGCGTTG -> GGACGGCTAGGGGGCGTTGC
GCACGAGCGTTCCGTACCAG -> CACGAGCGTTCCGTACCAGT
TCCTTTCCGGGAAGAAACAA -> CCTTTCCGGGAAGAAACAAC
TCGACATAAAAATCCTAGGC -> CGACATAAAAATCCTAGGCG
AGTAACCACTGACACCCAAT -> GTAACCACTGACACCCAATC
GATAATAGTCAGCCAGGCCA -> ATAATAGTCAGCCAGGCCAC
GTCCGACTATCAATGTCCAG -> TCCGACTATCAATGTCCAGG
TGCATTTTAGTCCGGACCGG -> GCATTTTAGTCCGGACCGGA
CCTGGACCCGCAGAGCGCCC -> CTGGACCCGCAGAGCGCCCA
TAAAAATCCTAGGCGCAATC -> AAAAATCCTAGGCGCAATCG
TAGGGCGGATTGCACTCCAA -> AGGGCGGATTGCACTCCAAT
GGCTGACAAGCATGCTTGTT -> GCTGACAAGCATGCTTGTTG
ATACCACGCGACGCAGTCCT -> TACCACGCGACGCAGTCCTG
CCTGCACCCGTGTCAGTAGT -> CTGCACCCGTGTCAGTAGTT
TCTTAGCACGAGCGTTCCGT -> CTTAGCACGAGCGTTCCGTA
ATTGGCTCGCCCCTCTCCGA -> TTGGCTCGCCCCTCTCCGAG
GAGTCAACCAGTGGGACAAC -> AGTCAACCAGTGGGACAACC
CTCTCCGAGAGCGACATATC -> TCTCCGAGAGCGACATATCT
GCCAATAAAATACCACGCGA -> CCAATAAAATACCACGCGAC
GGTAAGAGAAAGATCGGAAC -> GTAAGAGAAAGATCGGAACA
TTTCTGCCTGCACCCGTGTC -> TTCTGCCTGCACCCGTGTCA
CAGACCCCCAGATAATAGTC -> AGACCCCCAGATAATAGTCA
TAATTTGGAACGATTAATAC -> AATTTGGAACGATTAATACC
CCGAGTAGAGCCTCATCAGT -> CGAGTAGAGCCTCATCAGTC
CGTGCATTTTAGTCCGGACC -> GTGCATTTTAGTCCGGACCG
AGCCTCATCAGTCAGAATGA -> GCCTCATCAGTCAGAATGAT
GATTGCACTCCAATTAATTT -> ATTGCACTCCAATTAATTTG
CAGGGACCCTCGCTAGATCG -> AGGGACCCTCGCTAGATCGC
TTAATACCAGTTGAAGCCTA -> TAATACCAGTTGAAGCCTAC
AATGTTTTGCCAATAAAATA -> ATGTTTTGCCAATAAAATAC
GTGTTCACGGTAGGCACCCG -> TGTTCACGGTAGGCACCCGT
GCAATGTGAGAGCGAACAAA -> CAATGTGAGAGCGAACAAAT
GAAAACCGAGGCGTATAAAG -> AAAACCGAGGCGTATAAAGT
GAGTAGAGCCTCATCAGTCA -> AGTAGAGCCTCATCAGTCAG
CGACTATCAATGTCCAGGGA -> GACTATCAATGTCCAGGGAC
CGTACGGCCATTAGAATGAA -> GTACGGCCATTAGAATGAAT
AATCCAAACCTATCGGCGGT -> ATCCAAACCTATCGGCGGTA
TGACATGCAGGGTTGGACTC -> GACATGCAGGGTTGGACTCG
ACGAACGGATACCAGACCCC -> CGAACGGATACCAGACCCCC
GGCGCAATCGTGGATTCCTA -> GCGCAATCGTGGATTCCTAA
ACAATGCACTCTCTTAGCAC -> CAATGCACTCTCTTAGCACG
AGCACGAGCGTTCCGTACCA -> GCACGAGCGTTCCGTACCAG
TGGATTCCTAAGCCAGAACA -> GGATTCCTAAGCCAGAACAG
CCTTTAGCCTTTCAGGTCGA -> CTTTAGCCTTTCAGGTCGAC
CACTGACACCCAATCCAAAC -> ACTGACACCCAATCCAAACC
ATATGTCCCGTCGTGCATTT -> TATGTCCCGTCGTGCATTTT
GCATTTTAGTCCGGACCGGA -> CATTTTAGTCCGGACCGGAG
ATTGCACTCCAATTAATTTG -> TTGCACTCCAATTAATTTGG
GCCACTGTCACTACCGTACC -> CCACTGTCACTACCGTACCT
CAGTAGATGGATGAGGACAT -> AGTAGATGGATGAGGACATA
TTGAAGCCTACGTCGACATA -> TGAAGCCTACGTCGACATAA
CTAAAAGCTAAATAAAGGTG -> TAAAAGCTAAATAAAGGTGC
CAACCAGTGGGACAACCGAG -> AACCAGTGGGACAACCGAGT
AACAAATAATACATTCAAGC -> ACAAATAATACATTCAAGCC
GCACTCAGGACGGCTAGGGG -> CACTCAGGACGGCTAGGGGG
CCGTGACATGCAGGGTTGGA -> CGTGACATGCAGGGTTGGAC
AATTGGCTCGCCCCTCTCCG -> ATTGGCTCGCCCCTCTCCGA
CCCAGGAACCCTAACGGAGG -> CCAGGAACCCTAACGGAGGC
AACTCTTTCGGCTGACAAGC -> ACTCTTTCGGCTGACAAGCA
TGTAAGTCGGCTTCACCATC -> GTAAGTCGGCTTCACCATCG
GACACCCAATCCAAACCTAT -> ACACCCAATCCAAACCTATC
AGTCCGACTATCAATGTCCA -> GTCCGACTATCAATGTCCAG
ATCGCAATGTGAGAGCGAAC -> TCGCAATGTGAGAGCGAACA
CGTTGCACTGCAATTTCTGC -> GTTGCACTGCAATTTCTGCC
AAAACCGAGGCGTATAAAGT -> AAACCGAGGCGTATAAAGTT
ATAGCATCGGACCTTGCGTC -> TAGCATCGGACCTTGCGTCG
TCAAGCCACTGTCACTACCG -> CAAGCCACTGTCACTACCGT
AGACCTGGACCCGCAGAGCG -> GACCTGGACCCGCAGAGCGC
GACCTGGACCCGCAGAGCGC -> ACCTGGACCCGCAGAGCGCC
TCCCACAATGCACTCTCTTA -> CCCACAATGCACTCTCTTAG
CATAAAAATCCTAGGCGCAA -> ATAAAAATCCTAGGCGCAAT
TCGGCTGACAAGCATGCTTG -> CGGCTGACAAGCATGCTTGT
GAGCGAACAAATAATACATT -> AGCGAACAAATAATACATTC
TCTTATGCACACCACCCAGT -> CTTATGCACACCACCCAGTA
TATGCATATGTCCCGTCGTG -> ATGCATATGTCCCGTCGTGC
CTTTCAAAACTCTTTCGGCT -> TTTCAAAACTCTTTCGGCTG
AAGGTCCGAAACCCTAAAAG -> AGGTCCGAAACCCTAAAAGC
AGCCTTTCAGGTCGACACGA -> GCCTTTCAGGTCGACACGAA
GCCACGGATCACGGAACTCC -> CCACGGATCACGGAACTCCT
AGTCAGAATGATGTGAAATT -> GTCAGAATGATGTGAAATTG
CTTGCGTCGATACCGTAAAT -> TTGCGTCGATACCGTAAATC
GCCTACGTCGACATAAAAAT -> CCTACGTCGACATAAAAATC
CGTGGGGAAAACCGAGGCGT -> GTGGGGAAAACCGAGGCGTA
CAATAAAATACCACGCGACG -> AATAAAATACCACGCGACGC
ACGAAGCGTGATGGATAGGT -> CGAAGCGTGATGGATAGGTG
GGTCGACACGAACGGATACC -> GTCGACACGAACGGATACCA
CCCAGATAATAGTCAGCCAG -> CCAGATAATAGTCAGCCAGG
CCAGGCCACGGATCACGGAA -> CAGGCCACGGATCACGGAAC
CCAATAAAATACCACGCGAC -> CAATAAAATACCACGCGACG
TACGGCCATTAGAATGAATG -> ACGGCCATTAGAATGAATGT
CTTCACCATCGCACTCAGGA -> TTCACCATCGCACTCAGGAC
CGGTAAGAGAAAGATCGGAA -> GGTAAGAGAAAGATCGGAAC
TAGCCTTTCAGGTCGACACG -> AGCCTTTCAGGTCGACACGA
TAGGCACCCGTGACATGCAG -> AGGCACCCGTGACATGCAGG
TGTCCCGTCTTATGCACACC -> GTCCCGTCTTATGCACACCA
AGTCAGCCAGGCCACGGATC -> GTCAGCCAGGCCACGGATCA
ACGATAGGGCGGATTGCACT -> CGATAGGGCGGATTGCACTC
ACAGGTAGCGAAGGTCCGAA -> CAGGTAGCGAAGGTCCGAAA
TCTCCCACAATGCACTCTCT -> CTCCCACAATGCACTCTCTT
AAGACCTCTCCGTACGAAGC -> AGACCTCTCCGTACGAAGCG
CTGTCACTACCGTACCTTGT -> TGTCACTACCGTACCTTGTA
GCCCCGGCCGTGGGGAAAAC -> CCCCGGCCGTGGGGAAAACC
TAGCACGAGCGTTCCGTACC -> AGCACGAGCGTTCCGTACCA
ACGGTAGGCACCCGTGACAT -> CGGTAGGCACCCGTGACATG
ATCTTTCAAAACTCTTTCGG -> TCTTTCAAAACTCTTTCGGC
TATCAATGTCCAGGGACCCT -> ATCAATGTCCAGGGACCCTC
AATAGTCAGCCAGGCCACGG -> ATAGTCAGCCAGGCCACGGA
GTAAGAGAAAGATCGGAACA -> TAAGAGAAAGATCGGAACAG
AATGTCCAGGGACCCTCGCT -> ATGTCCAGGGACCCTCGCTA
GGTTGGACTCGTACGGCCAT -> GTTGGACTCGTACGGCCATT
CCAATCCAAACCTATCGGCG -> CAATCCAAACCTATCGGCGG
CAATGTCCAGGGACCCTCGC -> AATGTCCAGGGACCCTCGCT
CGTCGTGCATTTTAGTCCGG -> GTCGTGCATTTTAGTCCGGA
CCGGCCGTGGGGAAAACCGA -> CGGCCGTGGGGAAAACCGAG
AGTCAACCAGTGGGACAACC -> GTCAACCAGTGGGACAACCG
AACCGAGGCGTATAAAGTTA -> ACCGAGGCGTATAAAGTTAC
AGTTGAAGCCTACGTCGACA -> GTTGAAGCCTACGTCGACAT
ATCGGAACAGTCCGACTATC -> TCGGAACAGTCCGACTATCA
CTTAGCACGAGCGTTCCGTA -> TTAGCACGAGCGTTCCGTAC
GAGAGCGACATATCTTTCAA -> AGAGCGACATATCTTTCAAA
TGGATAGGTGTTCACGGTAG -> GGATAGGTGTTCACGGTAGG
TCAGCCAGGCCACGGATCAC -> CAGCCAGGCCACGGATCACG
ACGGATCACGGAACTCCTTT -> CGGATCACGGAACTCCTTTC
GTCCCTTTAGCCTTTCAGGT -> TCCCTTTAGCCTTTCAGGTC
AGGTCCGAAACCCTAAAAGC -> GGTCCGAAACCCTAAAAGCT
ACAGTCCGACTATCAATGTC -> CAGTCCGACTATCAATGTCC
GCGGTCCCTTTAGCCTTTCA -> CGGTCCCTTTAGCCTTTCAG
CATATGTCCCGTCGTGCATT -> ATATGTCCCGTCGTGCATTT
AAACTCTTTCGGCTGACAAG -> AACTCTTTCGGCTGACAAGC
TTGGCTCGCCCCTCTCCGAG -> TGGCTCGCCCCTCTCCGAGA
CCTTTCAGGTCGACACGAAC -> CTTTCAGGTCGACACGAACG
CTAGGGGGCGTTGCACTGCA -> TAGGGGGCGTTGCACTGCAA
CAATGTGAGAGCGAACAAAT -> AATGTGAGAGCGAACAAATA
CGGATCACGGAACTCCTTTC -> GGATCACGGAACTCCTTTCC
TGAAGCCTACGTCGACATAA -> GAAGCCTACGTCGACATAAA
AAAGGCGTCTCCCACAATGC -> AAGGCGTCTCCCACAATGCA
ACATTCAAGCCACTGTCACT -> CATTCAAGCCACTGTCACTA
ACTAAAGGCGTCTCCCACAA -> CTAAAGGCGTCTCCCACAAT
CCGGGAAGAAACAACGGTAA -> CGGGAAGAAACAACGGTAAG
ATCAGTCAGAATGATGTGAA -> TCAGTCAGAATGATGTGAAA
TGATGGATAGGTGTTCACGG -> GATGGATAGGTGTTCACGGT
TTATTGTGGACGATAGGGCG -> TATTGTGGACGATAGGGCGG
GTTACTAAAGGCGTCTCCCA -> TTACTAAAGGCGTCTCCCAC
GTACCTTGTAAGTCGGCTTC -> TACCTTGTAAGTCGGCTTCA
GCACTCCAATTAATTTGGAA -> CACTCCAATTAATTTGGAAC
TTCAAAACTCTTTCGGCTGA -> TCAAAACTCTTTCGGCTGAC
AAAAATCCTAGGCGCAATCG -> AAAATCCTAGGCGCAATCGT
GGGAAGAAACAACGGTAAGA -> GGAAGAAACAACGGTAAGAG
CGTACCTTGTAAGTCGGCTT -> GTACCTTGTAAGTCGGCTTC
AGTCGGCTTCACCATCGCAC -> GTCGGCTTCACCATCGCACT
CACCCGTGACATGCAGGGTT -> ACCCGTGACATGCAGGGTTG
CACCACCCAGTAACCACTGA -> ACCACCCAGTAACCACTGAC
AAGTCGGCTTCACCATCGCA -> AGTCGGCTTCACCATCGCAC
TACCAGACCCCCAGATAATA -> ACCAGACCCCCAGATAATAG
ACAAATAATACATTCAAGCC -> CAAATAATACATTCAAGCCA
ATTCAAGCCACTGTCACTAC -> TTCAAGCCACTGTCACTACC
GCATCGGACCTTGCGTCGAT -> CATCGGACCTTGCGTCGATA
GTCGTGCATTTTAGTCCGGA -> TCGTGCATTTTAGTCCGGAC
TTCCGGGAAGAAACAACGGT -> TCCGGGAAGAAACAACGGTA
CCTCTCCGTACGAAGCGTGA -> CTCTCCGTACGAAGCGTGAT
CGCGACGCAGTCCTGTAAAG -> GCGACGCAGTCCTGTAAAGG
GAACAGGTAGCGAAGGTCCG -> AACAGGTAGCGAAGGTCCGA
GGAAAACCGAGGCGTATAAA -> GAAAACCGAGGCGTATAAAG
CCGGACCGGAGTCAACCAGT -> CGGACCGGAGTCAACCAGTG
ATAAAAATCCTAGGCGCAAT -> TAAAAATCCTAGGCGCAATC
AGCCACTGTCACTACCGTAC -> GCCACTGTCACTACCGTACC
TTTCCGGGAAGAAACAACGG -> TTCCGGGAAGAAACAACGGT
TCGCTTATGCATATGTCCCG -> CGCTTATGCATATGTCCCGT
AAGGTGCGTCTCGCTTATGC -> AGGTGCGTCTCGCTTATGCA
GGACGGCTAGGGGGCGTTGC -> GACGGCTAGGGGGCGTTGCA
AAATAAAGGTGCGTCTCGCT -> AATAAAGGTGCGTCTCGCTT
TAAGCCAGAACAGGTAGCGA -> AAGCCAGAACAGGTAGCGAA
CGCAGTCCTGTAAAGGGACG -> GCAGTCCTGTAAAGGGACGT
GAGGACATAGCATCGGACCT -> AGGACATAGCATCGGACCTT
CACAATGCACTCTCTTAGCA -> ACAATGCACTCTCTTAGCAC
AGGACATAGCATCGGACCTT -> GGACATAGCATCGGACCTTG
ACGCGGTCCCTTTAGCCTTT -> CGCGGTCCCTTTAGCCTTTC
CCGTGGGGAAAACCGAGGCG -> CGTGGGGAAAACCGAGGCGT
ACCCGCAGAGCGCCCAGGAA -> CCCGCAGAGCGCCCAGGAAC
ATCACGGAACTCCTTTCCGG -> TCACGGAACTCCTTTCCGGG
ATAATAGTCAGCCAGGCCAC -> TAATAGTCAGCCAGGCCACG
TCAGTAGTTCATTGTCCCGT -> CAGTAGTTCATTGTCCCGTC
TTCCGTACCAGTAGATGGAT -> TCCGTACCAGTAGATGGATG
TCCGTACGAAGCGTGATGGA -> CCGTACGAAGCGTGATGGAT
TTCCTAAGCCAGAACAGGTA -> TCCTAAGCCAGAACAGGTAG
AGGTGCGTCTCGCTTATGCA -> GGTGCGTCTCGCTTATGCAT
GGGGCGTTGCACTGCAATTT -> GGGCGTTGCACTGCAATTTC
GCTAGGGGGCGTTGCACTGC -> CTAGGGGGCGTTGCACTGCA
GACTATCAATGTCCAGGGAC -> ACTATCAATGTCCAGGGACC
CGGACCTTGCGTCGATACCG -> GGACCTTGCGTCGATACCGT
ATAGGTGTTCACGGTAGGCA -> TAGGTGTTCACGGTAGGCAC
GAGCGCCCAGGAACCCTAAC -> AGCGCCCAGGAACCCTAACG
ATAAGACCTCTCCGTACGAA -> TAAGACCTCTCCGTACGAAG
CGGATTGCACTCCAATTAAT -> GGATTGCACTCCAATTAATT
TGACACCCAATCCAAACCTA -> GACACCCAATCCAAACCTAT
AGCGAAGGTCCGAAACCCTA -> GCGAAGGTCCGAAACCCTAA
GCAGAGCGCCCAGGAACCCT -> CAGAGCGCCCAGGAACCCTA
CATTCAAGCCACTGTCACTA -> ATTCAAGCCACTGTCACTAC
TGCAATTTCTGCCTGCACCC -> GCAATTTCTGCCTGCACCCG
CCCTAAAAGCTAAATAAAGG -> CCTAAAAGCTAAATAAAGGT
CGCTAGATCGCAATGTGAGA -> GCTAGATCGCAATGTGAGAG
CAGGCCACGGATCACGGAAC -> AGGCCACGGATCACGGAACT
GGGACCCTCGCTAGATCGCA -> GGACCCTCGCTAGATCGCAA
GCGTCGATACCGTAAATCAT -> CGTCGATACCGTAAATCATA
TTCACGGTAGGCACCCGTGA -> TCACGGTAGGCACCCGTGAC
CCCTCTCCGAGAGCGACATA -> CCTCTCCGAGAGCGACATAT
CTATCGGCGGTAGACCTGGA -> TATCGGCGGTAGACCTGGAC
CGCACTCAGGACGGCTAGGG -> GCACTCAGGACGGCTAGGGG
AGCGAACAAATAATACATTC -> GCGAACAAATAATACATTCA
AATACCACGCGACGCAGTCC -> ATACCACGCGACGCAGTCCT
ACTACCGTACCTTGTAAGTC -> CTACCGTACCTTGTAAGTCG
ATAGGGCGGATTGCACTCCA -> TAGGGCGGATTGCACTCCAA
GATAGGGCGGATTGCACTCC -> ATAGGGCGGATTGCACTCCA
GCCAGAACAGGTAGCGAAGG -> CCAGAACAGGTAGCGAAGGT
GGACGATAGGGCGGATTGCA -> GACGATAGGGCGGATTGCAC
CGCCCAGGAACCCTAACGGA -> GCCCAGGAACCCTAACGGAG
ATTTCTGCCTGCACCCGTGT -> TTTCTGCCTGCACCCGTGTC
GATACCGTAAATCATATAAG -> ATACCGTAAATCATATAAGA
GCACCCGTGTCAGTAGTTCA -> CACCCGTGTCAGTAGTTCAT
TGCACTCCAATTAATTTGGA -> GCACTCCAATTAATTTGGAA
TCCGAAACCCTAAAAGCTAA -> CCGAAACCCTAAAAGCTAAA
CTCCGTACGAAGCGTGATGG -> TCCGTACGAAGCGTGATGGA
CGAAGCGTGATGGATAGGTG -> GAAGCGTGATGGATAGGTGT
AGCATCGGACCTTGCGTCGA -> GCATCGGACCTTGCGTCGAT
CGAGTAGAGCCTCATCAGTC -> GAGTAGAGCCTCATCAGTCA
CATCAGTCAGAATGATGTGA -> ATCAGTCAGAATGATGTGAA
ACGGATACCAGACCCCCAGA -> CGGATACCAGACCCCCAGAT
TCAATGTCCAGGGACCCTCG -> CAATGTCCAGGGACCCTCGC
CATATAAGACCTCTCCGTAC -> ATATAAGACCTCTCCGTACG
AGTTACTAAAGGCGTCTCCC -> GTTACTAAAGGCGTCTCCCA
GACGTACGCGGTCCCTTTAG -> ACGTACGCGGTCCCTTTAGC
TCCCTTTAGCCTTTCAGGTC -> CCCTTTAGCCTTTCAGGTCG
TTTTGCCAATAAAATACCAC -> TTTGCCAATAAAATACCACG
TCGACACGAACGGATACCAG -> CGACACGAACGGATACCAGA
AGACCCCCAGATAATAGTCA -> GACCCCCAGATAATAGTCAG
TTTCAGGTCGACACGAACGG -> TTCAGGTCGACACGAACGGA
TTTAGTCCGGACCGGAGTCA -> TTAGTCCGGACCGGAGTCAA
CGGACCGGAGTCAACCAGTG -> GGACCGGAGTCAACCAGTGG
AAGGCGTCTCCCACAATGCA -> AGGCGTCTCCCACAATGCAC
TTTGGAACGATTAATACCAG -> TTGGAACGATTAATACCAGT
GTTCCGTACCAGTAGATGGA -> TTCCGTACCAGTAGATGGAT
CGAGGCGTATAAAGTTACTA -> GAGGCGTATAAAGTTACTAA
GGGGGCGTTGCACTGCAATT -> GGGGCGTTGCACTGCAATTT
TGCATATGTCCCGTCGTGCA -> GCATATGTCCCGTCGTGCAT
GTGGGACAACCGAGTAGAGC -> TGGGACAACCGAGTAGAGCC
TTGTAAGTCGGCTTCACCAT -> TGTAAGTCGGCTTCACCATC
CGACATATCTTTCAAAACTC -> GACATATCTTTCAAAACTCT
GCACTGCAATTTCTGCCTGC -> CACTGCAATTTCTGCCTGCA
AAGCATGCTTGTTGCCCCGG -> AGCATGCTTGTTGCCCCGGC
ATCGCACTCAGGACGGCTAG -> TCGCACTCAGGACGGCTAGG
ATAATACATTCAAGCCACTG -> TAATACATTCAAGCCACTGT
CTCCGAGAGCGACATATCTT -> TCCGAGAGCGACATATCTTT
CGTACGCGGTCCCTTTAGCC -> GTACGCGGTCCCTTTAGCCT
TAAAGGGACGTACGCGGTCC -> AAAGGGACGTACGCGGTCCC
CAGTGGGACAACCGAGTAGA -> AGTGGGACAACCGAGTAGAG
AAACCGAGGCGTATAAAGTT -> AACCGAGGCGTATAAAGTTA
AGCGCCCAGGAACCCTAACG -> GCGCCCAGGAACCCTAACGG
CGATACCGTAAATCATATAA -> GATACCGTAAATCATATAAG
CGTACGAAGCGTGATGGATA -> GTACGAAGCGTGATGGATAG
TATGTCCCGTCGTGCATTTT -> ATGTCCCGTCGTGCATTTTA
CCAAACCTATCGGCGGTAGA -> CAAACCTATCGGCGGTAGAC
CGACGCAGTCCTGTAAAGGG -> GACGCAGTCCTGTAAAGGGA
GATAGGTGTTCACGGTAGGC -> ATAGGTGTTCACGGTAGGCA
GCGACATATCTTTCAAAACT -> CGACATATCTTTCAAAACTC
GCCTGCACCCGTGTCAGTAG -> CCTGCACCCGTGTCAGTAGT
AATAAAATACCACGCGACGC -> ATAAAATACCACGCGACGCA
TCTCCGAGAGCGACATATCT -> CTCCGAGAGCGACATATCTT
TCTGCCTGCACCCGTGTCAG -> CTGCCTGCACCCGTGTCAGT
TGTCACTACCGTACCTTGTA -> GTCACTACCGTACCTTGTAA
CCCCAGATAATAGTCAGCCA -> CCCAGATAATAGTCAGCCAG
CCTATCGGCGGTAGACCTGG -> CTATCGGCGGTAGACCTGGA
ATATCTTTCAAAACTCTTTC -> TATCTTTCAAAACTCTTTCG
GCCCAGGAACCCTAACGGAG -> CCCAGGAACCCTAACGGAGG
GACGATAGGGCGGATTGCAC -> ACGATAGGGCGGATTGCACT
CAATGCACTCTCTTAGCACG -> AATGCACTCTCTTAGCACGA
GGCTCGCCCCTCTCCGAGAG -> GCTCGCCCCTCTCCGAGAGC
CGCGGTCCCTTTAGCCTTTC -> GCGGTCCCTTTAGCCTTTCA
GGCCACGGATCACGGAACTC -> GCCACGGATCACGGAACTCC
GTAAATCATATAAGACCTCT -> TAAATCATATAAGACCTCTC
ATACCAGTTGAAGCCTACGT -> TACCAGTTGAAGCCTACGTC
TGGAACGATTAATACCAGTT -> GGAACGATTAATACCAGTTG
TAATACCAGTTGAAGCCTAC -> AATACCAGTTGAAGCCTACG
CAAATAATACATTCAAGCCA -> AAATAATACATTCAAGCCAC
TAGGGGGCGTTGCACTGCAA -> AGGGGGCGTTGCACTGCAAT
CATCGGACCTTGCGTCGATA -> ATCGGACCTTGCGTCGATAC
GTGACATGCAGGGTTGGACT -> TGACATGCAGGGTTGGACTC
CGCCCCTCTCCGAGAGCGAC -> GCCCCTCTCCGAGAGCGACA
AGTGGGACAACCGAGTAGAG -> GTGGGACAACCGAGTAGAGC
TGTTCACGGTAGGCACCCGT -> GTTCACGGTAGGCACCCGTG
AACGGATACCAGACCCCCAG -> ACGGATACCAGACCCCCAGA
CCTAGGCGCAATCGTGGATT -> CTAGGCGCAATCGTGGATTC
ATACATTCAAGCCACTGTCA -> TACATTCAAGCCACTGTCAC
AGGTCGACACGAACGGATAC -> GGTCGACACGAACGGATACC
TCGTGGATTCCTAAGCCAGA -> CGTGGATTCCTAAGCCAGAA
CCGTACCAGTAGATGGATGA -> CGTACCAGTAGATGGATGAG
ATTAGAATGAATGTTTTGCC -> TTAGAATGAATGTTTTGCCA
TCAGTCAGAATGATGTGAAA -> CAGTCAGAATGATGTGAAAT
CACCCGTGTCAGTAGTTCAT -> ACCCGTGTCAGTAGTTCATT
TAATAGTCAGCCAGGCCACG -> AATAGTCAGCCAGGCCACGG
GAGGCGTATAAAGTTACTAA -> AGGCGTATAAAGTTACTAAA
AAACAACGGTAAGAGAAAGA -> AACAACGGTAAGAGAAAGAT
AGCCAGGCCACGGATCACGG -> GCCAGGCCACGGATCACGGA
GGGCGTTGCACTGCAATTTC -> GGCGTTGCACTGCAATTTCT
TCAGGACGGCTAGGGGGCGT -> CAGGACGGCTAGGGGGCGTT
GGCGTATAAAGTTACTAAAG -> GCGTATAAAGTTACTAAAGG
ATGAGGACATAGCATCGGAC -> TGAGGACATAGCATCGGACC
TAAAAGCTAAATAAAGGTGC -> AAAAGCTAAATAAAGGTGCG
GATGAGGACATAGCATCGGA -> ATGAGGACATAGCATCGGAC
CAGCCAGGCCACGGATCACG -> AGCCAGGCCACGGATCACGG
CACTACCGTACCTTGTAAGT -> ACTACCGTACCTTGTAAGTC
TCTCGCTTATGCATATGTCC -> CTCGCTTATGCATATGTCCC
GGTGTTCACGGTAGGCACCC -> GTGTTCACGGTAGGCACCCG
CAGGGTTGGACTCGTACGGC -> AGGGTTGGACTCGTACGGCC
GCGCCCAGGAACCCTAACGG -> CGCCCAGGAACCCTAACGGA
CTCGCCCCTCTCCGAGAGCG -> TCGCCCCTCTCCGAGAGCGA
CCCTCGCTAGATCGCAATGT -> CCTCGCTAGATCGCAATGTG
GTAGATGGATGAGGACATAG -> TAGATGGATGAGGACATAGC
GGGACAACCGAGTAGAGCCT -> GGACAACCGAGTAGAGCCTC
GCCAGGCCACGGATCACGGA -> CCAGGCCACGGATCACGGAA
TCATTGTCCCGTCTTATGCA -> CATTGTCCCGTCTTATGCAC
CTGACACCCAATCCAAACCT -> TGACACCCAATCCAAACCTA
TAGCGAAGGTCCGAAACCCT -> AGCGAAGGTCCGAAACCCTA
CAGAGCGCCCAGGAACCCTA -> AGAGCGCCCAGGAACCCTAA
TGGACGATAGGGCGGATTGC -> GGACGATAGGGCGGATTGCA
ATGATGTGAAATTGGCTCGC -> TGATGTGAAATTGGCTCGCC
CCAGTTGAAGCCTACGTCGA -> CAGTTGAAGCCTACGTCGAC
CTTTAGCCTTTCAGGTCGAC -> TTTAGCCTTTCAGGTCGACA
TCCGACTATCAATGTCCAGG -> CCGACTATCAATGTCCAGGG
AATCATATAAGACCTCTCCG -> ATCATATAAGACCTCTCCGT
TCGATACCGTAAATCATATA -> CGATACCGTAAATCATATAA
AGATAATAGTCAGCCAGGCC -> GATAATAGTCAGCCAGGCCA
GTCTCGCTTATGCATATGTC -> TCTCGCTTATGCATATGTCC
ACCCAGTAACCACTGACACC -> CCCAGTAACCACTGACACCC
AGTCCGGACCGGAGTCAACC -> GTCCGGACCGGAGTCAACCA
CAGTTGAAGCCTACGTCGAC -> AGTTGAAGCCTACGTCGACA
CCTAAAAGCTAAATAAAGGT -> CTAAAAGCTAAATAAAGGTG
CAATTAATTTGGAACGATTA -> AATTAATTTGGAACGATTAA
CGGAACTCCTTTCCGGGAAG -> GGAACTCCTTTCCGGGAAGA
GCAGGGTTGGACTCGTACGG -> CAGGGTTGGACTCGTACGGC
CACCCAATCCAAACCTATCG -> ACCCAATCCAAACCTATCGG
CGTCTCCCACAATGCACTCT -> GTCTCCCACAATGCACTCTC
TAAAGTTACTAAAGGCGTCT -> AAAGTTACTAAAGGCGTCTC
CACGGTAGGCACCCGTGACA -> ACGGTAGGCACCCGTGACAT
TACATTCAAGCCACTGTCAC -> ACATTCAAGCCACTGTCACT
CAATTTCTGCCTGCACCCGT -> AATTTCTGCCTGCACCCGTG
GAGAGCGAACAAATAATACA -> AGAGCGAACAAATAATACAT
CGGAACAGTCCGACTATCAA -> GGAACAGTCCGACTATCAAT
GGACGTACGCGGTCCCTTTA -> GACGTACGCGGTCCCTTTAG
GTCTTATGCACACCACCCAG -> TCTTATGCACACCACCCAGT
GCAGTCCTGTAAAGGGACGT -> CAGTCCTGTAAAGGGACGTA
CCCCGGCCGTGGGGAAAACC -> CCCGGCCGTGGGGAAAACCG
CCGTACCTTGTAAGTCGGCT -> CGTACCTTGTAAGTCGGCTT
AATCCTAGGCGCAATCGTGG -> ATCCTAGGCGCAATCGTGGA
GGTAGACCTGGACCCGCAGA -> GTAGACCTGGACCCGCAGAG
CGAACAAATAATACATTCAA -> GAACAAATAATACATTCAAG
CGAGCGTTCCGTACCAGTAG -> GAGCGTTCCGTACCAGTAGA
CTCTCCGTACGAAGCGTGAT -> TCTCCGTACGAAGCGTGATG
GACATATCTTTCAAAACTCT -> ACATATCTTTCAAAACTCTT
ACCGAGTAGAGCCTCATCAG -> CCGAGTAGAGCCTCATCAGT
ATGCACTCTCTTAGCACGAG -> TGCACTCTCTTAGCACGAGC
CAAACCTATCGGCGGTAGAC -> AAACCTATCGGCGGTAGACC
ACCCTCGCTAGATCGCAATG -> CCCTCGCTAGATCGCAATGT
ACCTCTCCGTACGAAGCGTG -> CCTCTCCGTACGAAGCGTGA
TTGCCCCGGCCGTGGGGAAA -> TGCCCCGGCCGTGGGGAAAA
AACCTATCGGCGGTAGACCT -> ACCTATCGGCGGTAGACCTG
GCATATGTCCCGTCGTGCAT -> CATATGTCCCGTCGTGCATT
CTGGACCCGCAGAGCGCCCA -> TGGACCCGCAGAGCGCCCAG
GGATCACGGAACTCCTTTCC -> GATCACGGAACTCCTTTCCG
GAACAAATAATACATTCAAG -> AACAAATAATACATTCAAGC
AGTAGATGGATGAGGACATA -> GTAGATGGATGAGGACATAG
GTGGGGAAAACCGAGGCGTA -> TGGGGAAAACCGAGGCGTAT
AATGATGTGAAATTGGCTCG -> ATGATGTGAAATTGGCTCGC
CCTTGCGTCGATACCGTAAA -> CTTGCGTCGATACCGTAAAT
GGATTGCACTCCAATTAATT -> GATTGCACTCCAATTAATTT
AAATCATATAAGACCTCTCC -> AATCATATAAGACCTCTCCG
TACCACGCGACGCAGTCCTG -> ACCACGCGACGCAGTCCTGT
TCTCCGTACGAAGCGTGATG -> CTCCGTACGAAGCGTGATGG
TACCGTACCTTGTAAGTCGG -> ACCGTACCTTGTAAGTCGGC
TCCTGTAAAGGGACGTACGC -> CCTGTAAAGGGACGTACGCG
AATGCACTCTCTTAGCACGA -> ATGCACTCTCTTAGCACGAG
CCACGCGACGCAGTCCTGTA -> CACGCGACGCAGTCCTGTAA
AGGGACCCTCGCTAGATCGC -> GGGACCCTCGCTAGATCGCA
ATTCCTAAGCCAGAACAGGT -> TTCCTAAGCCAGAACAGGTA
TGTTGCCCCGGCCGTGGGGA -> GTTGCCCCGGCCGTGGGGAA
GATGGATGAGGACATAGCAT -> ATGGATGAGGACATAGCATC
TAAATAAAGGTGCGTCTCGC -> AAATAAAGGTGCGTCTCGCT
GACGGCTAGGGGGCGTTGCA -> ACGGCTAGGGGGCGTTGCAC
GCGTATAAAGTTACTAAAGG -> CGTATAAAGTTACTAAAGGC
CGTTCCGTACCAGTAGATGG -> GTTCCGTACCAGTAGATGGA
GCGGTAGACCTGGACCCGCA -> CGGTAGACCTGGACCCGCAG
TGAGGACATAGCATCGGACC -> GAGGACATAGCATCGGACCT
ACGCAGTCCTGTAAAGGGAC -> CGCAGTCCTGTAAAGGGACG
CACCATCGCACTCAGGACGG -> ACCATCGCACTCAGGACGGC
GCGTGATGGATAGGTGTTCA -> CGTGATGGATAGGTGTTCAC
ACCGGAGTCAACCAGTGGGA -> CCGGAGTCAACCAGTGGGAC
GTAGAGCCTCATCAGTCAGA -> TAGAGCCTCATCAGTCAGAA
AGGCGTATAAAGTTACTAAA -> GGCGTATAAAGTTACTAAAG
TATCGGCGGTAGACCTGGAC -> ATCGGCGGTAGACCTGGACC
GAGCCTCATCAGTCAGAATG -> AGCCTCATCAGTCAGAATGA
AGAATGAATGTTTTGCCAAT -> GAATGAATGTTTTGCCAATA
GGTGCGTCTCGCTTATGCAT -> GTGCGTCTCGCTTATGCATA
CGTACCAGTAGATGGATGAG -> GTACCAGTAGATGGATGAGG
ACCGAGGCGTATAAAGTTAC -> CCGAGGCGTATAAAGTTACT
TCGGCTTCACCATCGCACTC -> CGGCTTCACCATCGCACTCA
TTGGAACGATTAATACCAGT -> TGGAACGATTAATACCAGTT
CCCACAATGCACTCTCTTAG -> CCACAATGCACTCTCTTAGC
CAGGTCGACACGAACGGATA -> AGGTCGACACGAACGGATAC
ATGAATGTTTTGCCAATAAA -> TGAATGTTTTGCCAATAAAA
GCTCGCCCCTCTCCGAGAGC -> CTCGCCCCTCTCCGAGAGCG
TTATGCATATGTCCCGTCGT -> TATGCATATGTCCCGTCGTG
TCGCACTCAGGACGGCTAGG -> CGCACTCAGGACGGCTAGGG
GAAGAAACAACGGTAAGAGA -> AAGAAACAACGGTAAGAGAA
GCACTCTCTTAGCACGAGCG -> CACTCTCTTAGCACGAGCGT
AGGGTTGGACTCGTACGGCC -> GGGTTGGACTCGTACGGCCA
CTAAGCCAGAACAGGTAGCG -> TAAGCCAGAACAGGTAGCGA
CACTGCAATTTCTGCCTGCA -> ACTGCAATTTCTGCCTGCAC
ATCAATGTCCAGGGACCCTC -> TCAATGTCCAGGGACCCTCG
TCCCGTCGTGCATTTTAGTC -> CCCGTCGTGCATTTTAGTCC
GAGCGACATATCTTTCAAAA -> AGCGACATATCTTTCAAAAC
CCTCGCTAGATCGCAATGTG -> CTCGCTAGATCGCAATGTGA
ATCGGCGGTAGACCTGGACC -> TCGGCGGTAGACCTGGACCC
GAACGGATACCAGACCCCCA -> AACGGATACCAGACCCCCAG
GAAACCCTAAAAGCTAAATA -> AAACCCTAAAAGCTAAATAA
AACTCCTTTCCGGGAAGAAA -> ACTCCTTTCCGGGAAGAAAC
ATCCAAACCTATCGGCGGTA -> TCCAAACCTATCGGCGGTAG
AGGGACGTACGCGGTCCCTT -> GGGACGTACGCGGTCCCTTT
TAAGAGAAAGATCGGAACAG -> AAGAGAAAGATCGGAACAGT
CTTGTAAGTCGGCTTCACCA -> TTGTAAGTCGGCTTCACCAT
AAAATCCTAGGCGCAATCGT -> AAATCCTAGGCGCAATCGTG
TCGGAACAGTCCGACTATCA -> CGGAACAGTCCGACTATCAA
TACCAGTTGAAGCCTACGTC -> ACCAGTTGAAGCCTACGTCG
AGGCACCCGTGACATGCAGG -> GGCACCCGTGACATGCAGGG
GAACAGTCCGACTATCAATG -> AACAGTCCGACTATCAATGT
CATGCAGGGTTGGACTCGTA -> ATGCAGGGTTGGACTCGTAC
AAGATCGGAACAGTCCGACT -> AGATCGGAACAGTCCGACTA
CCAGGGACCCTCGCTAGATC -> CAGGGACCCTCGCTAGATCG
AGATCGGAACAGTCCGACTA -> GATCGGAACAGTCCGACTAT
GACTCGTACGGCCATTAGAA -> ACTCGTACGGCCATTAGAAT
TGGGGAAAACCGAGGCGTAT -> GGGGAAAACCGAGGCGTATA
CAGATAATAGTCAGCCAGGC -> AGATAATAGTCAGCCAGGCC
TAGTCAGCCAGGCCACGGAT -> AGTCAGCCAGGCCACGGATC
AGCCAGAACAGGTAGCGAAG -> GCCAGAACAGGTAGCGAAGG
TTCATTGTCCCGTCTTATGC -> TCATTGTCCCGTCTTATGCA
CGGTAGACCTGGACCCGCAG -> GGTAGACCTGGACCCGCAGA
CGAAGGTCCGAAACCCTAAA -> GAAGGTCCGAAACCCTAAAA
TCAAAACTCTTTCGGCTGAC -> CAAAACTCTTTCGGCTGACA
ACCTTGCGTCGATACCGTAA -> CCTTGCGTCGATACCGTAAA
CTGTAAAGGGACGTACGCGG -> TGTAAAGGGACGTACGCGGT
AATAATACATTCAAGCCACT -> ATAATACATTCAAGCCACTG
ATCCTAGGCGCAATCGTGGA -> TCCTAGGCGCAATCGTGGAT
CGCAATGTGAGAGCGAACAA -> GCAATGTGAGAGCGAACAAA
CAACCGAGTAGAGCCTCATC -> AACCGAGTAGAGCCTCATCA
GACATGCAGGGTTGGACTCG -> ACATGCAGGGTTGGACTCGT
CCGCAGAGCGCCCAGGAACC -> CGCAGAGCGCCCAGGAACCC
CTGCAATTTCTGCCTGCACC -> TGCAATTTCTGCCTGCACCC
TAGTTCATTGTCCCGTCTTA -> AGTTCATTGTCCCGTCTTAT
TAAATCATATAAGACCTCTC -> AAATCATATAAGACCTCTCC
GCCTCATCAGTCAGAATGAT -> CCTCATCAGTCAGAATGATG
TTCGGCTGACAAGCATGCTT -> TCGGCTGACAAGCATGCTTG
TACCTTGTAAGTCGGCTTCA -> ACCTTGTAAGTCGGCTTCAC
GATACCAGACCCCCAGATAA -> ATACCAGACCCCCAGATAAT
TGTCCCGTCGTGCATTTTAG -> GTCCCGTCGTGCATTTTAGT
GACGCAGTCCTGTAAAGGGA -> ACGCAGTCCTGTAAAGGGAC
ATGTCCAGGGACCCTCGCTA -> TGTCCAGGGACCCTCGCTAG
TCGTACGGCCATTAGAATGA -> CGTACGGCCATTAGAATGAA
CTCAGGACGGCTAGGGGGCG -> TCAGGACGGCTAGGGGGCGT
CCCAGTAACCACTGACACCC -> CCAGTAACCACTGACACCCA
GTCCGAAACCCTAAAAGCTA -> TCCGAAACCCTAAAAGCTAA
CCAGACCCCCAGATAATAGT -> CAGACCCCCAGATAATAGTC
CATTGTCCCGTCTTATGCAC -> ATTGTCCCGTCTTATGCACA
GGATGAGGACATAGCATCGG -> GATGAGGACATAGCATCGGA
TTAGCACGAGCGTTCCGTAC -> TAGCACGAGCGTTCCGTACC
ATACCGTAAATCATATAAGA -> TACCGTAAATCATATAAGAC
CCACCCAGTAACCACTGACA -> CACCCAGTAACCACTGACAC
AAAACTCTTTCGGCTGACAA -> AAACTCTTTCGGCTGACAAG
CCTTGTAAGTCGGCTTCACC -> CTTGTAAGTCGGCTTCACCA
GGTAGCGAAGGTCCGAAACC -> GTAGCGAAGGTCCGAAACCC
TAGTCCGGACCGGAGTCAAC -> AGTCCGGACCGGAGTCAACC
CAGTCAGAATGATGTGAAAT -> AGTCAGAATGATGTGAAATT
TACGCGGTCCCTTTAGCCTT -> ACGCGGTCCCTTTAGCCTTT
CAAGCCACTGTCACTACCGT -> AAGCCACTGTCACTACCGTA
TGAGAGCGAACAAATAATAC -> GAGAGCGAACAAATAATACA
CCAGTAACCACTGACACCCA -> CAGTAACCACTGACACCCAA
GCAATTTCTGCCTGCACCCG -> CAATTTCTGCCTGCACCCGT
AATTTCTGCCTGCACCCGTG -> ATTTCTGCCTGCACCCGTGT
AAGCCACTGTCACTACCGTA -> AGCCACTGTCACTACCGTAC
CTCCTTTCCGGGAAGAAACA -> TCCTTTCCGGGAAGAAACAA
CAAGCATGCTTGTTGCCCCG -> AAGCATGCTTGTTGCCCCGG
GACCCGCAGAGCGCCCAGGA -> ACCCGCAGAGCGCCCAGGAA
TAGAATGAATGTTTTGCCAA -> AGAATGAATGTTTTGCCAAT
GAAAGATCGGAACAGTCCGA -> AAAGATCGGAACAGTCCGAC
AAAAGCTAAATAAAGGTGCG -> AAAGCTAAATAAAGGTGCGT
GATTAATACCAGTTGAAGCC -> ATTAATACCAGTTGAAGCCT
CAATCCAAACCTATCGGCGG -> AATCCAAACCTATCGGCGGT
GTACCAGTAGATGGATGAGG -> TACCAGTAGATGGATGAGGA
CAGAACAGGTAGCGAAGGTC -> AGAACAGGTAGCGAAGGTCC
TGCACCCGTGTCAGTAGTTC -> GCACCCGTGTCAGTAGTTCA
GACCCCCAGATAATAGTCAG -> ACCCCCAGATAATAGTCAGC
AGAGCGACATATCTTTCAAA -> GAGCGACATATCTTTCAAAA
GGATTCCTAAGCCAGAACAG -> GATTCCTAAGCCAGAACAGG
GCCCCTCTCCGAGAGCGACA -> CCCCTCTCCGAGAGCGACAT
CGAGAGCGACATATCTTTCA -> GAGAGCGACATATCTTTCAA
CCAGTAGATGGATGAGGACA -> CAGTAGATGGATGAGGACAT
TGCCTGCACCCGTGTCAGTA -> GCCTGCACCCGTGTCAGTAG
AGGCGTCTCCCACAATGCAC -> GGCGTCTCCCACAATGCACT
CGTCGATACCGTAAATCATA -> GTCGATACCGTAAATCATAT
GGGACGTACGCGGTCCCTTT -> GGACGTACGCGGTCCCTTTA
CTTGTTGCCCCGGCCGTGGG -> TTGTTGCCCCGGCCGTGGGG
GTAGCGAAGGTCCGAAACCC -> TAGCGAAGGTCCGAAACCCT
ACGTACGCGGTCCCTTTAGC -> CGTACGCGGTCCCTTTAGCC
GGCTTCACCATCGCACTCAG -> GCTTCACCATCGCACTCAGG
ACCACGCGACGCAGTCCTGT -> CCACGCGACGCAGTCCTGTA
CTAAATAAAGGTGCGTCTCG -> TAAATAAAGGTGCGTCTCGC
CCCGTCGTGCATTTTAGTCC -> CCGTCGTGCATTTTAGTCCG
CCGACTATCAATGTCCAGGG -> CGACTATCAATGTCCAGGGA
ACAACGGTAAGAGAAAGATC -> CAACGGTAAGAGAAAGATCG
AACGATTAATACCAGTTGAA -> ACGATTAATACCAGTTGAAG
GTGAGAGCGAACAAATAATA -> TGAGAGCGAACAAATAATAC
TCCGGGAAGAAACAACGGTA -> CCGGGAAGAAACAACGGTAA
CCCCTCTCCGAGAGCGACAT -> CCCTCTCCGAGAGCGACATA
TTAGCCTTTCAGGTCGACAC -> TAGCCTTTCAGGTCGACACG
CCGTAAATCATATAAGACCT -> CGTAAATCATATAAGACCTC
AACCCTAAAAGCTAAATAAA -> ACCCTAAAAGCTAAATAAAG
TCTTTCGGCTGACAAGCATG -> CTTTCGGCTGACAAGCATGC
AACCGAGTAGAGCCTCATCA -> ACCGAGTAGAGCCTCATCAG
CGATAGGGCGGATTGCACTC -> GATAGGGCGGATTGCACTCC
CTCTCTTAGCACGAGCGTTC -> TCTCTTAGCACGAGCGTTCC
ATACCAGACCCCCAGATAAT -> TACCAGACCCCCAGATAATA
ACCCCCAGATAATAGTCAGC -> CCCCCAGATAATAGTCAGCC
CTCTTAGCACGAGCGTTCCG -> TCTTAGCACGAGCGTTCCGT
CGGAGTCAACCAGTGGGACA -> GGAGTCAACCAGTGGGACAA
TGTTTTGCCAATAAAATACC -> GTTTTGCCAATAAAATACCA
ACATGCAGGGTTGGACTCGT -> CATGCAGGGTTGGACTCGTA
CTACCGTACCTTGTAAGTCG -> TACCGTACCTTGTAAGTCGG
CGGCTGACAAGCATGCTTGT -> GGCTGACAAGCATGCTTGTT
AGGCGCAATCGTGGATTCCT -> GGCGCAATCGTGGATTCCTA
GACACGAACGGATACCAGAC -> ACACGAACGGATACCAGACC
ACCTGGACCCGCAGAGCGCC -> CCTGGACCCGCAGAGCGCCC
TAGGCGCAATCGTGGATTCC -> AGGCGCAATCGTGGATTCCT
ATGTGAAATTGGCTCGCCCC -> TGTGAAATTGGCTCGCCCCT
GGCCATTAGAATGAATGTTT -> GCCATTAGAATGAATGTTTT
ACGATTAATACCAGTTGAAG -> CGATTAATACCAGTTGAAGC
GTCCAGGGACCCTCGCTAGA -> TCCAGGGACCCTCGCTAGAT
AGTTCATTGTCCCGTCTTAT -> GTTCATTGTCCCGTCTTATG
AAGCTAAATAAAGGTGCGTC -> AGCTAAATAAAGGTGCGTCT
CACACCACCCAGTAACCACT -> ACACCACCCAGTAACCACTG
GATTCCTAAGCCAGAACAGG -> ATTCCTAAGCCAGAACAGGT
GCTGACAAGCATGCTTGTTG -> CTGACAAGCATGCTTGTTGC
CAGGTAGCGAAGGTCCGAAA -> AGGTAGCGAAGGTCCGAAAC
ACCAGACCCCCAGATAATAG -> CCAGACCCCCAGATAATAGT
GGACAACCGAGTAGAGCCTC -> GACAACCGAGTAGAGCCTCA
ACAACCGAGTAGAGCCTCAT -> CAACCGAGTAGAGCCTCATC
GTCGACATAAAAATCCTAGG -> TCGACATAAAAATCCTAGGC
CCCTTTAGCCTTTCAGGTCG -> CCTTTAGCCTTTCAGGTCGA
TCACTACCGTACCTTGTAAG -> CACTACCGTACCTTGTAAGT
TGTGGACGATAGGGCGGATT -> GTGGACGATAGGGCGGATTG
GATCACGGAACTCCTTTCCG -> ATCACGGAACTCCTTTCCGG
TATCTTTCAAAACTCTTTCG -> ATCTTTCAAAACTCTTTCGG
TTTGCCAATAAAATACCACG -> TTGCCAATAAAATACCACGC
CGTGTCAGTAGTTCATTGTC -> GTGTCAGTAGTTCATTGTCC
CGTGGATTCCTAAGCCAGAA -> GTGGATTCCTAAGCCAGAAC
TCGGACCTTGCGTCGATACC -> CGGACCTTGCGTCGATACCG
CCACAATGCACTCTCTTAGC -> CACAATGCACTCTCTTAGCA
GTCTCCCACAATGCACTCTC -> TCTCCCACAATGCACTCTCT
TCAACCAGTGGGACAACCGA -> CAACCAGTGGGACAACCGAG
ATATAAGACCTCTCCGTACG -> TATAAGACCTCTCCGTACGA
GTGGATTCCTAAGCCAGAAC -> TGGATTCCTAAGCCAGAACA
TGTGAAATTGGCTCGCCCCT -> GTGAAATTGGCTCGCCCCTC
AATTAATTTGGAACGATTAA -> ATTAATTTGGAACGATTAAT
GGAAGAAACAACGGTAAGAG -> GAAGAAACAACGGTAAGAGA
CAAAACTCTTTCGGCTGACA -> AAAACTCTTTCGGCTGACAA
TGGACCCGCAGAGCGCCCAG -> GGACCCGCAGAGCGCCCAGG
ACTGTCACTACCGTACCTTG -> CTGTCACTACCGTACCTTGT
GTCAACCAGTGGGACAACCG -> TCAACCAGTGGGACAACCGA
ACTGACACCCAATCCAAACC -> CTGACACCCAATCCAAACCT
CTGACAAGCATGCTTGTTGC -> TGACAAGCATGCTTGTTGCC
TACGTCGACATAAAAATCCT -> ACGTCGACATAAAAATCCTA
TTGTGGACGATAGGGCGGAT -> TGTGGACGATAGGGCGGATT
GTCCCGTCTTATGCACACCA -> TCCCGTCTTATGCACACCAC
AAATTGGCTCGCCCCTCTCC -> AATTGGCTCGCCCCTCTCCG
CCTCTCCGAGAGCGACATAT -> CTCTCCGAGAGCGACATATC
ACAAGCATGCTTGTTGCCCC -> CAAGCATGCTTGTTGCCCCG
TCATATAAGACCTCTCCGTA -> CATATAAGACCTCTCCGTAC
CCGAGGCGTATAAAGTTACT -> CGAGGCGTATAAAGTTACTA
AGTCCTGTAAAGGGACGTAC -> GTCCTGTAAAGGGACGTACG
CCTGTAAAGGGACGTACGCG -> CTGTAAAGGGACGTACGCGG
GGACCTTGCGTCGATACCGT -> GACCTTGCGTCGATACCGTA
CATATCTTTCAAAACTCTTT -> ATATCTTTCAAAACTCTTTC
GCATGCTTGTTGCCCCGGCC -> CATGCTTGTTGCCCCGGCCG
CCAGAACAGGTAGCGAAGGT -> CAGAACAGGTAGCGAAGGTC
GGACTCGTACGGCCATTAGA -> GACTCGTACGGCCATTAGAA
TAAGTCGGCTTCACCATCGC -> AAGTCGGCTTCACCATCGCA
GTTGCACTGCAATTTCTGCC -> TTGCACTGCAATTTCTGCCT
GTTGCCCCGGCCGTGGGGAA -> TTGCCCCGGCCGTGGGGAAA
AAAGGGACGTACGCGGTCCC -> AAGGGACGTACGCGGTCCCT
AAGCCAGAACAGGTAGCGAA -> AGCCAGAACAGGTAGCGAAG
TAAAGGCGTCTCCCACAATG -> AAAGGCGTCTCCCACAATGC
CCGAGAGCGACATATCTTTC -> CGAGAGCGACATATCTTTCA
CGGGAAGAAACAACGGTAAG -> GGGAAGAAACAACGGTAAGA
GTAAGTCGGCTTCACCATCG -> TAAGTCGGCTTCACCATCGC
TAAAATACCACGCGACGCAG -> AAAATACCACGCGACGCAGT
CCGTACGAAGCGTGATGGAT -> CGTACGAAGCGTGATGGATA
AGGTAGCGAAGGTCCGAAAC -> GGTAGCGAAGGTCCGAAACC
CAGAATGATGTGAAATTGGC -> AGAATGATGTGAAATTGGCT
ACTCCAATTAATTTGGAACG -> CTCCAATTAATTTGGAACGA
TGCAGGGTTGGACTCGTACG -> GCAGGGTTGGACTCGTACGG
CCGTGTCAGTAGTTCATTGT -> CGTGTCAGTAGTTCATTGTC
GATGGATAGGTGTTCACGGT -> ATGGATAGGTGTTCACGGTA
GTGTCAGTAGTTCATTGTCC -> TGTCAGTAGTTCATTGTCCC
ACGTCGACATAAAAATCCTA -> CGTCGACATAAAAATCCTAG
AGTAGAGCCTCATCAGTCAG -> GTAGAGCCTCATCAGTCAGA
AGGCCACGGATCACGGAACT -> GGCCACGGATCACGGAACTC
CCCGTGACATGCAGGGTTGG -> CCGTGACATGCAGGGTTGGA
ACATAGCATCGGACCTTGCG -> CATAGCATCGGACCTTGCGT
AGGGCGGATTGCACTCCAAT -> GGGCGGATTGCACTCCAATT
GCTTATGCATATGTCCCGTC -> CTTATGCATATGTCCCGTCG
ACCCGTGTCAGTAGTTCATT -> CCCGTGTCAGTAGTTCATTG
GCACCCGTGACATGCAGGGT -> CACCCGTGACATGCAGGGTT
CTATCAATGTCCAGGGACCC -> TATCAATGTCCAGGGACCCT