AAAAACAGATC -> AAAACAGATCA
AAAAACATCAA -> AAAACATCAAC
AAAAATGCACC -> AAAATGCACCT
AAAACAATTAC -> AAACAATTACT
AAAACACCACT -> AAACACCACTA
AAAACAGATCA -> AAACAGATCAG
AAAACATCAAC -> AAACATCAACC
AAAAGAACCTA -> AAAGAACCTAT
AAAATGCACCT -> AAATGCACCTC
AAACAATTACT -> AACAATTACTC
AAACACCACTA -> AACACCACTAG
AAACAGATCAG -> AACAGATCAGG
AAACATCAACC -> AACATCAACCA
AAACCAAACGC -> AACCAAACGCA
AAACCAACTGT -> AACCAACTGTG
AAACCTAAAGA -> AACCTAAAGAA
AAACGCAGGGA -> AACGCAGGGAG
AAACTCCTTCC -> AACTCCTTCCG
AAAGAAAACAC -> AAGAAAACACC
AAAGAACCTAT -> AAGAACCTATG
AAAGAACTCGA -> AAGAACTCGAT
AAAGCCCCGTG -> AAGCCCCGTGA
AAAGTAGCGGC -> AAGTAGCGGCC
AAATACAATAA -> AATACAATAAG
AAATGCAATCC -> AATGCAATCCA
AAATGCACCTC -> AATGCACCTCA
AAATGCCCTCA -> AATGCCCTCAT
AAATTGCTAGG -> AATTGCTAGGG
AACAAGCCATC -> ACAAGCCATCT
AACAATTACTC -> ACAATTACTCA
AACACCACTAG -> ACACCACTAGA
AACACGAATCG -> ACACGAATCGA
AACAGATCAGG -> ACAGATCAGGG
AACAGCGGTGT -> ACAGCGGTGTA
AACAGGTGCTT -> ACAGGTGCTTG
AACATAGCTAA -> ACATAGCTAAG
AACATCAACCA -> ACATCAACCAG
AACATGTCTCG -> ACATGTCTCGT
AACATTCAAGT -> ACATTCAAGTG
AACATTGGGAG -> ACATTGGGAGT
AACCAAACGCA -> ACCAAACGCAG
AACCAACTGTG -> ACCAACTGTGA
AACCAGCGATT -> ACCAGCGATTC
AACCATCTTCA -> ACCATCTTCAC
AACCATGGTGT -> ACCATGGTGTC
AACCCGTCTCA -> ACCCGTCTCAG
AACCCTGCGGC -> ACCCTGCGGCA
AACCCTTCGGG -> ACCCTTCGGGC
AACCGGGACTT -> ACCGGGACTTC
AACCGTGTTCG -> ACCGTGTTCGC
AACCGTTACAA -> ACCGTTACAAT
AACCTAAAGAA -> ACCTAAAGAAC
AACCTATGAAT -> ACCTATGAATG
AACCTCCTGCC -> ACCTCCTGCCG
AACCTGCTCCA -> ACCTGCTCCAG
AACCTTTCCCT -> ACCTTTCCCTC
AACGCAGGGAG -> ACGCAGGGAGT
AACGGGCTCAG -> ACGGGCTCAGC
AACGTACTACA -> ACGTACTACAG
AACGTTGGGGT -> ACGTTGGGGTT
AACTCCTTCCG -> ACTCCTTCCGA
AACTCGATCCT -> ACTCGATCCTC
AACTGCAAAAA -> ACTGCAAAAAT
AACTGTGACAG -> ACTGTGACAGA
AAGAAAACACC -> AGAAAACACCA
AAGAACCTATG -> AGAACCTATGA
AAGAACTCGAT -> AGAACTCGATC
AAGACATCACT -> AGACATCACTA
AAGACGTGTGG -> AGACGTGTGGC
AAGACTCGTTG -> AGACTCGTTGC
AAGAGGGTGAA -> AGAGGGTGAAT
AAGAGTCGGCG -> AGAGTCGGCGA
AAGATTTAACA -> AGATTTAACAT
AAGCACACGCC -> AGCACACGCCT
AAGCACCGGCC -> AGCACCGGCCT
AAGCCATCTCC -> AGCCATCTCCA
AAGCCCCAAGT -> AGCCCCAAGTA
AAGCCCCGTGA -> AGCCCCGTGAT
AAGCCGGTGCC -> AGCCGGTGCCG
AAGCTCAGAGG -> AGCTCAGAGGG
AAGCTCTCGTG -> AGCTCTCGTGT
AAGGACCCTAA -> AGGACCCTAAT
AAGGAGATGCA -> AGGAGATGCAG
AAGGCCAACAA -> AGGCCAACAAG
AAGGCTTGCTC -> AGGCTTGCTCC
AAGTAAAGTAG -> AGTAAAGTAGC
AAGTACGAGGA -> AGTACGAGGAA
AAGTACTGCAC -> AGTACTGCACA
AAGTAGCGGCC -> AGTAGCGGCCT
AAGTGGTCGCC -> AGTGGTCGCCT
AATAAGACATC -> ATAAGACATCA
AATACAATAAG -> ATACAATAAGA
AATACAGGCCA -> ATACAGGCCAA
AATACCAAACT -> ATACCAAACTC
AATACGAGGCG -> ATACGAGGCGT
AATAGACTCAT -> ATAGACTCATA
AATAGCAATCG -> ATAGCAATCGT
AATATATTTTT -> ATATATTTTTC
AATATCTCCGG -> ATATCTCCGGA
AATCACGTTTT -> ATCACGTTTTT
AATCCACCTAA -> ATCCACCTAAA
AATCGATCTTG -> ATCGATCTTGT
AATCGCGGTGG -> ATCGCGGTGGT
AATCGCTGAAC -> ATCGCTGAACC
AATCGGGAGTA -> ATCGGGAGTAA
AATCGTGAGCA -> ATCGTGAGCAT
AATCTTCACTG -> ATCTTCACTGG
AATGCAATCCA -> ATGCAATCCAC
AATGCACCTCA -> ATGCACCTCAT
AATGCCAGCAG -> ATGCCAGCAGC
AATGCCCTCAT -> ATGCCCTCATT
AATGCTCCTCG -> ATGCTCCTCGA
AATGCTTAATG -> ATGCTTAATGC
AATGGGCATTC -> ATGGGCATTCC
AATGGGTAAAT -> ATGGGTAAATG
AATGTCTCGAT -> ATGTCTCGATG
AATGTGGCTTA -> ATGTGGCTTAA
AATTAAGCTCA -> ATTAAGCTCAG
AATTACTCATA -> ATTACTCATAC
AATTAGATAGT -> ATTAGATAGTT
AATTAGTACGC -> ATTAGTACGCA
AATTCGTCGTT -> ATTCGTCGTTT
AATTGAAACCA -> ATTGAAACCAA
AATTGCTAGGG -> ATTGCTAGGGC
AATTGGACGCC -> ATTGGACGCCC
AATTTGCTTGA -> ATTTGCTTGAA
ACAACCTGCTC -> CAACCTGCTCC
ACAAGCACCGG -> CAAGCACCGGC
ACAAGCCATCT -> CAAGCCATCTC
ACAATAAGACA -> CAATAAGACAT
ACAATACCAAA -> CAATACCAAAC
ACAATCGCTGA -> CAATCGCTGAA
ACAATTACTCA -> CAATTACTCAT
ACAATTAGATA -> CAATTAGATAG
ACACATGGTCT -> CACATGGTCTA
ACACCACTAGA -> CACCACTAGAC
ACACCTTAACC -> CACCTTAACCG
ACACGAATCGA -> CACGAATCGAT
ACACGCCTCCG -> CACGCCTCCGA
ACACTGTAAGG -> CACTGTAAGGA
ACAGAAGCACA -> CAGAAGCACAC
ACAGACAACCT -> CAGACAACCTG
ACAGATAGCCG -> CAGATAGCCGT
ACAGATCAGGG -> CAGATCAGGGC
ACAGATGAATT -> CAGATGAATTC
ACAGCGGTGTA -> CAGCGGTGTAG
ACAGGAGGTGT -> CAGGAGGTGTG
ACAGGCCAAAA -> CAGGCCAAAAA
ACAGGCTTTGC -> CAGGCTTTGCC
ACAGGTGCTTG -> CAGGTGCTTGC
ACATAGATTTC -> CATAGATTTCA
ACATAGCTAAG -> CATAGCTAAGA
ACATCAACCAG -> CATCAACCAGC
ACATCACTAAC -> CATCACTAACC
ACATGGTCTAG -> CATGGTCTAGA
ACATGTCTCGT -> CATGTCTCGTA
ACATTAGGCTA -> CATTAGGCTAG
ACATTCAAGTG -> CATTCAAGTGG
ACATTGGGAGT -> CATTGGGAGTG
ACCAAACGCAG -> CCAAACGCAGG
ACCAAACTCCT -> CCAAACTCCTT
ACCAACTGTGA -> CCAACTGTGAC
ACCACACCTTA -> CCACACCTTAA
ACCACTAGACC -> CCACTAGACCG
ACCAGATTCCA -> CCAGATTCCAC
ACCAGCGATTC -> CCAGCGATTCC
ACCAGTGTACC -> CCAGTGTACCG
ACCATCGCAGG -> CCATCGCAGGT
ACCATCTTCAC -> CCATCTTCACA
ACCATGGTGTC -> CCATGGTGTCG
ACCCAAAAGAA -> CCCAAAAGAAC
ACCCAGATGCG -> CCCAGATGCGA
ACCCCCAACCG -> CCCCCAACCGT
ACCCCCTAGTA -> CCCCCTAGTAG
ACCCGTCTCAG -> CCCGTCTCAGG
ACCCTAATGGG -> CCCTAATGGGT
ACCCTGCGGCA -> CCCTGCGGCAT
ACCCTTCGGGC -> CCCTTCGGGCA
ACCGATGATGG -> CCGATGATGGC
ACCGCGATTAT -> CCGCGATTATA
ACCGGCATTCG -> CCGGCATTCGC
ACCGGCCTGTA -> CCGGCCTGTAT
ACCGGGACTTC -> CCGGGACTTCT
ACCGTCGACGA -> CCGTCGACGAC
ACCGTGCGCTA -> CCGTGCGCTAA
ACCGTGTTCGC -> CCGTGTTCGCT
ACCGTTACAAT -> CCGTTACAATT
ACCGTTATGTT -> CCGTTATGTTC
ACCTAAAGAAC -> CCTAAAGAACT
ACCTAAATTGC -> CCTAAATTGCT
ACCTAACTGCA -> CCTAACTGCAA
ACCTATGAATG -> CCTATGAATGT
ACCTCATCTCT -> CCTCATCTCTG
ACCTCCTGCCG -> CCTCCTGCCGC
ACCTCGAATTT -> CCTCGAATTTG
ACCTGATGCCA -> CCTGATGCCAC
ACCTGCTCCAG -> CCTGCTCCAGA
ACCTTAACCGT -> CCTTAACCGTG
ACCTTTCCCTC -> CCTTTCCCTCC
ACCTTTTACCT -> CCTTTTACCTG
ACGAAGTACTG -> CGAAGTACTGC
ACGAATCGATC -> CGAATCGATCT
ACGACGGTTGC -> CGACGGTTGCG
ACGAGGAACCC -> CGAGGAACCCT
ACGAGGCGTAA -> CGAGGCGTAAC
ACGCAAGATTT -> CGCAAGATTTA
ACGCACGGTTG -> CGCACGGTTGC
ACGCAGGGAGT -> CGCAGGGAGTT
ACGCATTCACC -> CGCATTCACCC
ACGCCCGAGGG -> CGCCCGAGGGC
ACGCCTCCGAG -> CGCCTCCGAGG
ACGCTCATAGG -> CGCTCATAGGG
ACGCTTCGAAT -> CGCTTCGAATA
ACGGGCTCAGC -> CGGGCTCAGCT
ACGGGGAGTAA -> CGGGGAGTAAG
ACGGTGCTAGG -> CGGTGCTAGGG
ACGGTTGCAGT -> CGGTTGCAGTG
ACGGTTGCGAT -> CGGTTGCGATT
ACGTACTACAG -> CGTACTACAGG
ACGTGTATCCA -> CGTGTATCCAC
ACGTGTGGCCA -> CGTGTGGCCAC
ACGTTGGGGTT -> CGTTGGGGTTT
ACGTTTTTTGT -> CGTTTTTTGTT
ACTAACCGGGA -> CTAACCGGGAC
ACTAAGGCCAA -> CTAAGGCCAAC
ACTACAGGAGG -> CTACAGGAGGT
ACTAGACCGAT -> CTAGACCGATG
ACTCAAATACA -> CTCAAATACAA
ACTCATACTTT -> CTCATACTTTC
ACTCATATTTA -> CTCATATTTAA
ACTCCGTCAGA -> CTCCGTCAGAT
ACTCCTTCCGA -> CTCCTTCCGAC
ACTCGATCCTC -> CTCGATCCTCG
ACTCGGTTTCC -> CTCGGTTTCCT
ACTCGTTGCTC -> CTCGTTGCTCA
ACTCTTGACTT -> CTCTTGACTTT
ACTGACCAGAT -> CTGACCAGATT
ACTGATTGCAT -> CTGATTGCATA
ACTGCAAAAAT -> CTGCAAAAATG
ACTGCACATAG -> CTGCACATAGA
ACTGCGGTCAC -> CTGCGGTCACC
ACTGGCAAGTA -> CTGGCAAGTAC
ACTGTAAGGAG -> CTGTAAGGAGA
ACTGTGACAGA -> CTGTGACAGAT
ACTTAACCTCC -> CTTAACCTCCT
ACTTCTAAGGC -> CTTCTAAGGCT
ACTTGCAGCAT -> CTTGCAGCATG
ACTTGCGGATT -> CTTGCGGATTT
ACTTTCAATCG -> CTTTCAATCGG
ACTTTCGCTCC -> CTTTCGCTCCA
AGAAAACACCA -> GAAAACACCAC
AGAACCTATGA -> GAACCTATGAA
AGAACTCGATC -> GAACTCGATCC
AGAAGAGGGTG -> GAAGAGGGTGA
AGAAGCACACG -> GAAGCACACGC
AGAATACAGGC -> GAATACAGGCC
AGAATATCTCC -> GAATATCTCCG
AGAATGCCAGC -> GAATGCCAGCA
AGACAACCTGC -> GACAACCTGCT
AGACAAGCACC -> GACAAGCACCG
AGACAGATGAA -> GACAGATGAAT
AGACATCACTA -> GACATCACTAA
AGACCGATGAT -> GACCGATGATG
AGACCTTTTAC -> GACCTTTTACC
AGACGCTCATA -> GACGCTCATAG
AGACGTGTGGC -> GACGTGTGGCC
AGACTCATATT -> GACTCATATTT
AGACTCGTTGC -> GACTCGTTGCT
AGACTGACCAG -> GACTGACCAGA
AGACTTAACCT -> GACTTAACCTC
AGAGGGCTTGA -> GAGGGCTTGAA
AGAGGGTGAAT -> GAGGGTGAATG
AGAGTCGGCGA -> GAGTCGGCGAA
AGATAGCAGGA -> GATAGCAGGAG
AGATAGCCGTA -> GATAGCCGTAG
AGATAGTTCTT -> GATAGTTCTTT
AGATCAGGGCC -> GATCAGGGCCC
AGATGAATTCG -> GATGAATTCGT
AGATGATCTGG -> GATGATCTGGG
AGATGCAGGCC -> GATGCAGGCCT
AGATGCGATTT -> GATGCGATTTA
AGATTCCACGG -> GATTCCACGGG
AGATTTAACAT -> GATTTAACATA
AGATTTCAATT -> GATTTCAATTG
AGCAATCGTGA -> GCAATCGTGAG
AGCACACGCCT -> GCACACGCCTC
AGCACCGGCCT -> GCACCGGCCTG
AGCAGCTTCGG -> GCAGCTTCGGT
AGCAGGAGACG -> GCAGGAGACGC
AGCAGGCAATG -> GCAGGCAATGG
AGCATCGCCAA -> GCATCGCCAAC
AGCATGCTCAA -> GCATGCTCAAC
AGCCATCTCCA -> GCCATCTCCAG
AGCCCAAACCT -> GCCCAAACCTA
AGCCCCAAGTA -> GCCCCAAGTAA
AGCCCCGTGAT -> GCCCCGTGATA
AGCCGGTGCCG -> GCCGGTGCCGA
AGCCGTAGACT -> GCCGTAGACTT
AGCCTTAGGTT -> GCCTTAGGTTT
AGCGAATTGAA -> GCGAATTGAAA
AGCGAGTTATT -> GCGAGTTATTG
AGCGATTCCTA -> GCGATTCCTAT
AGCGCTCAACA -> GCGCTCAACAT
AGCGGAGACAG -> GCGGAGACAGA
AGCGGCCTCGT -> GCGGCCTCGTG
AGCGGTGTAGT -> GCGGTGTAGTG
AGCTAAGACGT -> GCTAAGACGTG
AGCTCAGAGGG -> GCTCAGAGGGC
AGCTCTCGTGT -> GCTCTCGTGTA
AGCTTCGGTCT -> GCTTCGGTCTC
AGCTTTCATAA -> GCTTTCATAAC
AGGAAACCAAC -> GGAAACCAACT
AGGAACCCTGC -> GGAACCCTGCG
AGGAATCTTCA -> GGAATCTTCAC
AGGACCCTAAT -> GGACCCTAATG
AGGACCGTCGA -> GGACCGTCGAC
AGGAGACGCTC -> GGAGACGCTCA
AGGAGATGCAG -> GGAGATGCAGG
AGGAGGTGTGG -> GGAGGTGTGGG
AGGCAATGGGC -> GGCAATGGGCA
AGGCCAAAAAC -> GGCCAAAAACA
AGGCCAACAAG -> GGCCAACAAGC
AGGCCAGTAAT -> GGCCAGTAATA
AGGCCTCGTTC -> GGCCTCGTTCT
AGGCGCAATAG -> GGCGCAATAGA
AGGCGCGGACA -> GGCGCGGACAG
AGGCGTAACGT -> GGCGTAACGTT
AGGCTAGGCGC -> GGCTAGGCGCA
AGGCTTGCTCC -> GGCTTGCTCCC
AGGCTTTGCCG -> GGCTTTGCCGA
AGGGAGAATAC -> GGGAGAATACA
AGGGAGAATAT -> GGGAGAATATC
AGGGAGTTTAC -> GGGAGTTTACT
AGGGCCCCGCA -> GGGCCCCGCAG
AGGGCCCGCGA -> GGGCCCGCGAC
AGGGCCTTTAA -> GGGCCTTTAAG
AGGGCTTGAAG -> GGGCTTGAAGA
AGGGTGAATGC -> GGGTGAATGCT
AGGGTGGGTAT -> GGGTGGGTATG
AGGTAGTACGC -> GGTAGTACGCA
AGGTATAGGGA -> GGTATAGGGAG
AGGTATATAAA -> GGTATATAAAG
AGGTATATCGT -> GGTATATCGTA
AGGTCGGGTGC -> GGTCGGGTGCT
AGGTGCAGCGC -> GGTGCAGCGCT
AGGTGCGGGAT -> GGTGCGGGATG
AGGTGCTTGCT -> GGTGCTTGCTT
AGGTGTGGGGA -> GGTGTGGGGAG
AGGTTATTATC -> GGTTATTATCT
AGGTTTCGCAA -> GGTTTCGCAAG
AGTAAAGCCCC -> GTAAAGCCCCG
AGTAAAGTAGC -> GTAAAGTAGCG
AGTAAATGCCC -> GTAAATGCCCT
AGTAAGCCCCA -> GTAAGCCCCAA
AGTAATAGCAA -> GTAATAGCAAT
AGTACCGCGAT -> GTACCGCGATT
AGTACGAGGAA -> GTACGAGGAAC
AGTACGCAAGA -> GTACGCAAGAT
AGTACGCATTC -> GTACGCATTCA
AGTACTGCACA -> GTACTGCACAT
AGTAGACCTTT -> GTAGACCTTTT
AGTAGCCCAAA -> GTAGCCCAAAC
AGTAGCGGCCT -> GTAGCGGCCTC
AGTCACCGTTA -> GTCACCGTTAT
AGTCCTCAGCG -> GTCCTCAGCGG
AGTCGGCGAAT -> GTCGGCGAATT
AGTGATGTATC -> GTGATGTATCG
AGTGCACTCCG -> GTGCACTCCGT
AGTGCATGTGG -> GTGCATGTGGT
AGTGGCCCAGA -> GTGGCCCAGAC
AGTGGTCGCCT -> GTGGTCGCCTG
AGTGTAATCAC -> GTGTAATCACG
AGTGTACCGTG -> GTGTACCGTGC
AGTTAACCATG -> GTTAACCATGG
AGTTATTGCAT -> GTTATTGCATC
AGTTCTTTTGA -> GTTCTTTTGAG
AGTTTACTGAT -> GTTTACTGATT
AGTTTGCACAA -> GTTTGCACAAT
AGTTTTCAATG -> GTTTTCAATGT
ATAAAGAAAAC -> TAAAGAAAACA
ATAACATGTCT -> TAACATGTCTC
ATAAGACATCA -> TAAGACATCAC
ATAAGAGTCGG -> TAAGAGTCGGC
ATACAATAAGA -> TACAATAAGAC
ATACAATCGCT -> TACAATCGCTG
ATACAGGCCAA -> TACAGGCCAAA
ATACCAAACTC -> TACCAAACTCC
ATACCATCGCA -> TACCATCGCAG
ATACGAGGCGT -> TACGAGGCGTA
ATACTAAGGCC -> TACTAAGGCCA
ATACTTGCAGC -> TACTTGCAGCA
ATACTTTCAAT -> TACTTTCAATC
ATAGACTCATA -> TAGACTCATAT
ATAGATTTCAA -> TAGATTTCAAT
ATAGCAATCGT -> TAGCAATCGTG
ATAGCAGGAGA -> TAGCAGGAGAC
ATAGCCGTAGA -> TAGCCGTAGAC
ATAGCTAAGAC -> TAGCTAAGACG
ATAGGGAGAAT -> TAGGGAGAATA,TAGGGAGAATA
ATAGTGGCCCA -> TAGTGGCCCAG
ATAGTTCTTTT -> TAGTTCTTTTG
ATATAAAGAAA -> TATAAAGAAAA
ATATATTTTTC -> TATATTTTTCG
ATATCGTAGTC -> TATCGTAGTCA
ATATCTCCGGA -> TATCTCCGGAG
ATATTTAACGG -> TATTTAACGGG
ATATTTTGTGC -> TATTTTGTGCC
ATATTTTTCGG -> TATTTTTCGGA
ATCAACCAGCG -> TCAACCAGCGA
ATCACGTTTTT -> TCACGTTTTTT
ATCACTAACCG -> TCACTAACCGG
ATCAGGGCCCC -> TCAGGGCCCCG
ATCCACATTAG -> TCCACATTAGG
ATCCACCTAAA -> TCCACCTAAAT
ATCCCTTGTAT -> TCCCTTGTATA
ATCCTCGAAAA -> TCCTCGAAAAC
ATCGACCACAC -> TCGACCACACC
ATCGACTGCGG -> TCGACTGCGGT
ATCGATCTTGT -> TCGATCTTGTC
ATCGCAGGTGC -> TCGCAGGTGCG
ATCGCCAACCT -> TCGCCAACCTT
ATCGCGGTGGT -> TCGCGGTGGTG
ATCGCTGAACC -> TCGCTGAACCA
ATCGGGAGTAA -> TCGGGAGTAAA
ATCGTAGTCAC -> TCGTAGTCACC
ATCGTGAGCAT -> TCGTGAGCATC
ATCTCCAGTTA -> TCTCCAGTTAA
ATCTCCGGAGC -> TCTCCGGAGCG
ATCTCTGCCGC -> TCTCTGCCGCA
ATCTGATCGAC -> TCTGATCGACT
ATCTGGGACTC -> TCTGGGACTCA
ATCTTCACACT -> TCTTCACACTG
ATCTTCACTGG -> TCTTCACTGGC
ATCTTCCTTCG -> TCTTCCTTCGA
ATCTTGTCCAA -> TCTTGTCCAAC
ATGAATGTCTC -> TGAATGTCTCG
ATGAATTCGTC -> TGAATTCGTCG
ATGATCTGGGA -> TGATCTGGGAC
ATGATGGCTTT -> TGATGGCTTTA
ATGCAATCCAC -> TGCAATCCACC
ATGCACAGACA -> TGCACAGACAA
ATGCACCTCAT -> TGCACCTCATC
ATGCAGGCCTC -> TGCAGGCCTCG
ATGCCACTTGC -> TGCCACTTGCG
ATGCCAGCAGC -> TGCCAGCAGCT
ATGCCCTCATT -> TGCCCTCATTC
ATGCGATTTAA -> TGCGATTTAAC
ATGCTCAACCT -> TGCTCAACCTT
ATGCTCCTCGA -> TGCTCCTCGAC
ATGCTGTATTG -> TGCTGTATTGA
ATGCTTAATGC -> TGCTTAATGCT
ATGGCTTTACC -> TGGCTTTACCC
ATGGGCATTCC -> TGGGCATTCCC
ATGGGTAAATG -> TGGGTAAATGC
ATGGTCTAGAA -> TGGTCTAGAAG
ATGGTGTCGTA -> TGGTGTCGTAA
ATGTATCGACC -> TGTATCGACCA
ATGTCTCGATG -> TGTCTCGATGC
ATGTCTCGTAG -> TGTCTCGTAGC
ATGTGGCTTAA -> TGTGGCTTAAC
ATGTGGTCCAA -> TGTGGTCCAAC
ATGTTCCGAGT -> TGTTCCGAGTA
ATGTTTGAGGA -> TGTTTGAGGAC
ATTAAGCTCAG -> TTAAGCTCAGA
ATTACTCATAC -> TTACTCATACT
ATTAGATAGTT -> TTAGATAGTTC
ATTAGGCTAGG -> TTAGGCTAGGC
ATTAGTACGCA -> TTAGTACGCAA
ATTATAAGAGT -> TTATAAGAGTC
ATTATCTGATC -> TTATCTGATCG
ATTCAAGTGGT -> TTCAAGTGGTC
ATTCACCCCCA -> TTCACCCCCAA
ATTCCACGGGG -> TTCCACGGGGA
ATTCCCCACCC -> TTCCCCACCCC
ATTCCCTGAGT -> TTCCCTGAGTT
ATTCCTATTTC -> TTCCTATTTCA
ATTCGCGATAG -> TTCGCGATAGT
ATTCGTCGTTT -> TTCGTCGTTTG
ATTCGTTACGA -> TTCGTTACGAA
ATTGAAACCAA -> TTGAAACCAAA
ATTGAGGTAGT -> TTGAGGTAGTA
ATTGCATACAA -> TTGCATACAAT
ATTGCATCCCT -> TTGCATCCCTT
ATTGCTAGGGC -> TTGCTAGGGCC
ATTGGACGCCC -> TTGGACGCCCG
ATTGGGAGTGC -> TTGGGAGTGCA
ATTTAACATAG -> TTTAACATAGC
ATTTAACATTG -> TTTAACATTGG
ATTTAACGGGC -> TTTAACGGGCT
ATTTACAGGCT -> TTTACAGGCTT
ATTTCAATTGG -> TTTCAATTGGA
ATTTCACACAT -> TTTCACACATG
ATTTGCTTGAA -> TTTGCTTGAAT
ATTTTGTGCCG -> TTTTGTGCCGG
ATTTTTCGGAG -> TTTTTCGGAGT
CAAAAACAGAT -> AAAAACAGATC
CAAAAACATCA -> AAAAACATCAA
CAAAAATGCAC -> AAAAATGCACC
CAAAAGAACCT -> AAAAGAACCTA
CAAACCTAAAG -> AAACCTAAAGA
CAAACGCAGGG -> AAACGCAGGGA
CAAACTCCTTC -> AAACTCCTTCC
CAAATACAATA -> AAATACAATAA
CAACAAGCCAT -> AACAAGCCATC
CAACACGAATC -> AACACGAATCG
CAACAGCGGTG -> AACAGCGGTGT
CAACAGGTGCT -> AACAGGTGCTT
CAACATTCAAG -> AACATTCAAGT
CAACCAGCGAT -> AACCAGCGATT
CAACCCGTCTC -> AACCCGTCTCA
CAACCGTTACA -> AACCGTTACAA
CAACCTGCTCC -> AACCTGCTCCA
CAACCTTTCCC -> AACCTTTCCCT
CAACTGTGACA -> AACTGTGACAG
CAAGATTTAAC -> AAGATTTAACA
CAAGCACCGGC -> AAGCACCGGCC
CAAGCCATCTC -> AAGCCATCTCC
CAAGGACCCTA -> AAGGACCCTAA
CAAGTAAAGTA -> AAGTAAAGTAG
CAAGTACGAGG -> AAGTACGAGGA
CAAGTGGTCGC -> AAGTGGTCGCC
CAATAAGACAT -> AATAAGACATC
CAATACCAAAC -> AATACCAAACT
CAATAGACTCA -> AATAGACTCAT
CAATCCACCTA -> AATCCACCTAA
CAATCGCTGAA -> AATCGCTGAAC
CAATCGGGAGT -> AATCGGGAGTA
CAATCGTGAGC -> AATCGTGAGCA
CAATGGGCATT -> AATGGGCATTC
CAATGTGGCTT -> AATGTGGCTTA
CAATTACTCAT -> AATTACTCATA
CAATTAGATAG -> AATTAGATAGT
CAATTGGACGC -> AATTGGACGCC
CACAATACCAA -> ACAATACCAAA
CACACATGGTC -> ACACATGGTCT
CACACCTTAAC -> ACACCTTAACC
CACACGCCTCC -> ACACGCCTCCG
CACACTGTAAG -> ACACTGTAAGG
CACAGACAACC -> ACAGACAACCT
CACATAGATTT -> ACATAGATTTC
CACATGGTCTA -> ACATGGTCTAG
CACATTAGGCT -> ACATTAGGCTA
CACCACTAGAC -> ACCACTAGACC
CACCAGTGTAC -> ACCAGTGTACC
CACCCAGATGC -> ACCCAGATGCG
CACCCCCAACC -> ACCCCCAACCG
CACCCCCTAGT -> ACCCCCTAGTA
CACCGGCCTGT -> ACCGGCCTGTA
CACCGTTATGT -> ACCGTTATGTT
CACCTAAATTG -> ACCTAAATTGC
CACCTAACTGC -> ACCTAACTGCA
CACCTCATCTC -> ACCTCATCTCT
CACCTTAACCG -> ACCTTAACCGT
CACGAATCGAT -> ACGAATCGATC
CACGCCTCCGA -> ACGCCTCCGAG
CACGGGGAGTA -> ACGGGGAGTAA
CACGGTTGCAG -> ACGGTTGCAGT
CACGTTTTTTG -> ACGTTTTTTGT
CACTAACCGGG -> ACTAACCGGGA
CACTAGACCGA -> ACTAGACCGAT
CACTCCGTCAG -> ACTCCGTCAGA
CACTCTTGACT -> ACTCTTGACTT
CACTGGCAAGT -> ACTGGCAAGTA
CACTGTAAGGA -> ACTGTAAGGAG
CACTTGCGGAT -> ACTTGCGGATT
CAGAAGCACAC -> AGAAGCACACG
CAGAATGCCAG -> AGAATGCCAGC
CAGACAACCTG -> AGACAACCTGC
CAGACAAGCAC -> AGACAAGCACC
CAGACTGACCA -> AGACTGACCAG
CAGAGGGCTTG -> AGAGGGCTTGA
CAGATAGCAGG -> AGATAGCAGGA
CAGATAGCCGT -> AGATAGCCGTA
CAGATCAGGGC -> AGATCAGGGCC
CAGATGAATTC -> AGATGAATTCG
CAGATGCGATT -> AGATGCGATTT
CAGATTCCACG -> AGATTCCACGG
CAGCAGCTTCG -> AGCAGCTTCGG
CAGCATGCTCA -> AGCATGCTCAA
CAGCGATTCCT -> AGCGATTCCTA
CAGCGCTCAAC -> AGCGCTCAACA
CAGCGGAGACA -> AGCGGAGACAG
CAGCGGTGTAG -> AGCGGTGTAGT
CAGCTTCGGTC -> AGCTTCGGTCT
CAGCTTTCATA -> AGCTTTCATAA
CAGGAGACGCT -> AGGAGACGCTC
CAGGAGGTGTG -> AGGAGGTGTGG
CAGGCAATGGG -> AGGCAATGGGC
CAGGCCAAAAA -> AGGCCAAAAAC
CAGGCCTCGTT -> AGGCCTCGTTC
CAGGCGCGGAC -> AGGCGCGGACA
CAGGCTTTGCC -> AGGCTTTGCCG
CAGGGAGTTTA -> AGGGAGTTTAC
CAGGGCCCCGC -> AGGGCCCCGCA
CAGGTATATAA -> AGGTATATAAA
CAGGTATATCG -> AGGTATATCGT
CAGGTCGGGTG -> AGGTCGGGTGC
CAGGTGCGGGA -> AGGTGCGGGAT
CAGGTGCTTGC -> AGGTGCTTGCT
CAGGTTATTAT -> AGGTTATTATC
CAGTAATAGCA -> AGTAATAGCAA
CAGTGATGTAT -> AGTGATGTATC
CAGTGTACCGT -> AGTGTACCGTG
CAGTTAACCAT -> AGTTAACCATG
CATAACATGTC -> ATAACATGTCT
CATACAATCGC -> ATACAATCGCT
CATACCATCGC -> ATACCATCGCA
CATACTTTCAA -> ATACTTTCAAT
CATAGATTTCA -> ATAGATTTCAA
CATAGCTAAGA -> ATAGCTAAGAC
CATAGGGAGAA -> ATAGGGAGAAT
CATATTTAACG -> ATATTTAACGG
CATCAACCAGC -> ATCAACCAGCG
CATCACTAACC -> ATCACTAACCG
CATCCCTTGTA -> ATCCCTTGTAT
CATCGCAGGTG -> ATCGCAGGTGC
CATCGCCAACC -> ATCGCCAACCT
CATCTCCAGTT -> ATCTCCAGTTA
CATCTCTGCCG -> ATCTCTGCCGC
CATCTTCACAC -> ATCTTCACACT
CATCTTCCTTC -> ATCTTCCTTCG
CATGCTCAACC -> ATGCTCAACCT
CATGGTCTAGA -> ATGGTCTAGAA
CATGGTGTCGT -> ATGGTGTCGTA
CATGTCTCGTA -> ATGTCTCGTAG
CATGTGGTCCA -> ATGTGGTCCAA
CATTAGGCTAG -> ATTAGGCTAGG
CATTCAAGTGG -> ATTCAAGTGGT
CATTCACCCCC -> ATTCACCCCCA
CATTCCCTGAG -> ATTCCCTGAGT
CATTCGCGATA -> ATTCGCGATAG
CATTCGTTACG -> ATTCGTTACGA
CATTGGGAGTG -> ATTGGGAGTGC
CCAAAAACATC -> CAAAAACATCA
CCAAAAGAACC -> CAAAAGAACCT
CCAAACCTAAA -> CAAACCTAAAG
CCAAACGCAGG -> CAAACGCAGGG
CCAAACTCCTT -> CAAACTCCTTC
CCAACAAGCCA -> CAACAAGCCAT
CCAACACGAAT -> CAACACGAATC
CCAACAGCGGT -> CAACAGCGGTG
CCAACAGGTGC -> CAACAGGTGCT
CCAACCCGTCT -> CAACCCGTCTC
CCAACCGTTAC -> CAACCGTTACA
CCAACCTTTCC -> CAACCTTTCCC
CCAACTGTGAC -> CAACTGTGACA
CCAAGTAAAGT -> CAAGTAAAGTA
CCACACCTTAA -> CACACCTTAAC
CCACATTAGGC -> CACATTAGGCT
CCACCCCCTAG -> CACCCCCTAGT
CCACCTAAATT -> CACCTAAATTG
CCACCTAACTG -> CACCTAACTGC
CCACGGGGAGT -> CACGGGGAGTA
CCACTAGACCG -> CACTAGACCGA
CCACTTGCGGA -> CACTTGCGGAT
CCAGACAAGCA -> CAGACAAGCAC
CCAGACTGACC -> CAGACTGACCA
CCAGATGCGAT -> CAGATGCGATT
CCAGATTCCAC -> CAGATTCCACG
CCAGCAGCTTC -> CAGCAGCTTCG
CCAGCGATTCC -> CAGCGATTCCT
CCAGTAATAGC -> CAGTAATAGCA
CCAGTGTACCG -> CAGTGTACCGT
CCAGTTAACCA -> CAGTTAACCAT
CCATCGCAGGT -> CATCGCAGGTG
CCATCTCCAGT -> CATCTCCAGTT
CCATCTTCACA -> CATCTTCACAC
CCATGGTGTCG -> CATGGTGTCGT
CCCAAAAGAAC -> CCAAAAGAACC
CCCAAACCTAA -> CCAAACCTAAA
CCCAACCGTTA -> CCAACCGTTAC
CCCAAGTAAAG -> CCAAGTAAAGT
CCCACCCCCTA -> CCACCCCCTAG
CCCAGACTGAC -> CCAGACTGACC
CCCAGATGCGA -> CCAGATGCGAT
CCCCAACCGTT -> CCCAACCGTTA
CCCCAAGTAAA -> CCCAAGTAAAG
CCCCACCCCCT -> CCCACCCCCTA
CCCCCAACCGT -> CCCCAACCGTT
CCCCCTAGTAG -> CCCCTAGTAGA
CCCCGCAGGTC -> CCCGCAGGTCG
CCCCGTGATAT -> CCCGTGATATT
CCCCTAGTAGA -> CCCTAGTAGAC
CCCCTTCTCAG -> CCCTTCTCAGG
CCCGAGGGCCT -> CCGAGGGCCTT
CCCGCAGGTCG -> CCGCAGGTCGG
CCCGCGACCGG -> CCGCGACCGGC
CCCGTCTCAGG -> CCGTCTCAGGT
CCCGTGACTCG -> CCGTGACTCGG
CCCGTGATATT -> CCGTGATATTT
CCCTAACGTAC -> CCTAACGTACT
CCCTAATGGGT -> CCTAATGGGTA
CCCTAGTAGAC -> CCTAGTAGACC
CCCTCATTCGT -> CCTCATTCGTT
CCCTCCGCCTT -> CCTCCGCCTTT
CCCTGAGTTTG -> CCTGAGTTTGC
CCCTGCGGCAT -> CCTGCGGCATA
CCCTTCGGGCA -> CCTTCGGGCAG
CCCTTCTCAGG -> CCTTCTCAGGT
CCCTTGTATAC -> CCTTGTATACT
CCGACGCACGG -> CGACGCACGGT
CCGACGCTTCG -> CGACGCTTCGA
CCGAGGAAACC -> CGAGGAAACCA
CCGAGGGCCTT -> CGAGGGCCTTT
CCGAGTAAAGC -> CGAGTAAAGCC
CCGAGTACCGC -> CGAGTACCGCG
CCGATGATGGC -> CGATGATGGCT
CCGCAGGCGCG -> CGCAGGCGCGG
CCGCAGGTCGG -> CGCAGGTCGGG
CCGCCTTTTCA -> CGCCTTTTCAT
CCGCGACCGGC -> CGCGACCGGCA
CCGCGATTATA -> CGCGATTATAA
CCGCTCGCGCA -> CGCTCGCGCAG
CCGGAGCGAAT -> CGGAGCGAATT
CCGGCATTCGC -> CGGCATTCGCG
CCGGCCTGTAT -> CGGCCTGTATA
CCGGGACTTCT -> CGGGACTTCTA
CCGGTCTGAGG -> CGGTCTGAGGT
CCGGTGCCGAG -> CGGTGCCGAGT
CCGTAGACTTA -> CGTAGACTTAA
CCGTCAGATAG -> CGTCAGATAGC
CCGTCGACGAC -> CGTCGACGACG
CCGTCTCAGGT -> CGTCTCAGGTT
CCGTGACTCGG -> CGTGACTCGGT
CCGTGATATTT -> CGTGATATTTT
CCGTGCGCTAA -> CGTGCGCTAAT
CCGTGTTCGCT -> CGTGTTCGCTC
CCGTTACAATT -> CGTTACAATTA
CCGTTATGTTC -> CGTTATGTTCC
CCTAAAGAACT -> CTAAAGAACTC
CCTAAATTGCT -> CTAAATTGCTA
CCTAACGTACT -> CTAACGTACTA
CCTAACTGCAA -> CTAACTGCAAA
CCTAATGGGTA -> CTAATGGGTAA
CCTAGCAGGCA -> CTAGCAGGCAA
CCTAGTAGACC -> CTAGTAGACCT
CCTATGAATGT -> CTATGAATGTC
CCTATTTCACA -> CTATTTCACAC
CCTCAGCGGAG -> CTCAGCGGAGA
CCTCATCTCTG -> CTCATCTCTGC
CCTCATTCGTT -> CTCATTCGTTA
CCTCCGAGGAA -> CTCCGAGGAAA
CCTCCGCCTTT -> CTCCGCCTTTT
CCTCCTGCCGC -> CTCCTGCCGCT
CCTCGAAAACA -> CTCGAAAACAA
CCTCGAATTTG -> CTCGAATTTGC
CCTCGACCTCG -> CTCGACCTCGA
CCTCGTGCGTT -> CTCGTGCGTTA
CCTCGTTCTTA -> CTCGTTCTTAG
CCTGAGTTTGC -> CTGAGTTTGCA
CCTGATGCCAC -> CTGATGCCACT
CCTGCCGCTCG -> CTGCCGCTCGC
CCTGCGGCATA -> CTGCGGCATAC
CCTGCTCCAGA -> CTGCTCCAGAC
CCTGCTCTCAC -> CTGCTCTCACT
CCTGGAGTAGC -> CTGGAGTAGCC
CCTGTATACTA -> CTGTATACTAA
CCTTAACCGTG -> CTTAACCGTGT
CCTTAGGTTTC -> CTTAGGTTTCG
CCTTCCGACGC -> CTTCCGACGCT
CCTTCGAGTTT -> CTTCGAGTTTT
CCTTCGGGCAG -> CTTCGGGCAGA
CCTTCTCAGGT -> CTTCTCAGGTA
CCTTGCTGTGC -> CTTGCTGTGCC
CCTTGTATACT -> CTTGTATACTT
CCTTTAAGCCG -> CTTTAAGCCGG
CCTTTCCCTCC -> CTTTCCCTCCG
CCTTTTACCTG -> CTTTTACCTGA
CCTTTTCATCT -> CTTTTCATCTT
CGAAAACAATT -> GAAAACAATTA
CGAAGTACTGC -> GAAGTACTGCA
CGAATATATTT -> GAATATATTTT
CGAATCGATCT -> GAATCGATCTT
CGAATTAAGCT -> GAATTAAGCTC
CGAATTGAAAC -> GAATTGAAACC
CGAATTTGCTT -> GAATTTGCTTG
CGACCACACCT -> GACCACACCTT
CGACCGGCATT -> GACCGGCATTC
CGACCTCGAAT -> GACCTCGAATT
CGACGACGGTT -> GACGACGGTTG
CGACGCACGGT -> GACGCACGGTT
CGACGCTTCGA -> GACGCTTCGAA
CGACGGTTGCG -> GACGGTTGCGA
CGACTGCGGTC -> GACTGCGGTCA
CGAGGAAACCA -> GAGGAAACCAA
CGAGGAACCCT -> GAGGAACCCTG
CGAGGCGTAAC -> GAGGCGTAACG
CGAGGGCCTTT -> GAGGGCCTTTA
CGAGTAAAGCC -> GAGTAAAGCCC
CGAGTACCGCG -> GAGTACCGCGA
CGAGTTATTGC -> GAGTTATTGCA
CGAGTTTTCAA -> GAGTTTTCAAT
CGATAGTGGCC -> GATAGTGGCCC
CGATCCTCGAA -> GATCCTCGAAA
CGATCTTGTCC -> GATCTTGTCCA
CGATGATGGCT -> GATGATGGCTT
CGATGCACAGA -> GATGCACAGAC
CGATTATAAGA -> GATTATAAGAG
CGATTCCCCAC -> GATTCCCCACC
CGATTCCTATT -> GATTCCTATTT
CGATTTAACAT -> GATTTAACATT
CGCAAGATTTA -> GCAAGATTTAA
CGCAAGGACCC -> GCAAGGACCCT
CGCAATAGACT -> GCAATAGACTC
CGCACGGTTGC -> GCACGGTTGCA
CGCAGGCGCGG -> GCAGGCGCGGA
CGCAGGGAGTT -> GCAGGGAGTTT
CGCAGGTATAT -> GCAGGTATATA
CGCAGGTCGGG -> GCAGGTCGGGT
CGCAGGTGCGG -> GCAGGTGCGGG
CGCATTCACCC -> GCATTCACCCC
CGCCAACCTTT -> GCCAACCTTTC
CGCCCGAGGGC -> GCCCGAGGGCC
CGCCTCCGAGG -> GCCTCCGAGGA
CGCCTGGAGTA -> GCCTGGAGTAG
CGCCTTTTCAT -> GCCTTTTCATC
CGCGACCGGCA -> GCGACCGGCAT
CGCGATAGTGG -> GCGATAGTGGC
CGCGATTATAA -> GCGATTATAAG
CGCGCAGGTAT -> GCGCAGGTATA
CGCGGACAGAA -> GCGGACAGAAG
CGCGGTGGTGA -> GCGGTGGTGAG
CGCTAATTAGT -> GCTAATTAGTA
CGCTCAACATT -> GCTCAACATTC
CGCTCATAGGG -> GCTCATAGGGA
CGCTCCAACAG -> GCTCCAACAGC
CGCTCCTTGCT -> GCTCCTTGCTG
CGCTCGCGCAG -> GCTCGCGCAGG
CGCTGAACCAT -> GCTGAACCATC
CGCTTCGAATA -> GCTTCGAATAT
CGGACAGAAGC -> GGACAGAAGCA
CGGAGACAGAT -> GGAGACAGATG
CGGAGCGAATT -> GGAGCGAATTG
CGGAGTCCTCA -> GGAGTCCTCAG
CGGATTTACAG -> GGATTTACAGG
CGGCATACCAT -> GGCATACCATC
CGGCATTCGCG -> GGCATTCGCGA
CGGCCTCGTGC -> GGCCTCGTGCG
CGGCCTGTATA -> GGCCTGTATAC
CGGCGAATTAA -> GGCGAATTAAG
CGGGACTTCTA -> GGGACTTCTAA
CGGGAGTAAAT -> GGGAGTAAATG
CGGGATGTTTG -> GGGATGTTTGA
CGGGCAGAATG -> GGGCAGAATGC
CGGGCTCAGCT -> GGGCTCAGCTT
CGGGGAGTAAG -> GGGGAGTAAGC
CGGGTGCTGAA -> GGGTGCTGAAG
CGGGTGGACGT -> GGGTGGACGTG
CGGTCACCAGT -> GGTCACCAGTG
CGGTCTCGGGT -> GGTCTCGGGTG
CGGTCTGAGGT -> GGTCTGAGGTA
CGGTGCCGAGT -> GGTGCCGAGTA
CGGTGCTAGGG -> GGTGCTAGGGT
CGGTGGTGAGG -> GGTGGTGAGGT
CGGTGTAGTGC -> GGTGTAGTGCA
CGGTTGCAGTG -> GGTTGCAGTGA
CGGTTGCGATT -> GGTTGCGATTC
CGGTTTCCTGC -> GGTTTCCTGCT
CGTAACGTTGG -> GTAACGTTGGG
CGTAATACGAG -> GTAATACGAGG
CGTACTACAGG -> GTACTACAGGA
CGTAGACTTAA -> GTAGACTTAAC
CGTAGCGAGTT -> GTAGCGAGTTA
CGTAGTCACCG -> GTAGTCACCGT
CGTCAGATAGC -> GTCAGATAGCA
CGTCGACGACG -> GTCGACGACGG
CGTCGTTTGGG -> GTCGTTTGGGC
CGTCTCAGGTT -> GTCTCAGGTTA
CGTGACTCGGT -> GTGACTCGGTT
CGTGAGCATCG -> GTGAGCATCGC
CGTGATATTTT -> GTGATATTTTG
CGTGCGCTAAT -> GTGCGCTAATT
CGTGCGTTAGA -> GTGCGTTAGAT
CGTGTAGGAAT -> GTGTAGGAATC
CGTGTATCCAC -> GTGTATCCACA
CGTGTGGCCAC -> GTGTGGCCACC
CGTGTTCGCTC -> GTGTTCGCTCC
CGTTACAATTA -> GTTACAATTAG
CGTTACGAAGT -> GTTACGAAGTA
CGTTAGATGAT -> GTTAGATGATC
CGTTATGTTCC -> GTTATGTTCCG
CGTTCTTAGCC -> GTTCTTAGCCT
CGTTGCTCACC -> GTTGCTCACCC
CGTTGGGGTTT -> GTTGGGGTTTG
CGTTTGGGCAA -> GTTTGGGCAAA
CGTTTTTTGTT -> GTTTTTTGTTA
CTAAAGAACTC -> TAAAGAACTCG
CTAAATTGCTA -> TAAATTGCTAG
CTAACCGGGAC -> TAACCGGGACT
CTAACGTACTA -> TAACGTACTAC
CTAACTGCAAA -> TAACTGCAAAA
CTAAGACGTGT -> TAAGACGTGTG
CTAAGGCCAAC -> TAAGGCCAACA
CTAAGGCTTGC -> TAAGGCTTGCT
CTAATGGGTAA -> TAATGGGTAAA
CTAATTAGTAC -> TAATTAGTACG
CTACAGGAGGT -> TACAGGAGGTG
CTAGAAGAGGG -> TAGAAGAGGGT
CTAGACCGATG -> TAGACCGATGA
CTAGCAGGCAA -> TAGCAGGCAAT
CTAGGCGCAAT -> TAGGCGCAATA
CTAGGGCCCGC -> TAGGGCCCGCG
CTAGGGTGGGT -> TAGGGTGGGTA
CTAGTAGACCT -> TAGTAGACCTT
CTATGAATGTC -> TATGAATGTCT
CTATTTCACAC -> TATTTCACACA
CTCAAATACAA -> TCAAATACAAT
CTCAACATTCA -> TCAACATTCAA
CTCAACCTTGC -> TCAACCTTGCA
CTCACCCAGAT -> TCACCCAGATG
CTCACTCTTGA -> TCACTCTTGAC
CTCAGAGGGCT -> TCAGAGGGCTT
CTCAGCGGAGA -> TCAGCGGAGAC
CTCAGCTTTCA -> TCAGCTTTCAT
CTCAGGTATAT -> TCAGGTATATC
CTCAGGTTATT -> TCAGGTTATTA
CTCATACTTTC -> TCATACTTTCA
CTCATAGGGAG -> TCATAGGGAGA
CTCATATTTAA -> TCATATTTAAC
CTCATCTCTGC -> TCATCTCTGCC
CTCATTCGTTA -> TCATTCGTTAC
CTCCAACAGCG -> TCCAACAGCGG
CTCCAGACAAG -> TCCAGACAAGC
CTCCAGTTAAC -> TCCAGTTAACC
CTCCCGTGACT -> TCCCGTGACTC
CTCCGAGGAAA -> TCCGAGGAAAC
CTCCGCCTTTT -> TCCGCCTTTTC
CTCCGGAGCGA -> TCCGGAGCGAA
CTCCGTCAGAT -> TCCGTCAGATA
CTCCTCGACCT -> TCCTCGACCTC
CTCCTGCCGCT -> TCCTGCCGCTC
CTCCTTCCGAC -> TCCTTCCGACG
CTCCTTGCTGT -> TCCTTGCTGTG
CTCGAAAACAA -> TCGAAAACAAT
CTCGAATTTGC -> TCGAATTTGCT
CTCGACCTCGA -> TCGACCTCGAA
CTCGATCCTCG -> TCGATCCTCGA
CTCGATGCACA -> TCGATGCACAG
CTCGCGCAGGT -> TCGCGCAGGTA
CTCGGGTGGAC -> TCGGGTGGACG
CTCGGTTTCCT -> TCGGTTTCCTG
CTCGTAGCGAG -> TCGTAGCGAGT
CTCGTGCGTTA -> TCGTGCGTTAG
CTCGTGTAGGA -> TCGTGTAGGAA
CTCGTTCTTAG -> TCGTTCTTAGC
CTCGTTGCTCA -> TCGTTGCTCAC
CTCTCACTCTT -> TCTCACTCTTG
CTCTCGTGTAG -> TCTCGTGTAGG
CTCTGCCGCAG -> TCTGCCGCAGG
CTCTTGACTTT -> TCTTGACTTTC
CTGAACCATCT -> TGAACCATCTT
CTGAAGCTCTC -> TGAAGCTCTCG
CTGACCAGATT -> TGACCAGATTC
CTGAGGTATAG -> TGAGGTATAGG
CTGAGTTTGCA -> TGAGTTTGCAC
CTGATCGACTG -> TGATCGACTGC
CTGATGCCACT -> TGATGCCACTT
CTGATTGCATA -> TGATTGCATAC
CTGCAAAAATG -> TGCAAAAATGC
CTGCACATAGA -> TGCACATAGAT
CTGCCGCAGGC -> TGCCGCAGGCG
CTGCCGCTCGC -> TGCCGCTCGCG
CTGCGGCATAC -> TGCGGCATACC
CTGCGGTCACC -> TGCGGTCACCA
CTGCTCCAGAC -> TGCTCCAGACA
CTGCTCTCACT -> TGCTCTCACTC
CTGGAGTAGCC -> TGGAGTAGCCC
CTGGCAAGTAC -> TGGCAAGTACG
CTGGGACTCAA -> TGGGACTCAAA
CTGTAAGGAGA -> TGTAAGGAGAT
CTGTATACTAA -> TGTATACTAAG
CTGTATTGAGG -> TGTATTGAGGT
CTGTGACAGAT -> TGTGACAGATA
CTGTGCCAACA -> TGTGCCAACAC
CTTAACCCTTC -> TTAACCCTTCG
CTTAACCGTGT -> TTAACCGTGTT
CTTAACCTCCT -> TTAACCTCCTG
CTTAATGCTCC -> TTAATGCTCCT
CTTAGCCTTAG -> TTAGCCTTAGG
CTTAGGTTTCG -> TTAGGTTTCGC
CTTCACACTGT -> TTCACACTGTA
CTTCACTGGCA -> TTCACTGGCAA
CTTCCGACGCT -> TTCCGACGCTT
CTTCCTTCGAG -> TTCCTTCGAGT
CTTCGAATATA -> TTCGAATATAT
CTTCGAGTTTT -> TTCGAGTTTTC
CTTCGGGCAGA -> TTCGGGCAGAA
CTTCGGTCTCG -> TTCGGTCTCGG
CTTCTAAGGCT -> TTCTAAGGCTT
CTTCTCAGGTA -> TTCTCAGGTAT
CTTGAAGACTC -> TTGAAGACTCG
CTTGAATCGCG -> TTGAATCGCGG
CTTGACTTTCG -> TTGACTTTCGC
CTTGCAGCATG -> TTGCAGCATGC
CTTGCGGATTT -> TTGCGGATTTA
CTTGCTCCCGT -> TTGCTCCCGTG
CTTGCTGTGCC -> TTGCTGTGCCA
CTTGCTTGCTT -> TTGCTTGCTTT
CTTGCTTTCCC -> TTGCTTTCCCT
CTTGTATACTT -> TTGTATACTTG
CTTGTCCAACC -> TTGTCCAACCC
CTTTAAGCCGG -> TTTAAGCCGGT
CTTTACCCAAA -> TTTACCCAAAA
CTTTCAATCGG -> TTTCAATCGGG
CTTTCATAACA -> TTTCATAACAT
CTTTCCCTAAC -> TTTCCCTAACG
CTTTCCCTCCG -> TTTCCCTCCGC
CTTTCGCTCCA -> TTTCGCTCCAA
CTTTGCCGACG -> TTTGCCGACGC
CTTTTACCTGA -> TTTTACCTGAT
CTTTTCATCTT -> TTTTCATCTTC
CTTTTGAGGCC -> TTTTGAGGCCA
GAAAACAATTA -> AAAACAATTAC
GAAAACACCAC -> AAAACACCACT
GAAACCAAACG -> AAACCAAACGC
GAAACCAACTG -> AAACCAACTGT
GAACCATCTTC -> AACCATCTTCA
GAACCCTGCGG -> AACCCTGCGGC
GAACCTATGAA -> AACCTATGAAT
GAACTCGATCC -> AACTCGATCCT
GAAGACTCGTT -> AAGACTCGTTG
GAAGAGGGTGA -> AAGAGGGTGAA
GAAGCACACGC -> AAGCACACGCC
GAAGCTCTCGT -> AAGCTCTCGTG
GAAGTACTGCA -> AAGTACTGCAC
GAATACAGGCC -> AATACAGGCCA
GAATATATTTT -> AATATATTTTT
GAATATCTCCG -> AATATCTCCGG
GAATCGATCTT -> AATCGATCTTG
GAATCGCGGTG -> AATCGCGGTGG
GAATCTTCACT -> AATCTTCACTG
GAATGCCAGCA -> AATGCCAGCAG
GAATGCTTAAT -> AATGCTTAATG
GAATGTCTCGA -> AATGTCTCGAT
GAATTAAGCTC -> AATTAAGCTCA
GAATTCGTCGT -> AATTCGTCGTT
GAATTGAAACC -> AATTGAAACCA
GAATTTGCTTG -> AATTTGCTTGA
GACAACCTGCT -> ACAACCTGCTC
GACAAGCACCG -> ACAAGCACCGG
GACAGAAGCAC -> ACAGAAGCACA
GACAGATAGCC -> ACAGATAGCCG
GACAGATGAAT -> ACAGATGAATT
GACATCACTAA -> ACATCACTAAC
GACCACACCTT -> ACCACACCTTA
GACCAGATTCC -> ACCAGATTCCA
GACCCTAATGG -> ACCCTAATGGG
GACCGATGATG -> ACCGATGATGG
GACCGGCATTC -> ACCGGCATTCG
GACCGTCGACG -> ACCGTCGACGA
GACCTCGAATT -> ACCTCGAATTT
GACCTTTTACC -> ACCTTTTACCT
GACGACGGTTG -> ACGACGGTTGC
GACGCACGGTT -> ACGCACGGTTG
GACGCCCGAGG -> ACGCCCGAGGG
GACGCTCATAG -> ACGCTCATAGG
GACGCTTCGAA -> ACGCTTCGAAT
GACGGTTGCGA -> ACGGTTGCGAT
GACGTGTATCC -> ACGTGTATCCA
GACGTGTGGCC -> ACGTGTGGCCA
GACTCAAATAC -> ACTCAAATACA
GACTCATATTT -> ACTCATATTTA
GACTCGGTTTC -> ACTCGGTTTCC
GACTCGTTGCT -> ACTCGTTGCTC
GACTGACCAGA -> ACTGACCAGAT
GACTGCGGTCA -> ACTGCGGTCAC
GACTTAACCTC -> ACTTAACCTCC
GACTTCTAAGG -> ACTTCTAAGGC
GACTTTCGCTC -> ACTTTCGCTCC
GAGAATACAGG -> AGAATACAGGC
GAGAATATCTC -> AGAATATCTCC
GAGACAGATGA -> AGACAGATGAA
GAGACGCTCAT -> AGACGCTCATA
GAGATGCAGGC -> AGATGCAGGCC
GAGCATCGCCA -> AGCATCGCCAA
GAGCGAATTGA -> AGCGAATTGAA
GAGGAAACCAA -> AGGAAACCAAC
GAGGAACCCTG -> AGGAACCCTGC
GAGGACCGTCG -> AGGACCGTCGA
GAGGCCAGTAA -> AGGCCAGTAAT
GAGGCGTAACG -> AGGCGTAACGT
GAGGGCCTTTA -> AGGGCCTTTAA
GAGGGCTTGAA -> AGGGCTTGAAG
GAGGGTGAATG -> AGGGTGAATGC
GAGGTAGTACG -> AGGTAGTACGC
GAGGTATAGGG -> AGGTATAGGGA
GAGGTGCAGCG -> AGGTGCAGCGC
GAGGTGTGGGG -> AGGTGTGGGGA
GAGTAAAGCCC -> AGTAAAGCCCC
GAGTAAATGCC -> AGTAAATGCCC
GAGTAAGCCCC -> AGTAAGCCCCA
GAGTACCGCGA -> AGTACCGCGAT
GAGTAGCCCAA -> AGTAGCCCAAA
GAGTCCTCAGC -> AGTCCTCAGCG
GAGTCGGCGAA -> AGTCGGCGAAT
GAGTGCACTCC -> AGTGCACTCCG
GAGTGTAATCA -> AGTGTAATCAC
GAGTTATTGCA -> AGTTATTGCAT
GAGTTTACTGA -> AGTTTACTGAT
GAGTTTGCACA -> AGTTTGCACAA
GAGTTTTCAAT -> AGTTTTCAATG
GATAGCAGGAG -> ATAGCAGGAGA
GATAGCCGTAG -> ATAGCCGTAGA
GATAGTGGCCC -> ATAGTGGCCCA
GATAGTTCTTT -> ATAGTTCTTTT
GATATTTTGTG -> ATATTTTGTGC
GATCAGGGCCC -> ATCAGGGCCCC
GATCCTCGAAA -> ATCCTCGAAAA
GATCGACTGCG -> ATCGACTGCGG
GATCTGGGACT -> ATCTGGGACTC
GATCTTGTCCA -> ATCTTGTCCAA
GATGAATTCGT -> ATGAATTCGTC
GATGATCTGGG -> ATGATCTGGGA
GATGATGGCTT -> ATGATGGCTTT
GATGCACAGAC -> ATGCACAGACA
GATGCAGGCCT -> ATGCAGGCCTC
GATGCCACTTG -> ATGCCACTTGC
GATGCGATTTA -> ATGCGATTTAA
GATGGCTTTAC -> ATGGCTTTACC
GATGTATCGAC -> ATGTATCGACC
GATGTTTGAGG -> ATGTTTGAGGA
GATTATAAGAG -> ATTATAAGAGT
GATTCCACGGG -> ATTCCACGGGG
GATTCCCCACC -> ATTCCCCACCC
GATTCCTATTT -> ATTCCTATTTC
GATTGCATACA -> ATTGCATACAA
GATTTAACATA -> ATTTAACATAG
GATTTAACATT -> ATTTAACATTG
GATTTACAGGC -> ATTTACAGGCT
GATTTCAATTG -> ATTTCAATTGG
GCAAAAACAGA -> CAAAAACAGAT
GCAAAAATGCA -> CAAAAATGCAC
GCAAGATTTAA -> CAAGATTTAAC
GCAAGGACCCT -> CAAGGACCCTA
GCAAGTACGAG -> CAAGTACGAGG
GCAATAGACTC -> CAATAGACTCA
GCAATCCACCT -> CAATCCACCTA
GCAATCGTGAG -> CAATCGTGAGC
GCAATGGGCAT -> CAATGGGCATT
GCACAATACCA -> CACAATACCAA
GCACACGCCTC -> CACACGCCTCC
GCACAGACAAC -> CACAGACAACC
GCACATAGATT -> CACATAGATTT
GCACCGGCCTG -> CACCGGCCTGT
GCACCTCATCT -> CACCTCATCTC
GCACGGTTGCA -> CACGGTTGCAG
GCACTCCGTCA -> CACTCCGTCAG
GCAGAATGCCA -> CAGAATGCCAG
GCAGCATGCTC -> CAGCATGCTCA
GCAGCGCTCAA -> CAGCGCTCAAC
GCAGCTTCGGT -> CAGCTTCGGTC
GCAGGAGACGC -> CAGGAGACGCT
GCAGGCAATGG -> CAGGCAATGGG
GCAGGCCTCGT -> CAGGCCTCGTT
GCAGGCGCGGA -> CAGGCGCGGAC
GCAGGGAGTTT -> CAGGGAGTTTA
GCAGGTATATA -> CAGGTATATAA
GCAGGTCGGGT -> CAGGTCGGGTG
GCAGGTGCGGG -> CAGGTGCGGGA
GCAGTGATGTA -> CAGTGATGTAT
GCATACAATCG -> CATACAATCGC
GCATACCATCG -> CATACCATCGC
GCATCCCTTGT -> CATCCCTTGTA
GCATCGCCAAC -> CATCGCCAACC
GCATGCTCAAC -> CATGCTCAACC
GCATGTGGTCC -> CATGTGGTCCA
GCATTCACCCC -> CATTCACCCCC
GCATTCCCTGA -> CATTCCCTGAG
GCATTCGCGAT -> CATTCGCGATA
GCCAAAAACAT -> CCAAAAACATC
GCCAACAAGCC -> CCAACAAGCCA
GCCAACACGAA -> CCAACACGAAT
GCCAACCTTTC -> CCAACCTTTCC
GCCACCTAACT -> CCACCTAACTG
GCCACTTGCGG -> CCACTTGCGGA
GCCAGCAGCTT -> CCAGCAGCTTC
GCCAGTAATAG -> CCAGTAATAGC
GCCATCTCCAG -> CCATCTCCAGT
GCCCAAACCTA -> CCCAAACCTAA
GCCCAGACTGA -> CCCAGACTGAC
GCCCCAAGTAA -> CCCCAAGTAAA
GCCCCGCAGGT -> CCCCGCAGGTC
GCCCCGTGATA -> CCCCGTGATAT
GCCCCTTCTCA -> CCCCTTCTCAG
GCCCGAGGGCC -> CCCGAGGGCCT
GCCCGCGACCG -> CCCGCGACCGG
GCCCTCATTCG -> CCCTCATTCGT
GCCGACGCACG -> CCGACGCACGG
GCCGAGTACCG -> CCGAGTACCGC
GCCGCAGGCGC -> CCGCAGGCGCG
GCCGCTCGCGC -> CCGCTCGCGCA
GCCGGTCTGAG -> CCGGTCTGAGG
GCCGGTGCCGA -> CCGGTGCCGAG
GCCGTAGACTT -> CCGTAGACTTA
GCCTAGCAGGC -> CCTAGCAGGCA
GCCTCCGAGGA -> CCTCCGAGGAA
GCCTCGTGCGT -> CCTCGTGCGTT
GCCTCGTTCTT -> CCTCGTTCTTA
GCCTGGAGTAG -> CCTGGAGTAGC
GCCTGTATACT -> CCTGTATACTA
GCCTTAGGTTT -> CCTTAGGTTTC
GCCTTTAAGCC -> CCTTTAAGCCG
GCCTTTTCATC -> CCTTTTCATCT
GCGAATTAAGC -> CGAATTAAGCT
GCGAATTGAAA -> CGAATTGAAAC
GCGACCGGCAT -> CGACCGGCATT
GCGAGTTATTG -> CGAGTTATTGC
GCGATAGTGGC -> CGATAGTGGCC
GCGATTATAAG -> CGATTATAAGA
GCGATTCCCCA -> CGATTCCCCAC
GCGATTCCTAT -> CGATTCCTATT
GCGATTTAACA -> CGATTTAACAT
GCGCAATAGAC -> CGCAATAGACT
GCGCAGGTATA -> CGCAGGTATAT
GCGCGGACAGA -> CGCGGACAGAA
GCGCTAATTAG -> CGCTAATTAGT
GCGCTCAACAT -> CGCTCAACATT
GCGGACAGAAG -> CGGACAGAAGC
GCGGAGACAGA -> CGGAGACAGAT
GCGGATTTACA -> CGGATTTACAG
GCGGCATACCA -> CGGCATACCAT
GCGGCCTCGTG -> CGGCCTCGTGC
GCGGGATGTTT -> CGGGATGTTTG
GCGGTCACCAG -> CGGTCACCAGT
GCGGTGGTGAG -> CGGTGGTGAGG
GCGGTGTAGTG -> CGGTGTAGTGC
GCGTAACGTTG -> CGTAACGTTGG
GCGTTAGATGA -> CGTTAGATGAT
GCTAAGACGTG -> CTAAGACGTGT
GCTAATTAGTA -> CTAATTAGTAC
GCTAGGCGCAA -> CTAGGCGCAAT
GCTAGGGCCCG -> CTAGGGCCCGC
GCTAGGGTGGG -> CTAGGGTGGGT
GCTCAACATTC -> CTCAACATTCA
GCTCAACCTTG -> CTCAACCTTGC
GCTCACCCAGA -> CTCACCCAGAT
GCTCAGAGGGC -> CTCAGAGGGCT
GCTCAGCTTTC -> CTCAGCTTTCA
GCTCATAGGGA -> CTCATAGGGAG
GCTCCAACAGC -> CTCCAACAGCG
GCTCCAGACAA -> CTCCAGACAAG
GCTCCCGTGAC -> CTCCCGTGACT
GCTCCTCGACC -> CTCCTCGACCT
GCTCCTTGCTG -> CTCCTTGCTGT
GCTCGCGCAGG -> CTCGCGCAGGT
GCTCTCACTCT -> CTCTCACTCTT
GCTCTCGTGTA -> CTCTCGTGTAG
GCTGAACCATC -> CTGAACCATCT
GCTGAAGCTCT -> CTGAAGCTCTC
GCTGTATTGAG -> CTGTATTGAGG
GCTGTGCCAAC -> CTGTGCCAACA
GCTTAACCCTT -> CTTAACCCTTC
GCTTAATGCTC -> CTTAATGCTCC
GCTTCGAATAT -> CTTCGAATATA
GCTTCGGTCTC -> CTTCGGTCTCG
GCTTGAAGACT -> CTTGAAGACTC
GCTTGAATCGC -> CTTGAATCGCG
GCTTGCTCCCG -> CTTGCTCCCGT
GCTTGCTTGCT -> CTTGCTTGCTT
GCTTGCTTTCC -> CTTGCTTTCCC
GCTTTACCCAA -> CTTTACCCAAA
GCTTTCATAAC -> CTTTCATAACA
GCTTTCCCTAA -> CTTTCCCTAAC
GCTTTGCCGAC -> CTTTGCCGACG
GGAAACCAACT -> GAAACCAACTG
GGAACCCTGCG -> GAACCCTGCGG
GGAATCTTCAC -> GAATCTTCACT
GGACAGAAGCA -> GACAGAAGCAC
GGACCCTAATG -> GACCCTAATGG
GGACCGTCGAC -> GACCGTCGACG
GGACGCCCGAG -> GACGCCCGAGG
GGACGTGTATC -> GACGTGTATCC
GGACTCAAATA -> GACTCAAATAC
GGACTTCTAAG -> GACTTCTAAGG
GGAGAATACAG -> GAGAATACAGG
GGAGAATATCT -> GAGAATATCTC
GGAGACAGATG -> GAGACAGATGA
GGAGACGCTCA -> GAGACGCTCAT
GGAGATGCAGG -> GAGATGCAGGC
GGAGCGAATTG -> GAGCGAATTGA
GGAGGTGTGGG -> GAGGTGTGGGG
GGAGTAAATGC -> GAGTAAATGCC
GGAGTAAGCCC -> GAGTAAGCCCC
GGAGTAGCCCA -> GAGTAGCCCAA
GGAGTCCTCAG -> GAGTCCTCAGC
GGAGTGCACTC -> GAGTGCACTCC
GGAGTGTAATC -> GAGTGTAATCA
GGAGTTTACTG -> GAGTTTACTGA
GGATGTTTGAG -> GATGTTTGAGG
GGATTTACAGG -> GATTTACAGGC
GGCAAAAACAG -> GCAAAAACAGA
GGCAAGTACGA -> GCAAGTACGAG
GGCAATGGGCA -> GCAATGGGCAT
GGCAGAATGCC -> GCAGAATGCCA
GGCATACCATC -> GCATACCATCG
GGCATTCCCTG -> GCATTCCCTGA
GGCATTCGCGA -> GCATTCGCGAT
GGCCAAAAACA -> GCCAAAAACAT
GGCCAACAAGC -> GCCAACAAGCC
GGCCACCTAAC -> GCCACCTAACT
GGCCAGTAATA -> GCCAGTAATAG
GGCCCAGACTG -> GCCCAGACTGA
GGCCCCGCAGG -> GCCCCGCAGGT
GGCCCCTTCTC -> GCCCCTTCTCA
GGCCCGCGACC -> GCCCGCGACCG
GGCCTCGTGCG -> GCCTCGTGCGT
GGCCTCGTTCT -> GCCTCGTTCTT
GGCCTGTATAC -> GCCTGTATACT
GGCCTTTAAGC -> GCCTTTAAGCC
GGCGAATTAAG -> GCGAATTAAGC
GGCGCAATAGA -> GCGCAATAGAC
GGCGCGGACAG -> GCGCGGACAGA
GGCGTAACGTT -> GCGTAACGTTG
GGCTAGGCGCA -> GCTAGGCGCAA
GGCTCAGCTTT -> GCTCAGCTTTC
GGCTTAACCCT -> GCTTAACCCTT
GGCTTGAAGAC -> GCTTGAAGACT
GGCTTGCTCCC -> GCTTGCTCCCG
GGCTTTACCCA -> GCTTTACCCAA
GGCTTTGCCGA -> GCTTTGCCGAC
GGGACTCAAAT -> GGACTCAAATA
GGGACTTCTAA -> GGACTTCTAAG
GGGAGAATACA -> GGAGAATACAG
GGGAGAATATC -> GGAGAATATCT
GGGAGTAAATG -> GGAGTAAATGC
GGGAGTAAGCC -> GGAGTAAGCCC
GGGAGTGCACT -> GGAGTGCACTC
GGGAGTGTAAT -> GGAGTGTAATC
GGGAGTTTACT -> GGAGTTTACTG
GGGATGTTTGA -> GGATGTTTGAG
GGGCAAAAACA -> GGCAAAAACAG
GGGCAGAATGC -> GGCAGAATGCC
GGGCATTCCCT -> GGCATTCCCTG
GGGCCCCGCAG -> GGCCCCGCAGG
GGGCCCCTTCT -> GGCCCCTTCTC
GGGCCCGCGAC -> GGCCCGCGACC
GGGCCTTTAAG -> GGCCTTTAAGC
GGGCTCAGCTT -> GGCTCAGCTTT
GGGCTTGAAGA -> GGCTTGAAGAC
GGGGAGTAAGC -> GGGAGTAAGCC
GGGGAGTGTAA -> GGGAGTGTAAT
GGGGTTTGGGC -> GGGTTTGGGCC
GGGTAAATGCA -> GGTAAATGCAA
GGGTATGCTGT -> GGTATGCTGTA
GGGTGAATGCT -> GGTGAATGCTT
GGGTGCTGAAG -> GGTGCTGAAGC
GGGTGGACGTG -> GGTGGACGTGT
GGGTGGGTATG -> GGTGGGTATGC
GGGTTTGGGCC -> GGTTTGGGCCC
GGTAAATGCAA -> GTAAATGCAAT
GGTAGTACGCA -> GTAGTACGCAT
GGTATAGGGAG -> GTATAGGGAGA
GGTATATAAAG -> GTATATAAAGA
GGTATATCGTA -> GTATATCGTAG
GGTATGCTGTA -> GTATGCTGTAT
GGTCACCAGTG -> GTCACCAGTGT
GGTCCAACAGG -> GTCCAACAGGT
GGTCGCCTGGA -> GTCGCCTGGAG
GGTCGGGTGCT -> GTCGGGTGCTG
GGTCTAGAAGA -> GTCTAGAAGAG
GGTCTCGGGTG -> GTCTCGGGTGG
GGTCTGAGGTA -> GTCTGAGGTAT
GGTGAATGCTT -> GTGAATGCTTA
GGTGAGGTGCA -> GTGAGGTGCAG
GGTGCAGCGCT -> GTGCAGCGCTC
GGTGCCGAGTA -> GTGCCGAGTAC
GGTGCGGGATG -> GTGCGGGATGT
GGTGCTAGGGT -> GTGCTAGGGTG
GGTGCTGAAGC -> GTGCTGAAGCT
GGTGCTTGCTT -> GTGCTTGCTTG
GGTGGACGTGT -> GTGGACGTGTA
GGTGGGTATGC -> GTGGGTATGCT
GGTGGTGAGGT -> GTGGTGAGGTG
GGTGTAGTGCA -> GTGTAGTGCAT
GGTGTCGTAAT -> GTGTCGTAATA
GGTGTGGGGAG -> GTGTGGGGAGT
GGTTATTATCT -> GTTATTATCTG
GGTTGCAGTGA -> GTTGCAGTGAT
GGTTGCGATTC -> GTTGCGATTCC
GGTTTCCTGCT -> GTTTCCTGCTC
GGTTTCGCAAG -> GTTTCGCAAGG
GGTTTGGGCCC -> GTTTGGGCCCC
GTAAAGCCCCG -> TAAAGCCCCGT
GTAAAGTAGCG -> TAAAGTAGCGG
GTAAATGCAAT -> TAAATGCAATC
GTAAATGCCCT -> TAAATGCCCTC
GTAACGTTGGG -> TAACGTTGGGG
GTAAGCCCCAA -> TAAGCCCCAAG
GTAAGGAGATG -> TAAGGAGATGC
GTAATACGAGG -> TAATACGAGGC
GTAATAGCAAT -> TAATAGCAATC
GTAATCACGTT -> TAATCACGTTT
GTACCGCGATT -> TACCGCGATTA
GTACCGTGCGC -> TACCGTGCGCT
GTACGAGGAAC -> TACGAGGAACC
GTACGCAAGAT -> TACGCAAGATT
GTACGCATTCA -> TACGCATTCAC
GTACTACAGGA -> TACTACAGGAG
GTACTGCACAT -> TACTGCACATA
GTAGACCTTTT -> TAGACCTTTTA
GTAGACTTAAC -> TAGACTTAACC
GTAGCCCAAAC -> TAGCCCAAACC
GTAGCGAGTTA -> TAGCGAGTTAT
GTAGCGGCCTC -> TAGCGGCCTCG
GTAGGAATCTT -> TAGGAATCTTC
GTAGTACGCAT -> TAGTACGCATT
GTAGTCACCGT -> TAGTCACCGTT
GTAGTGCATGT -> TAGTGCATGTG
GTATACTAAGG -> TATACTAAGGC
GTATACTTGCA -> TATACTTGCAG
GTATAGGGAGA -> TATAGGGAGAA
GTATATAAAGA -> TATATAAAGAA
GTATATCGTAG -> TATATCGTAGT
GTATCCACATT -> TATCCACATTA
GTATCGACCAC -> TATCGACCACA
GTATGCTGTAT -> TATGCTGTATT
GTATTGAGGTA -> TATTGAGGTAG
GTCACCAGTGT -> TCACCAGTGTA
GTCACCGTTAT -> TCACCGTTATG
GTCAGATAGCA -> TCAGATAGCAG
GTCCAACAGGT -> TCCAACAGGTG
GTCCAACCCGT -> TCCAACCCGTC
GTCCTCAGCGG -> TCCTCAGCGGA
GTCGACGACGG -> TCGACGACGGT
GTCGCCTGGAG -> TCGCCTGGAGT
GTCGGCGAATT -> TCGGCGAATTA
GTCGGGTGCTG -> TCGGGTGCTGA
GTCGTAATACG -> TCGTAATACGA
GTCGTTTGGGC -> TCGTTTGGGCA
GTCTAGAAGAG -> TCTAGAAGAGG
GTCTCAGGTTA -> TCTCAGGTTAT
GTCTCGATGCA -> TCTCGATGCAC
GTCTCGGGTGG -> TCTCGGGTGGA
GTCTCGTAGCG -> TCTCGTAGCGA
GTCTGAGGTAT -> TCTGAGGTATA
GTGAATGCTTA -> TGAATGCTTAA
GTGACAGATAG -> TGACAGATAGC
GTGACTCGGTT -> TGACTCGGTTT
GTGAGCATCGC -> TGAGCATCGCC
GTGAGGTGCAG -> TGAGGTGCAGC
GTGATATTTTG -> TGATATTTTGT
GTGATGTATCG -> TGATGTATCGA
GTGCACTCCGT -> TGCACTCCGTC
GTGCAGCGCTC -> TGCAGCGCTCA
GTGCATGTGGT -> TGCATGTGGTC
GTGCCAACACG -> TGCCAACACGA
GTGCCGAGTAC -> TGCCGAGTACC
GTGCCGGTCTG -> TGCCGGTCTGA
GTGCGCTAATT -> TGCGCTAATTA
GTGCGGGATGT -> TGCGGGATGTT
GTGCGTTAGAT -> TGCGTTAGATG
GTGCTAGGGTG -> TGCTAGGGTGG
GTGCTGAAGCT -> TGCTGAAGCTC
GTGCTTGCTTG -> TGCTTGCTTGC
GTGGACGTGTA -> TGGACGTGTAT
GTGGCCACCTA -> TGGCCACCTAA
GTGGCCCAGAC -> TGGCCCAGACT
GTGGCTTAACC -> TGGCTTAACCC
GTGGGGAGTGT -> TGGGGAGTGTA
GTGGGTATGCT -> TGGGTATGCTG
GTGGTCCAACA -> TGGTCCAACAG
GTGGTCGCCTG -> TGGTCGCCTGG
GTGGTGAGGTG -> TGGTGAGGTGC
GTGTAATCACG -> TGTAATCACGT
GTGTACCGTGC -> TGTACCGTGCG
GTGTAGGAATC -> TGTAGGAATCT
GTGTAGTGCAT -> TGTAGTGCATG
GTGTATCCACA -> TGTATCCACAT
GTGTCGTAATA -> TGTCGTAATAC
GTGTGGCCACC -> TGTGGCCACCT
GTGTGGGGAGT -> TGTGGGGAGTG
GTGTTCGCTCC -> TGTTCGCTCCT
GTTAACCATGG -> TTAACCATGGT
GTTACAATTAG -> TTACAATTAGA
GTTACGAAGTA -> TTACGAAGTAC
GTTACGGTGCT -> TTACGGTGCTA
GTTAGATGATC -> TTAGATGATCT
GTTATGTTCCG -> TTATGTTCCGA
GTTATTATCTG -> TTATTATCTGA
GTTATTGCATC -> TTATTGCATCC
GTTCCGAGTAA -> TTCCGAGTAAA
GTTCGCTCCTT -> TTCGCTCCTTG
GTTCTTAGCCT -> TTCTTAGCCTT
GTTCTTTTGAG -> TTCTTTTGAGG
GTTGCAGTGAT -> TTGCAGTGATG
GTTGCGATTCC -> TTGCGATTCCC
GTTGCTCACCC -> TTGCTCACCCA
GTTGGGGTTTG -> TTGGGGTTTGG
GTTTACTGATT -> TTTACTGATTG
GTTTCCTGCTC -> TTTCCTGCTCT
GTTTCGCAAGG -> TTTCGCAAGGA
GTTTGAGGACC -> TTTGAGGACCG
GTTTGCACAAT -> TTTGCACAATA
GTTTGGGCAAA -> TTTGGGCAAAA
GTTTGGGCCCC -> TTTGGGCCCCT
GTTTTCAATGT -> TTTTCAATGTG
GTTTTTTGTTA -> TTTTTTGTTAC
TAAAGAAAACA -> AAAGAAAACAC
TAAAGAACTCG -> AAAGAACTCGA
TAAAGCCCCGT -> AAAGCCCCGTG
TAAAGTAGCGG -> AAAGTAGCGGC
TAAATGCAATC -> AAATGCAATCC
TAAATGCCCTC -> AAATGCCCTCA
TAAATTGCTAG -> AAATTGCTAGG
TAACATAGCTA -> AACATAGCTAA
TAACATGTCTC -> AACATGTCTCG
TAACATTGGGA -> AACATTGGGAG
TAACCATGGTG -> AACCATGGTGT
TAACCCTTCGG -> AACCCTTCGGG
TAACCGGGACT -> AACCGGGACTT
TAACCGTGTTC -> AACCGTGTTCG
TAACCTCCTGC -> AACCTCCTGCC
TAACGGGCTCA -> AACGGGCTCAG
TAACGTACTAC -> AACGTACTACA
TAACGTTGGGG -> AACGTTGGGGT
TAACTGCAAAA -> AACTGCAAAAA
TAAGACATCAC -> AAGACATCACT
TAAGACGTGTG -> AAGACGTGTGG
TAAGAGTCGGC -> AAGAGTCGGCG
TAAGCCCCAAG -> AAGCCCCAAGT
TAAGCCGGTGC -> AAGCCGGTGCC
TAAGCTCAGAG -> AAGCTCAGAGG
TAAGGAGATGC -> AAGGAGATGCA
TAAGGCCAACA -> AAGGCCAACAA
TAAGGCTTGCT -> AAGGCTTGCTC
TAATACGAGGC -> AATACGAGGCG
TAATAGCAATC -> AATAGCAATCG
TAATCACGTTT -> AATCACGTTTT
TAATGCTCCTC -> AATGCTCCTCG
TAATGGGTAAA -> AATGGGTAAAT
TAATTAGTACG -> AATTAGTACGC
TACAATAAGAC -> ACAATAAGACA
TACAATCGCTG -> ACAATCGCTGA
TACAATTAGAT -> ACAATTAGATA
TACAGGAGGTG -> ACAGGAGGTGT
TACAGGCCAAA -> ACAGGCCAAAA
TACAGGCTTTG -> ACAGGCTTTGC
TACCAAACTCC -> ACCAAACTCCT
TACCATCGCAG -> ACCATCGCAGG
TACCCAAAAGA -> ACCCAAAAGAA
TACCGCGATTA -> ACCGCGATTAT
TACCGTGCGCT -> ACCGTGCGCTA
TACCTGATGCC -> ACCTGATGCCA
TACGAAGTACT -> ACGAAGTACTG
TACGAGGAACC -> ACGAGGAACCC
TACGAGGCGTA -> ACGAGGCGTAA
TACGCAAGATT -> ACGCAAGATTT
TACGCATTCAC -> ACGCATTCACC
TACGGTGCTAG -> ACGGTGCTAGG
TACTAAGGCCA -> ACTAAGGCCAA
TACTACAGGAG -> ACTACAGGAGG
TACTCATACTT -> ACTCATACTTT
TACTGATTGCA -> ACTGATTGCAT
TACTGCACATA -> ACTGCACATAG
TACTTGCAGCA -> ACTTGCAGCAT
TACTTTCAATC -> ACTTTCAATCG
TAGAAGAGGGT -> AGAAGAGGGTG
TAGACCGATGA -> AGACCGATGAT
TAGACCTTTTA -> AGACCTTTTAC
TAGACTCATAT -> AGACTCATATT
TAGACTTAACC -> AGACTTAACCT
TAGATAGTTCT -> AGATAGTTCTT
TAGATGATCTG -> AGATGATCTGG
TAGATTTCAAT -> AGATTTCAATT
TAGCAATCGTG -> AGCAATCGTGA
TAGCAGGAGAC -> AGCAGGAGACG
TAGCAGGCAAT -> AGCAGGCAATG
TAGCCCAAACC -> AGCCCAAACCT
TAGCCGTAGAC -> AGCCGTAGACT
TAGCCTTAGGT -> AGCCTTAGGTT
TAGCGAGTTAT -> AGCGAGTTATT
TAGCGGCCTCG -> AGCGGCCTCGT
TAGCTAAGACG -> AGCTAAGACGT
TAGGAATCTTC -> AGGAATCTTCA
TAGGCGCAATA -> AGGCGCAATAG
TAGGCTAGGCG -> AGGCTAGGCGC
TAGGGAGAATA -> AGGGAGAATAC,AGGGAGAATAT
TAGGGCCCGCG -> AGGGCCCGCGA
TAGGGTGGGTA -> AGGGTGGGTAT
TAGGTTTCGCA -> AGGTTTCGCAA
TAGTACGCAAG -> AGTACGCAAGA
TAGTACGCATT -> AGTACGCATTC
TAGTAGACCTT -> AGTAGACCTTT
TAGTCACCGTT -> AGTCACCGTTA
TAGTGCATGTG -> AGTGCATGTGG
TAGTGGCCCAG -> AGTGGCCCAGA
TAGTTCTTTTG -> AGTTCTTTTGA
TATAAAGAAAA -> ATAAAGAAAAC
TATAAGAGTCG -> ATAAGAGTCGG
TATACTAAGGC -> ATACTAAGGCC
TATACTTGCAG -> ATACTTGCAGC
TATAGGGAGAA -> ATAGGGAGAAT
TATATAAAGAA -> ATATAAAGAAA
TATATCGTAGT -> ATATCGTAGTC
TATATTTTTCG -> ATATTTTTCGG
TATCCACATTA -> ATCCACATTAG
TATCGACCACA -> ATCGACCACAC
TATCGTAGTCA -> ATCGTAGTCAC
TATCTCCGGAG -> ATCTCCGGAGC
TATCTGATCGA -> ATCTGATCGAC
TATGAATGTCT -> ATGAATGTCTC
TATGCTGTATT -> ATGCTGTATTG
TATGTTCCGAG -> ATGTTCCGAGT
TATTATCTGAT -> ATTATCTGATC
TATTGAGGTAG -> ATTGAGGTAGT
TATTGCATCCC -> ATTGCATCCCT
TATTTAACGGG -> ATTTAACGGGC
TATTTCACACA -> ATTTCACACAT
TATTTTGTGCC -> ATTTTGTGCCG
TATTTTTCGGA -> ATTTTTCGGAG
TCAAATACAAT -> CAAATACAATA
TCAACATTCAA -> CAACATTCAAG
TCAACCAGCGA -> CAACCAGCGAT
TCAAGTGGTCG -> CAAGTGGTCGC
TCAATCGGGAG -> CAATCGGGAGT
TCAATGTGGCT -> CAATGTGGCTT
TCAATTGGACG -> CAATTGGACGC
TCACACATGGT -> CACACATGGTC
TCACACTGTAA -> CACACTGTAAG
TCACCAGTGTA -> CACCAGTGTAC
TCACCCAGATG -> CACCCAGATGC
TCACCCCCAAC -> CACCCCCAACC
TCACCGTTATG -> CACCGTTATGT
TCACGTTTTTT -> CACGTTTTTTG
TCACTAACCGG -> CACTAACCGGG
TCACTCTTGAC -> CACTCTTGACT
TCACTGGCAAG -> CACTGGCAAGT
TCAGAGGGCTT -> CAGAGGGCTTG
TCAGATAGCAG -> CAGATAGCAGG
TCAGCGGAGAC -> CAGCGGAGACA
TCAGCTTTCAT -> CAGCTTTCATA
TCAGGGCCCCG -> CAGGGCCCCGC
TCAGGTATATC -> CAGGTATATCG
TCAGGTTATTA -> CAGGTTATTAT
TCATAACATGT -> CATAACATGTC
TCATACTTTCA -> CATACTTTCAA
TCATAGGGAGA -> CATAGGGAGAA
TCATATTTAAC -> CATATTTAACG
TCATCTCTGCC -> CATCTCTGCCG
TCATCTTCCTT -> CATCTTCCTTC
TCATTCGTTAC -> CATTCGTTACG
TCCAACAGCGG -> CCAACAGCGGT
TCCAACAGGTG -> CCAACAGGTGC
TCCAACCCGTC -> CCAACCCGTCT
TCCACATTAGG -> CCACATTAGGC
TCCACCTAAAT -> CCACCTAAATT
TCCACGGGGAG -> CCACGGGGAGT
TCCAGACAAGC -> CCAGACAAGCA
TCCAGTTAACC -> CCAGTTAACCA
TCCCCACCCCC -> CCCCACCCCCT
TCCCGTGACTC -> CCCGTGACTCG
TCCCTAACGTA -> CCCTAACGTAC
TCCCTCCGCCT -> CCCTCCGCCTT
TCCCTGAGTTT -> CCCTGAGTTTG
TCCCTTGTATA -> CCCTTGTATAC
TCCGACGCTTC -> CCGACGCTTCG
TCCGAGGAAAC -> CCGAGGAAACC
TCCGAGTAAAG -> CCGAGTAAAGC
TCCGCCTTTTC -> CCGCCTTTTCA
TCCGGAGCGAA -> CCGGAGCGAAT
TCCGTCAGATA -> CCGTCAGATAG
TCCTATTTCAC -> CCTATTTCACA
TCCTCAGCGGA -> CCTCAGCGGAG
TCCTCGAAAAC -> CCTCGAAAACA
TCCTCGACCTC -> CCTCGACCTCG
TCCTGCCGCTC -> CCTGCCGCTCG
TCCTGCTCTCA -> CCTGCTCTCAC
TCCTTCCGACG -> CCTTCCGACGC
TCCTTCGAGTT -> CCTTCGAGTTT
TCCTTGCTGTG -> CCTTGCTGTGC
TCGAAAACAAT -> CGAAAACAATT
TCGAATATATT -> CGAATATATTT
TCGAATTTGCT -> CGAATTTGCTT
TCGACCACACC -> CGACCACACCT
TCGACCTCGAA -> CGACCTCGAAT
TCGACGACGGT -> CGACGACGGTT
TCGACTGCGGT -> CGACTGCGGTC
TCGAGTTTTCA -> CGAGTTTTCAA
TCGATCCTCGA -> CGATCCTCGAA
TCGATCTTGTC -> CGATCTTGTCC
TCGATGCACAG -> CGATGCACAGA
TCGCAAGGACC -> CGCAAGGACCC
TCGCAGGTGCG -> CGCAGGTGCGG
TCGCCAACCTT -> CGCCAACCTTT
TCGCCTGGAGT -> CGCCTGGAGTA
TCGCGATAGTG -> CGCGATAGTGG
TCGCGCAGGTA -> CGCGCAGGTAT
TCGCGGTGGTG -> CGCGGTGGTGA
TCGCTCCAACA -> CGCTCCAACAG
TCGCTCCTTGC -> CGCTCCTTGCT
TCGCTGAACCA -> CGCTGAACCAT
TCGGAGTCCTC -> CGGAGTCCTCA
TCGGCGAATTA -> CGGCGAATTAA
TCGGGAGTAAA -> CGGGAGTAAAT
TCGGGCAGAAT -> CGGGCAGAATG
TCGGGTGCTGA -> CGGGTGCTGAA
TCGGGTGGACG -> CGGGTGGACGT
TCGGTCTCGGG -> CGGTCTCGGGT
TCGGTTTCCTG -> CGGTTTCCTGC
TCGTAATACGA -> CGTAATACGAG
TCGTAGCGAGT -> CGTAGCGAGTT
TCGTAGTCACC -> CGTAGTCACCG
TCGTCGTTTGG -> CGTCGTTTGGG
TCGTGAGCATC -> CGTGAGCATCG
TCGTGCGTTAG -> CGTGCGTTAGA
TCGTGTAGGAA -> CGTGTAGGAAT
TCGTTACGAAG -> CGTTACGAAGT
TCGTTCTTAGC -> CGTTCTTAGCC
TCGTTGCTCAC -> CGTTGCTCACC
TCGTTTGGGCA -> CGTTTGGGCAA
TCTAAGGCTTG -> CTAAGGCTTGC
TCTAGAAGAGG -> CTAGAAGAGGG
TCTCACTCTTG -> CTCACTCTTGA
TCTCAGGTATA -> CTCAGGTATAT
TCTCAGGTTAT -> CTCAGGTTATT
TCTCCAGTTAA -> CTCCAGTTAAC
TCTCCGGAGCG -> CTCCGGAGCGA
TCTCGATGCAC -> CTCGATGCACA
TCTCGGGTGGA -> CTCGGGTGGAC
TCTCGTAGCGA -> CTCGTAGCGAG
TCTCGTGTAGG -> CTCGTGTAGGA
TCTCTGCCGCA -> CTCTGCCGCAG
TCTGAGGTATA -> CTGAGGTATAG
TCTGATCGACT -> CTGATCGACTG
TCTGCCGCAGG -> CTGCCGCAGGC
TCTGGGACTCA -> CTGGGACTCAA
TCTTAGCCTTA -> CTTAGCCTTAG
TCTTCACACTG -> CTTCACACTGT
TCTTCACTGGC -> CTTCACTGGCA
TCTTCCTTCGA -> CTTCCTTCGAG
TCTTGACTTTC -> CTTGACTTTCG
TCTTGTCCAAC -> CTTGTCCAACC
TCTTTTGAGGC -> CTTTTGAGGCC
TGAAACCAAAC -> GAAACCAAACG
TGAACCATCTT -> GAACCATCTTC
TGAAGACTCGT -> GAAGACTCGTT
TGAAGCTCTCG -> GAAGCTCTCGT
TGAATCGCGGT -> GAATCGCGGTG
TGAATGCTTAA -> GAATGCTTAAT
TGAATGTCTCG -> GAATGTCTCGA
TGAATTCGTCG -> GAATTCGTCGT
TGACAGATAGC -> GACAGATAGCC
TGACCAGATTC -> GACCAGATTCC
TGACTCGGTTT -> GACTCGGTTTC
TGACTTTCGCT -> GACTTTCGCTC
TGAGCATCGCC -> GAGCATCGCCA
TGAGGACCGTC -> GAGGACCGTCG
TGAGGCCAGTA -> GAGGCCAGTAA
TGAGGTAGTAC -> GAGGTAGTACG
TGAGGTATAGG -> GAGGTATAGGG
TGAGGTGCAGC -> GAGGTGCAGCG
TGAGTTTGCAC -> GAGTTTGCACA
TGATATTTTGT -> GATATTTTGTG
TGATCGACTGC -> GATCGACTGCG
TGATCTGGGAC -> GATCTGGGACT
TGATGCCACTT -> GATGCCACTTG
TGATGGCTTTA -> GATGGCTTTAC
TGATGTATCGA -> GATGTATCGAC
TGATTGCATAC -> GATTGCATACA
TGCAAAAATGC -> GCAAAAATGCA
TGCAATCCACC -> GCAATCCACCT
TGCACAATACC -> GCACAATACCA
TGCACAGACAA -> GCACAGACAAC
TGCACATAGAT -> GCACATAGATT
TGCACCTCATC -> GCACCTCATCT
TGCACTCCGTC -> GCACTCCGTCA
TGCAGCATGCT -> GCAGCATGCTC
TGCAGCGCTCA -> GCAGCGCTCAA
TGCAGGCCTCG -> GCAGGCCTCGT
TGCAGTGATGT -> GCAGTGATGTA
TGCATACAATC -> GCATACAATCG
TGCATCCCTTG -> GCATCCCTTGT
TGCATGTGGTC -> GCATGTGGTCC
TGCCAACACGA -> GCCAACACGAA
TGCCACTTGCG -> GCCACTTGCGG
TGCCAGCAGCT -> GCCAGCAGCTT
TGCCCTCATTC -> GCCCTCATTCG
TGCCGACGCAC -> GCCGACGCACG
TGCCGAGTACC -> GCCGAGTACCG
TGCCGCAGGCG -> GCCGCAGGCGC
TGCCGCTCGCG -> GCCGCTCGCGC
TGCCGGTCTGA -> GCCGGTCTGAG
TGCGATTCCCC -> GCGATTCCCCA
TGCGATTTAAC -> GCGATTTAACA
TGCGCTAATTA -> GCGCTAATTAG
TGCGGATTTAC -> GCGGATTTACA
TGCGGCATACC -> GCGGCATACCA
TGCGGGATGTT -> GCGGGATGTTT
TGCGGTCACCA -> GCGGTCACCAG
TGCGTTAGATG -> GCGTTAGATGA
TGCTAGGGCCC -> GCTAGGGCCCG
TGCTAGGGTGG -> GCTAGGGTGGG
TGCTCAACCTT -> GCTCAACCTTG
TGCTCACCCAG -> GCTCACCCAGA
TGCTCCAGACA -> GCTCCAGACAA
TGCTCCCGTGA -> GCTCCCGTGAC
TGCTCCTCGAC -> GCTCCTCGACC
TGCTCTCACTC -> GCTCTCACTCT
TGCTGAAGCTC -> GCTGAAGCTCT
TGCTGTATTGA -> GCTGTATTGAG
TGCTGTGCCAA -> GCTGTGCCAAC
TGCTTAATGCT -> GCTTAATGCTC
TGCTTGAATCG -> GCTTGAATCGC
TGCTTGCTTGC -> GCTTGCTTGCT
TGCTTGCTTTC -> GCTTGCTTTCC
TGCTTTCCCTA -> GCTTTCCCTAA
TGGACGCCCGA -> GGACGCCCGAG
TGGACGTGTAT -> GGACGTGTATC
TGGAGTAGCCC -> GGAGTAGCCCA
TGGCAAGTACG -> GGCAAGTACGA
TGGCCACCTAA -> GGCCACCTAAC
TGGCCCAGACT -> GGCCCAGACTG
TGGCTTAACCC -> GGCTTAACCCT
TGGCTTTACCC -> GGCTTTACCCA
TGGGACTCAAA -> GGGACTCAAAT
TGGGAGTGCAC -> GGGAGTGCACT
TGGGCAAAAAC -> GGGCAAAAACA
TGGGCATTCCC -> GGGCATTCCCT
TGGGCCCCTTC -> GGGCCCCTTCT
TGGGGAGTGTA -> GGGGAGTGTAA
TGGGGTTTGGG -> GGGGTTTGGGC
TGGGTAAATGC -> GGGTAAATGCA
TGGGTATGCTG -> GGGTATGCTGT
TGGTCCAACAG -> GGTCCAACAGG
TGGTCGCCTGG -> GGTCGCCTGGA
TGGTCTAGAAG -> GGTCTAGAAGA
TGGTGAGGTGC -> GGTGAGGTGCA
TGGTGTCGTAA -> GGTGTCGTAAT
TGTAAGGAGAT -> GTAAGGAGATG
TGTAATCACGT -> GTAATCACGTT
TGTACCGTGCG -> GTACCGTGCGC
TGTAGGAATCT -> GTAGGAATCTT
TGTAGTGCATG -> GTAGTGCATGT
TGTATACTAAG -> GTATACTAAGG
TGTATACTTGC -> GTATACTTGCA
TGTATCCACAT -> GTATCCACATT
TGTATCGACCA -> GTATCGACCAC
TGTATTGAGGT -> GTATTGAGGTA
TGTCCAACCCG -> GTCCAACCCGT
TGTCGTAATAC -> GTCGTAATACG
TGTCTCGATGC -> GTCTCGATGCA
TGTCTCGTAGC -> GTCTCGTAGCG
TGTGACAGATA -> GTGACAGATAG
TGTGCCAACAC -> GTGCCAACACG
TGTGCCGGTCT -> GTGCCGGTCTG
TGTGGCCACCT -> GTGGCCACCTA
TGTGGCTTAAC -> GTGGCTTAACC
TGTGGGGAGTG -> GTGGGGAGTGT
TGTGGTCCAAC -> GTGGTCCAACA
TGTTACGGTGC -> GTTACGGTGCT
TGTTCCGAGTA -> GTTCCGAGTAA
TGTTCGCTCCT -> GTTCGCTCCTT
TGTTTGAGGAC -> GTTTGAGGACC
TTAACATAGCT -> TAACATAGCTA
TTAACATTGGG -> TAACATTGGGA
TTAACCATGGT -> TAACCATGGTG
TTAACCCTTCG -> TAACCCTTCGG
TTAACCGTGTT -> TAACCGTGTTC
TTAACCTCCTG -> TAACCTCCTGC
TTAACGGGCTC -> TAACGGGCTCA
TTAAGCCGGTG -> TAAGCCGGTGC
TTAAGCTCAGA -> TAAGCTCAGAG
TTAATGCTCCT -> TAATGCTCCTC
TTACAATTAGA -> TACAATTAGAT
TTACAGGCTTT -> TACAGGCTTTG
TTACCCAAAAG -> TACCCAAAAGA
TTACCTGATGC -> TACCTGATGCC
TTACGAAGTAC -> TACGAAGTACT
TTACGGTGCTA -> TACGGTGCTAG
TTACTCATACT -> TACTCATACTT
TTACTGATTGC -> TACTGATTGCA
TTAGATAGTTC -> TAGATAGTTCT
TTAGATGATCT -> TAGATGATCTG
TTAGCCTTAGG -> TAGCCTTAGGT
TTAGGCTAGGC -> TAGGCTAGGCG
TTAGGTTTCGC -> TAGGTTTCGCA
TTAGTACGCAA -> TAGTACGCAAG
TTATAAGAGTC -> TATAAGAGTCG
TTATCTGATCG -> TATCTGATCGA
TTATGTTCCGA -> TATGTTCCGAG
TTATTATCTGA -> TATTATCTGAT
TTATTGCATCC -> TATTGCATCCC
TTCAAGTGGTC -> TCAAGTGGTCG
TTCAATCGGGA -> TCAATCGGGAG
TTCAATGTGGC -> TCAATGTGGCT
TTCAATTGGAC -> TCAATTGGACG
TTCACACATGG -> TCACACATGGT
TTCACACTGTA -> TCACACTGTAA
TTCACCCCCAA -> TCACCCCCAAC
TTCACTGGCAA -> TCACTGGCAAG
TTCATAACATG -> TCATAACATGT
TTCATCTTCCT -> TCATCTTCCTT
TTCCACGGGGA -> TCCACGGGGAG
TTCCCCACCCC -> TCCCCACCCCC
TTCCCTAACGT -> TCCCTAACGTA
TTCCCTCCGCC -> TCCCTCCGCCT
TTCCCTGAGTT -> TCCCTGAGTTT
TTCCGACGCTT -> TCCGACGCTTC
TTCCGAGTAAA -> TCCGAGTAAAG
TTCCTATTTCA -> TCCTATTTCAC
TTCCTGCTCTC -> TCCTGCTCTCA
TTCCTTCGAGT -> TCCTTCGAGTT
TTCGAATATAT -> TCGAATATATT
TTCGAGTTTTC -> TCGAGTTTTCA
TTCGCAAGGAC -> TCGCAAGGACC
TTCGCGATAGT -> TCGCGATAGTG
TTCGCTCCAAC -> TCGCTCCAACA
TTCGCTCCTTG -> TCGCTCCTTGC
TTCGGAGTCCT -> TCGGAGTCCTC
TTCGGGCAGAA -> TCGGGCAGAAT
TTCGGTCTCGG -> TCGGTCTCGGG
TTCGTCGTTTG -> TCGTCGTTTGG
TTCGTTACGAA -> TCGTTACGAAG
TTCTAAGGCTT -> TCTAAGGCTTG
TTCTCAGGTAT -> TCTCAGGTATA
TTCTTAGCCTT -> TCTTAGCCTTA
TTCTTTTGAGG -> TCTTTTGAGGC
TTGAAACCAAA -> TGAAACCAAAC
TTGAAGACTCG -> TGAAGACTCGT
TTGAATCGCGG -> TGAATCGCGGT
TTGACTTTCGC -> TGACTTTCGCT
TTGAGGACCGT -> TGAGGACCGTC
TTGAGGCCAGT -> TGAGGCCAGTA
TTGAGGTAGTA -> TGAGGTAGTAC
TTGCACAATAC -> TGCACAATACC
TTGCAGCATGC -> TGCAGCATGCT
TTGCAGTGATG -> TGCAGTGATGT
TTGCATACAAT -> TGCATACAATC
TTGCATCCCTT -> TGCATCCCTTG
TTGCCGACGCA -> TGCCGACGCAC
TTGCGATTCCC -> TGCGATTCCCC
TTGCGGATTTA -> TGCGGATTTAC
TTGCTAGGGCC -> TGCTAGGGCCC
TTGCTCACCCA -> TGCTCACCCAG
TTGCTCCCGTG -> TGCTCCCGTGA
TTGCTGTGCCA -> TGCTGTGCCAA
TTGCTTGAATC -> TGCTTGAATCG
TTGCTTGCTTT -> TGCTTGCTTTC
TTGCTTTCCCT -> TGCTTTCCCTA
TTGGACGCCCG -> TGGACGCCCGA
TTGGGAGTGCA -> TGGGAGTGCAC
TTGGGCAAAAA -> TGGGCAAAAAC
TTGGGCCCCTT -> TGGGCCCCTTC
TTGGGGTTTGG -> TGGGGTTTGGG
TTGTATACTTG -> TGTATACTTGC
TTGTCCAACCC -> TGTCCAACCCG
TTGTGCCGGTC -> TGTGCCGGTCT
TTGTTACGGTG -> TGTTACGGTGC
TTTAACATAGC -> TTAACATAGCT
TTTAACATTGG -> TTAACATTGGG
TTTAACGGGCT -> TTAACGGGCTC
TTTAAGCCGGT -> TTAAGCCGGTG
TTTACAGGCTT -> TTACAGGCTTT
TTTACCCAAAA -> TTACCCAAAAG
TTTACCTGATG -> TTACCTGATGC
TTTACTGATTG -> TTACTGATTGC
TTTCAATCGGG -> TTCAATCGGGA
TTTCAATGTGG -> TTCAATGTGGC
TTTCAATTGGA -> TTCAATTGGAC
TTTCACACATG -> TTCACACATGG
TTTCATAACAT -> TTCATAACATG
TTTCATCTTCC -> TTCATCTTCCT
TTTCCCTAACG -> TTCCCTAACGT
TTTCCCTCCGC -> TTCCCTCCGCC
TTTCCTGCTCT -> TTCCTGCTCTC
TTTCGCAAGGA -> TTCGCAAGGAC
TTTCGCTCCAA -> TTCGCTCCAAC
TTTCGGAGTCC -> TTCGGAGTCCT
TTTGAGGACCG -> TTGAGGACCGT
TTTGAGGCCAG -> TTGAGGCCAGT
TTTGCACAATA -> TTGCACAATAC
TTTGCCGACGC -> TTGCCGACGCA
TTTGCTTGAAT -> TTGCTTGAATC
TTTGGGCAAAA -> TTGGGCAAAAA
TTTGGGCCCCT -> TTGGGCCCCTT
TTTGTGCCGGT -> TTGTGCCGGTC
TTTGTTACGGT -> TTGTTACGGTG
TTTTACCTGAT -> TTTACCTGATG
TTTTCAATGTG -> TTTCAATGTGG
TTTTCATCTTC -> TTTCATCTTCC
TTTTCGGAGTC -> TTTCGGAGTCC
TTTTGAGGCCA -> TTTGAGGCCAG
TTTTGTGCCGG -> TTTGTGCCGGT
TTTTGTTACGG -> TTTGTTACGGT
TTTTTCGGAGT -> TTTTCGGAGTC
TTTTTGTTACG -> TTTTGTTACGG
TTTTTTGTTAC -> TTTTTGTTACG
