CCGATCACTAG -> CGATCACTAGA
TTGTAAGATAG -> TGTAAGATAGT
CGTTCGTAGTG -> GTTCGTAGTGT
CAGACCCTGTA -> AGACCCTGTAT
GACTCATACAG -> ACTCATACAGG
ATGCACAAGTA -> TGCACAAGTAG
TTTTATCACTC -> TTTATCACTCT
GATCCGAGCTC -> ATCCGAGCTCT
TCTTAGTTAAA -> CTTAGTTAAAC
TCTCGAATGCA -> CTCGAATGCAC
CGGAGAAGCAG -> GGAGAAGCAGC
GGCCACATAAC -> GCCACATAACG
AGTTAACACAG -> GTTAACACAGC
CGGTTAATTGC -> GGTTAATTGCT
GCACAAGTAGC -> CACAAGTAGCA
CGTGCACAACT -> GTGCACAACTG
CACAGACGGAT -> ACAGACGGATC
CACGATTTAGA -> ACGATTTAGAA
TCCTAGTGAGT -> CCTAGTGAGTG
ATTTGCTTGCC -> TTTGCTTGCCG
CGATTGACCGA -> GATTGACCGAG
GTTCGTAGTGT -> TTCGTAGTGTG
TCGTGGATCTA -> CGTGGATCTAC
AGCTAGAGGCC -> GCTAGAGGCCC
AGCGGACTCAT -> GCGGACTCATA
GAAGGATATTC -> AAGGATATTCA
AGCTAGGAACT -> GCTAGGAACTT
CCCTCTGTTTC -> CCTCTGTTTCC
ACGCGTATTTC -> CGCGTATTTCG
GCACTAAGGGT -> CACTAAGGGTT
GAAGAAACGAA -> AAGAAACGAAA
AACCATCACAC -> ACCATCACACA
GACCGCATTCC -> ACCGCATTCCG
GATTGACCGAG -> ATTGACCGAGG
CTAGCTAGAGG -> TAGCTAGAGGC
CCAGTATGCGC -> CAGTATGCGCG
CAACCATCGTT -> AACCATCGTTC
CCTACATCGGC -> CTACATCGGCC
TACGACGAGGG -> ACGACGAGGGG
TTCTGTCATTG -> TCTGTCATTGA
ACCGAGTGGCC -> CCGAGTGGCCC
GATATTCAAAT -> ATATTCAAATG
GTTCTGGCACT -> TTCTGGCACTG
TTATCACTCTC -> TATCACTCTCC
GTATCCATCAC -> TATCCATCACG
TCGAATGCACA -> CGAATGCACAA
TGAAGGATATT -> GAAGGATATTC
AACAGCTGGGG -> ACAGCTGGGGA
CCTTCTCCCGT -> CTTCTCCCGTG
TACGTAATCCA -> ACGTAATCCAA
AAGATGCGTGC -> AGATGCGTGCT
ACTAGCTAGAG -> CTAGCTAGAGG
GGCCAGTATGC -> GCCAGTATGCG
GATCCTAGTAC -> ATCCTAGTACC
GTATAGGGTTA -> TATAGGGTTAT
CTGGCGTGTAT -> TGGCGTGTATC
GCTCTCTACAA -> CTCTCTACAAC
GTTCGGGACGT -> TTCGGGACGTG
GTAATTACACT -> TAATTACACTA
GTCCCCAAGGG -> TCCCCAAGGGG
TTTATCACTCT -> TTATCACTCTC
AAAGATGCGTG -> AAGATGCGTGC
GGGAGCGCCCC -> GGAGCGCCCCC
AATGTGAACGC -> ATGTGAACGCG
TCAAATGTAGT -> CAAATGTAGTC
TTTGTAGACGA -> TTGTAGACGAC
TTCCAAGTTAA -> TCCAAGTTAAC
ACGAGGAATGC -> CGAGGAATGCC
GGGGAGGCATG -> GGGAGGCATGC
GTGCACAACTG -> TGCACAACTGA
TCTGGCTCACA -> CTGGCTCACAG
TTCTGTACCGG -> TCTGTACCGGT
CCGGTCTTGCA -> CGGTCTTGCAC
ATCAAGCGCCC -> TCAAGCGCCCT
GGAACTCCTAG -> GAACTCCTAGT
ACCGAGGAGAC -> CCGAGGAGACG
TGCTGTCTAGC -> GCTGTCTAGCC
TTAATTGCTTT -> TAATTGCTTTG
CTCTCTAAACT -> TCTCTAAACTA
GGAGACTGCTC -> GAGACTGCTCA
CTGGGGAGAGT -> TGGGGAGAGTC
CAGGACTGCAA -> AGGACTGCAAA
AACGGGCCCGT -> ACGGGCCCGTT
GGATCTGGCGT -> GATCTGGCGTG
AGATGACCCCA -> GATGACCCCAA
TCGCTATTTTC -> CGCTATTTTCG
CACATAACGTG -> ACATAACGTGT
GAGAGCCAGCC -> AGAGCCAGCCA
AAAGGTGCCCT -> AAGGTGCCCTT
CGGATCTGGCG -> GGATCTGGCGT
GCCCTATATCC -> CCCTATATCCC
ATACTCAGAAC -> TACTCAGAACG
GCATACACCAC -> CATACACCACA
CCGCGAGATTC -> CGCGAGATTCC
GGCCCGATGAG -> GCCCGATGAGT
GGCAAGGCTCC -> GCAAGGCTCCC
AATGGTGCCAA -> ATGGTGCCAAA
AGCTTAGGCGT -> GCTTAGGCGTG
CGCGGGACCGA -> GCGGGACCGAG
GGGACGTGCAC -> GGACGTGCACA
CTGGACCCCCC -> TGGACCCCCCC
GCGCATTTAGC -> CGCATTTAGCC
ATTCCGGTTCG -> TTCCGGTTCGC
AGATTTTTCGA -> GATTTTTCGAG
AACGTCAATAA -> ACGTCAATAAG
ATTAGTGCCGA -> TTAGTGCCGAT
GCGTGTCCCCA -> CGTGTCCCCAA
TCGTTGCTGAT -> CGTTGCTGATC
CGTATGGCGGA -> GTATGGCGGAC
TCTGGCACTGC -> CTGGCACTGCA
GATATTTCATT -> ATATTTCATTC
ACTCAGAACGG -> CTCAGAACGGG
AGCAAACAGCA -> GCAAACAGCAG
TAATCCAAATA -> AATCCAAATAA
TTTTTACGCAT -> TTTTACGCATC
CTCCGCTAGAC -> TCCGCTAGACT
GATGCGAGAGA -> ATGCGAGAGAT
GCATCCTTCCC -> CATCCTTCCCC
ATAACATCCTG -> TAACATCCTGG
GTTACTATAAC -> TTACTATAACG
ATTAAGTCACC -> TTAAGTCACCT
CCGAGAGAAAT -> CGAGAGAAATA
TTCCGCGTGTC -> TCCGCGTGTCC
TACTATAACGA -> ACTATAACGAG
CGTATTTCGTG -> GTATTTCGTGG
CTTAGGAAGAA -> TTAGGAAGAAA
ACCGGTCTTGC -> CCGGTCTTGCA
TTTTTTCATCC -> TTTTTCATCCC
TCGTTCCGCGT -> CGTTCCGCGTG
CCTGGGGGCCC -> CTGGGGGCCCG
AACCCCCCGAG -> ACCCCCCGAGA
GTCCGGGCCAG -> TCCGGGCCAGT
GGCGGTAGCCT -> GCGGTAGCCTA
CCCGCGAACAT -> CCGCGAACATT
TCCTTCCCCGG -> CCTTCCCCGGT
AACATCCTGGA -> ACATCCTGGAC
ATTTTCGCTAC -> TTTTCGCTACC
GGAGACGGGGC -> GAGACGGGGCG
CTCCACGCTTC -> TCCACGCTTCG
TACAACAAGAG -> ACAACAAGAGT
TACGCTACCAA -> ACGCTACCAAT
ATTGCTTTGTT -> TTGCTTTGTTG
CGTCTAAGTGA -> GTCTAAGTGAG
GCTCCCCGGGT -> CTCCCCGGGTT
TCCGCGTGTCC -> CCGCGTGTCCC
TGGCTTTTATC -> GGCTTTTATCA
GTTCCGCGTGT -> TTCCGCGTGTC
CGCTATTTTCG -> GCTATTTTCGC
GGGCCCGATGA -> GGCCCGATGAG
CTTATTATGTC -> TTATTATGTCT
CCCTTTCCTCC -> CCTTTCCTCCC
GCGGGGTCTAT -> CGGGGTCTATA
GACTTTTTTTC -> ACTTTTTTTCA
CATACAGGAGT -> ATACAGGAGTC
AGAACGGGCCC -> GAACGGGCCCG
TACATCGGCCC -> ACATCGGCCCC
CGGTCTAGCCG -> GGTCTAGCCGC
ACATAACGTGT -> CATAACGTGTG
CCGGGCCAGTA -> CGGGCCAGTAT
CAAGTTAACAC -> AAGTTAACACA
GATAACATCCT -> ATAACATCCTG
ACCGCATTCCG -> CCGCATTCCGG
TAGTTATAGCT -> AGTTATAGCTA
CCTCTGTTTCC -> CTCTGTTTCCA
GACCCTGTATG -> ACCCTGTATGT
ATGTGCACGTT -> TGTGCACGTTG
ATGACCCCAAT -> TGACCCCAATA
TTCCGGTTCGC -> TCCGGTTCGCG
GATCACTAGAA -> ATCACTAGAAC
AGCCAGGCGAA -> GCCAGGCGAAA
GCCCAGGAAGC -> CCCAGGAAGCT
CAGGCGAAATC -> AGGCGAAATCA
AGGTGCCCTTT -> GGTGCCCTTTC
TAAACGCGTAT -> AAACGCGTATT
GAACTTTCTTA -> AACTTTCTTAT
GGACTCCGTGC -> GACTCCGTGCT
CCCCCTCTTGG -> CCCCTCTTGGT
CGAAATCAGGA -> GAAATCAGGAA
GAAGTTAACGT -> AAGTTAACGTC
CAATGTGAACG -> AATGTGAACGC
GGCCCCTCTGT -> GCCCCTCTGTT
ATTGACCGAGG -> TTGACCGAGGA
GCGGACTGGCC -> CGGACTGGCCG
CGGCCCCTCTG -> GGCCCCTCTGT
GAGTCCTAATT -> AGTCCTAATTC
TGACCGATTTG -> GACCGATTTGC
ATCCTGGACCC -> TCCTGGACCCC
CGGACTCATAC -> GGACTCATACA
CCCCCGGGAAC -> CCCCGGGAACG
TCATTGATCAA -> CATTGATCAAG
GCACGTTGGGA -> CACGTTGGGAA
CTTGGTGCTAC -> TTGGTGCTACA
TGTTGACACTT -> GTTGACACTTA
GAGCGCCCCCG -> AGCGCCCCCGG
ATACTAGCTAG -> TACTAGCTAGA
GATTGTGTAAT -> ATTGTGTAATT
AAAGGCTCTAG -> AAGGCTCTAGG
TCGAATGGTGC -> CGAATGGTGCC
AGGCCCTATAT -> GGCCCTATATC
TACCGATCACT -> ACCGATCACTA
ACGAGACGATT -> CGAGACGATTG
AAATCAACAAT -> AATCAACAATA
TTCGGAACTCC -> TCGGAACTCCT
CCGCATTCCGG -> CGCATTCCGGT
CGGATCCTAGT -> GGATCCTAGTA
TCGTTTTAGGC -> CGTTTTAGGCC
TGCGCGGGACC -> GCGCGGGACCG
GCATGCGACGT -> CATGCGACGTA
GCTTGCCGTCT -> CTTGCCGTCTA
ATTCAAATGTA -> TTCAAATGTAG
TATAGCTAGGA -> ATAGCTAGGAA
TCTCTTAGCGC -> CTCTTAGCGCA
TTGTCCTCACG -> TGTCCTCACGA
ATACAGGAGTC -> TACAGGAGTCC
CATAACGTGTG -> ATAACGTGTGG
AGGGGAGCGCC -> GGGGAGCGCCC
ATTCGTGAGAG -> TTCGTGAGAGC
ACGTCAATAAG -> CGTCAATAAGG
CAGGCAAGGCT -> AGGCAAGGCTC
ATATCTCGAAT -> TATCTCGAATG
CTCTCTACAAC -> TCTCTACAACA
GTTGTATACTC -> TTGTATACTCA
TCTGTCATTGA -> CTGTCATTGAT
TTTGTAAGATA -> TTGTAAGATAG
AGGGTTATGAA -> GGGTTATGAAC
GCGTATTTCGT -> CGTATTTCGTG
TGTCTACGTAA -> GTCTACGTAAT
AAAGTTACGCA -> AAGTTACGCAT
TGTAAGATAGT -> GTAAGATAGTA
TGTAAACGCCA -> GTAAACGCCAA
GTATGCGCGGG -> TATGCGCGGGA
TATAACTGCTC -> ATAACTGCTCT
CATTAGCGGAC -> ATTAGCGGACT
TAGCCCAGGCA -> AGCCCAGGCAA
GGGGTCTATAA -> GGGTCTATAAG
CCTTCCCCAAG -> CTTCCCCAAGA
TTAAACGCGTA -> TAAACGCGTAT
AAGGGTTCGGG -> AGGGTTCGGGA
AGGGTTCGCTT -> GGGTTCGCTTC
GTGCTACAATT -> TGCTACAATTA
GTTGCTGATCC -> TTGCTGATCCG
GCCAGGCGAAA -> CCAGGCGAAAT
CCCCCCCAGTC -> CCCCCCAGTCT
TTGACACTTAT -> TGACACTTATT
CCCAGGTTTTG -> CCAGGTTTTGT
CGATCACTAGA -> GATCACTAGAA
AAGACTCTTTG -> AGACTCTTTGT
CGCCTAAACCG -> GCCTAAACCGT
AACCCAGGGGG -> ACCCAGGGGGT
CATACACCACA -> ATACACCACAG
CATGGGCGGTA -> ATGGGCGGTAG
TCTTTTTACGC -> CTTTTTACGCA
GAGTGGCCCAG -> AGTGGCCCAGG
ACACGCCTAAA -> CACGCCTAAAC
CCCAGGCAAGG -> CCAGGCAAGGC
ATTGTGTAATT -> TTGTGTAATTA
GACCCCCCCAG -> ACCCCCCCAGT
AAAATCAACAA -> AAATCAACAAT
TTGACCGAGGA -> TGACCGAGGAG
GCGCGGGACCG -> CGCGGGACCGA
GTCGAACCCCC -> TCGAACCCCCC
CCCAGGAAGCT -> CCAGGAAGCTG
ACTTGCTCGCC -> CTTGCTCGCCA
GAAATAATCTG -> AAATAATCTGG
GTGTACCATTC -> TGTACCATTCG
TGCAACCATCG -> GCAACCATCGT
ATAGTCCTAAT -> TAGTCCTAATT
CGTGGTTAGTT -> GTGGTTAGTTA
CCGCTAGACTT -> CGCTAGACTTG
TAGGGTTATGA -> AGGGTTATGAA
CCAGGCAAGGC -> CAGGCAAGGCT
CATCACACAGA -> ATCACACAGAT
GGAGAAGCAGC -> GAGAAGCAGCG
ATAAGGTTTGG -> TAAGGTTTGGC
AACTATAAACT -> ACTATAAACTT
TGTTACTATAA -> GTTACTATAAC
CTCGTGGATCT -> TCGTGGATCTA
GGTTTTGTAAG -> GTTTTGTAAGA
ATCAGGAAGTT -> TCAGGAAGTTA
AGCGGGGACTC -> GCGGGGACTCT
AATCAGGAAGT -> ATCAGGAAGTT
CAATTATAACT -> AATTATAACTG
TGCTACAATTA -> GCTACAATTAT
TTTGCTTGCCG -> TTGCTTGCCGT
TCCTCACGAGG -> CCTCACGAGGA
CAATACACGCC -> AATACACGCCT
TCCGGGCCAGT -> CCGGGCCAGTA
TGGCCGTCTCT -> GGCCGTCTCTT
CAGTATGCGCG -> AGTATGCGCGG
ATTCGATTTAG -> TTCGATTTAGG
AACACAGCATT -> ACACAGCATTT
AATGTAGTCGT -> ATGTAGTCGTC
GTGGCCCAGGA -> TGGCCCAGGAA
AAGGAGACTGC -> AGGAGACTGCT
CCAAAGGCAGG -> CAAAGGCAGGA
AATTACACTAT -> ATTACACTATG
CCCGTCAGCGC -> CCGTCAGCGCA
TTTGGCGGACA -> TTGGCGGACAT
CGCCCTTCCCC -> GCCCTTCCCCA
AACTCCTAGTG -> ACTCCTAGTGA
AACATTAGCGG -> ACATTAGCGGA
TCTCCCGTGTA -> CTCCCGTGTAC
ACCGATCACTA -> CCGATCACTAG
ATGCGCGGGAC -> TGCGCGGGACC
GATTAGTGCCG -> ATTAGTGCCGA
AGCTGACTGGC -> GCTGACTGGCT
CAGGGACGTTC -> AGGGACGTTCG
GATCGAGGTGC -> ATCGAGGTGCA
GGGGGCCCGAT -> GGGGCCCGATG
ATGTGAACGCG -> TGTGAACGCGA
AGTCCTAATTC -> GTCCTAATTCG,GTCCTAATTCA
TCCGGTTCGCG -> CCGGTTCGCGG
TCGCGGACTCC -> CGCGGACTCCG
TAGGCCCCGCG -> AGGCCCCGCGA
AGTCACCTTCT -> GTCACCTTCTC
CATCGTTCCGC -> ATCGTTCCGCG
ACTGCAAAGAT -> CTGCAAAGATG
GGACTGCAAAG -> GACTGCAAAGA
GGGTTCGGGAC -> GGTTCGGGACG
GTAATCCAAAT -> TAATCCAAATA
TAAGGTTTGGC -> AAGGTTTGGCG
TCATACAGGAG -> CATACAGGAGT
GTGAGAGCCAG -> TGAGAGCCAGC
AGGCTCCCCGG -> GGCTCCCCGGG
GGCTCACAGTG -> GCTCACAGTGA
ACACAGATCGG -> CACAGATCGGA
ACTCTCGTGGA -> CTCTCGTGGAT
ACAACAAGAGT -> CAACAAGAGTC
CGAGCACAGAC -> GAGCACAGACG
CTTGCCGTCTA -> TTGCCGTCTAA
TCTGGCGTGTA -> CTGGCGTGTAT
GCCCAGCTTAG -> CCCAGCTTAGG
CGCTAGACTTG -> GCTAGACTTGC
GGCAAACCCGT -> GCAAACCCGTC
TACTCAGAACG -> ACTCAGAACGG
CTAATTCGATT -> TAATTCGATTG
ACTGGCTTTTA -> CTGGCTTTTAT
AGTTGGGCAAC -> GTTGGGCAACT
TATAAACTTCG -> ATAAACTTCGT
TTCAACGTGCG -> TCAACGTGCGT
TCTCCGGGATT -> CTCCGGGATTT
TTTTTCATCCC -> TTTTCATCCCC
GCTAGACTTGC -> CTAGACTTGCT
TGTGAACGCGA -> GTGAACGCGAG
CACTAGAACGA -> ACTAGAACGAG
TCTGTACCGGT -> CTGTACCGGTC
TAAACGCCAAA -> AAACGCCAAAA
ATACCGATCAC -> TACCGATCACT
TAGTACCCGCG -> AGTACCCGCGA
CCTAAACCGTT -> CTAAACCGTTA
TTCTGGCACTG -> TCTGGCACTGC
GAAGCAGCGGG -> AAGCAGCGGGG
TATGTCCCACG -> ATGTCCCACGA
TTTTCGAGGAG -> TTTCGAGGAGG
TCGGAATGATT -> CGGAATGATTT
TTGGCCACATA -> TGGCCACATAA
ACGGATCCTAG -> CGGATCCTAGT
GAAAAATCAAC -> AAAAATCAACA
CAGACGGATCT -> AGACGGATCTG
TCGTGAGAGCC -> CGTGAGAGCCA
ATAGCATACAC -> TAGCATACACC
ATAAGGAGACT -> TAAGGAGACTG
CTACATAATGA -> TACATAATGAT
CCCCGCGAGAT -> CCCGCGAGATT
CTTAGCGCACC -> TTAGCGCACCT
GAGAGATCGAG -> AGAGATCGAGG
CAGTCTTACGA -> AGTCTTACGAC
CTGAATCGAAT -> TGAATCGAATG
CGGGAACGCCT -> GGGAACGCCTG
CTAGCCCAGGC -> TAGCCCAGGCA
ACAATTATAAC -> CAATTATAACT
GACGATTGACC -> ACGATTGACCG
CATGCGACGTA -> ATGCGACGTAA
GCCTCACTTAA -> CCTCACTTAAG
TCTCGTGGATC -> CTCGTGGATCT
AGTGATGCGAG -> GTGATGCGAGA
AACGAGCACAG -> ACGAGCACAGA
ATCTTAGTTAA -> TCTTAGTTAAA
CTTAGTTAAAC -> TTAGTTAAACG
AGGGTTCGGGA -> GGGTTCGGGAC
ACGCGGTCTAG -> CGCGGTCTAGC
ACGGGCCCGTT -> CGGGCCCGTTT
AGAAATAATCT -> GAAATAATCTG
GCTTCTGTACC -> CTTCTGTACCG
ATCCTTCCCCG -> TCCTTCCCCGG
ACAAACCCAGG -> CAAACCCAGGG
GCCCCGCGAGA -> CCCCGCGAGAT
GGTTTGGCGGA -> GTTTGGCGGAC
CCCAGTCTTAC -> CCAGTCTTACG
GGTCTATAAGG -> GTCTATAAGGT
TAATCTGGCTC -> AATCTGGCTCA
CTACAACAAGA -> TACAACAAGAG
ATATTTCATTC -> TATTTCATTCG
TTGATCAAGCG -> TGATCAAGCGC
ATTTTTCGAGG -> TTTTTCGAGGA
GCGGCAAACCC -> CGGCAAACCCG
TTATCTTAGTT -> TATCTTAGTTA
TCGTGGTTAGT -> CGTGGTTAGTT
TCCCCAAGAAC -> CCCCAAGAACT
ACTATAACGAG -> CTATAACGAGC
GAATGTTACTA -> AATGTTACTAT
GCCCTTCCCCA -> CCCTTCCCCAA
ATTTATGTATA -> TTTATGTATAG
CGAGATGACCC -> GAGATGACCCC
CCCGATGAGTT -> CCGATGAGTTC
CCCCAATAGCA -> CCCAATAGCAT
GAATGCACAAG -> AATGCACAAGT
AGCATTTCCAG -> GCATTTCCAGG
GACGTAATTAC -> ACGTAATTACA
CGGTTCTTGCA -> GGTTCTTGCAT
CTAGTACCCGC -> TAGTACCCGCG
GTTGGGCAACT -> TTGGGCAACTC
GCTCTCTTAGC -> CTCTCTTAGCG
GTCCATTACCA -> TCCATTACCAT
TATAGGGTTAT -> ATAGGGTTATG
CACCACAGATA -> ACCACAGATAT
ATGATTGACTG -> TGATTGACTGA
AAGTCACCTTC -> AGTCACCTTCT
TCTGAATCGAA -> CTGAATCGAAT
CCTAATTCAAC -> CTAATTCAACG
GTCAATAAGGA -> TCAATAAGGAG
GTGAAGGATAT -> TGAAGGATATT
CTTTTTACGCA -> TTTTTACGCAT
AACCATCGTTC -> ACCATCGTTCC
TGGCGGACATA -> GGCGGACATAG
GATTTAGAACG -> ATTTAGAACGT
AGACTGCTCAG -> GACTGCTCAGA
TGTAATTAAGT -> GTAATTAAGTC
GGGGACTCTCT -> GGGACTCTCTC
TTTAGCCGGAC -> TTAGCCGGACC
GCCATATCTCG -> CCATATCTCGA
TCCCCGGGTTG -> CCCCGGGTTGT
CTAGAGGCCCT -> TAGAGGCCCTA
TATGAACGGAT -> ATGAACGGATC
ACGCGAGTGAT -> CGCGAGTGATG
TATGTGTAAAC -> ATGTGTAAACG
TTCGTGAGAGC -> TCGTGAGAGCC
AGGAGACTGCT -> GGAGACTGCTC
AGAGATCGAGG -> GAGATCGAGGT
TGGTTAGTTAT -> GGTTAGTTATA
TTCGCGGACTC -> TCGCGGACTCC
GATCTACATAC -> ATCTACATACC
GGGTGAAGGAT -> GGTGAAGGATA
GGCGGACTGGC -> GCGGACTGGCC
CTAGCCGCACT -> TAGCCGCACTA
CTCTCTTAGCG -> TCTCTTAGCGC
CGACGCGGGGA -> GACGCGGGGAG
GTGCTGTCTAG -> TGCTGTCTAGC
ACGCATCCTTC -> CGCATCCTTCC
TTTCCAGGGAC -> TTCCAGGGACG
TTTATGTATAG -> TTATGTATAGG
GATTGACTGAT -> ATTGACTGATA
TCGATTTAGGG -> CGATTTAGGGT
ACTGCTCAGAC -> CTGCTCAGACC
TTGTATACTCA -> TGTATACTCAG
TGAAGCGGCGA -> GAAGCGGCGAG
AGCCTACATCG -> GCCTACATCGG
TTTAGGGTTCG -> TTAGGGTTCGC
GGAATATTGAT -> GAATATTGATC
GTTAAACGCGT -> TTAAACGCGTA
GCTGTCTAGCC -> CTGTCTAGCCC
CATATCTCGAA -> ATATCTCGAAT
CTTCCCCAAGA -> TTCCCCAAGAA
ACGGGGACGTG -> CGGGGACGTGC
TAAACTTCGTA -> AAACTTCGTAC
CTAATTCAACG -> TAATTCAACGT
ACCATCGTTCC -> CCATCGTTCCG
GACCGAGGAGA -> ACCGAGGAGAC
TTGCATGTGCA -> TGCATGTGCAC
GGCAACTCTCG -> GCAACTCTCGT
AATATTGATCT -> ATATTGATCTT
TTAGGGTTCGC -> TAGGGTTCGCT
TTATAACTGCT -> TATAACTGCTC
CGTTCTGGCAC -> GTTCTGGCACT
TATCTTAGTTA -> ATCTTAGTTAA
TGATAACATCC -> GATAACATCCT
TGCTCTCTACA -> GCTCTCTACAA
TTATAGCTAGG -> TATAGCTAGGA
GCGTCGTTGCT -> CGTCGTTGCTG
AGATAGTACCT -> GATAGTACCTT
CAAGAACTCTT -> AAGAACTCTTT
GCCCGTTTGTT -> CCCGTTTGTTA
TGAACGGATCC -> GAACGGATCCT
ATCCCAGGTTT -> TCCCAGGTTTT
GAACGCCTGGG -> AACGCCTGGGG
GTTTGTTAACG -> TTTGTTAACGG
CCGTGCTGTCT -> CGTGCTGTCTA
GCGCCCCCGGG -> CGCCCCCGGGA
TTCTCCCGTGT -> TCTCCCGTGTA
AAGTAGCAAAC -> AGTAGCAAACA
TTAGTGCCGAT -> TAGTGCCGATC
TAAGGTCGTAT -> AAGGTCGTATA
GTTAATTGCTT -> TTAATTGCTTT
GTGATGCGAGA -> TGATGCGAGAG
AGTCTTACGAC -> GTCTTACGACG
TTGCCGTCTAA -> TGCCGTCTAAG
ACTCTTTGTAG -> CTCTTTGTAGA
ATAACGAGCAC -> TAACGAGCACA
ACGTTCTGGCA -> CGTTCTGGCAC
GCATGTGCACG -> CATGTGCACGT
TTAGCCGGACC -> TAGCCGGACCG
GAATGGTGCCA -> AATGGTGCCAA
TGCAAAGATGC -> GCAAAGATGCG
TCTTTGTAGAC -> CTTTGTAGACG
TTACACTATGT -> TACACTATGTG
GCACAACTGAC -> CACAACTGACT
GAATATTGATC -> AATATTGATCT
AATCAACAATA -> ATCAACAATAC
CCAAAACGTTC -> CAAAACGTTCT
CCAGGAAGCTG -> CAGGAAGCTGA
CTTGCTCGCCA -> TTGCTCGCCAA
TGGGCGGTAGC -> GGGCGGTAGCC
CACCTTCTCCC -> ACCTTCTCCCG
GACGTAGATTT -> ACGTAGATTTT
TGGTGCCAAAG -> GGTGCCAAAGT
CGTGCTCTATA -> GTGCTCTATAG
ATCCGAGCTCT -> TCCGAGCTCTC
CTCTCGTGGAT -> TCTCGTGGATC
CAATACGCTAC -> AATACGCTACC
AAACGCGTATT -> AACGCGTATTT
GGCCCCGCGAG -> GCCCCGCGAGA
TCGTACCTCTG -> CGTACCTCTGA
ATAATTTTCGG -> TAATTTTCGGA
GAGACGGGGCG -> AGACGGGGCGG
GGACTCATACA -> GACTCATACAG
TATTCAAATGT -> ATTCAAATGTA
TTTCGCTACCG -> TTCGCTACCGC
GACGGATCTGG -> ACGGATCTGGC
GGATATTCAAA -> GATATTCAAAT
TTTTCGGAACT -> TTTCGGAACTC
AGTCCGGGCCA -> GTCCGGGCCAG
ATAAACTTCGT -> TAAACTTCGTA
ATGTCTACGTA -> TGTCTACGTAA
TGTGCACGTTG -> GTGCACGTTGG
AAGGCAGGACT -> AGGCAGGACTG
ACTGCAAGGCG -> CTGCAAGGCGG
TACCGGTCTTG -> ACCGGTCTTGC
GCACATGGGCG -> CACATGGGCGG
TGTACCGGTCT -> GTACCGGTCTT
CTTATTTGTCC -> TTATTTGTCCT
GCACAGACGGA -> CACAGACGGAT
GCGGACTCCGT -> CGGACTCCGTG
GCCCCCGGGAA -> CCCCCGGGAAC
ACGCCCAGCTT -> CGCCCAGCTTA
TCGAGGTGCAA -> CGAGGTGCAAC
CTCGCCAAAAG -> TCGCCAAAAGG
TATACTCAGAA -> ATACTCAGAAC
GTCCACGCCCA -> TCCACGCCCAG
AGCCCAGGCAA -> GCCCAGGCAAG
TTCGCTACCGC -> TCGCTACCGCC
TTTCCTCCCAC -> TTCCTCCCACC
CCATATCTCGA -> CATATCTCGAA
GTCCTAATTCG -> TCCTAATTCGA
TGAATCGAATG -> GAATCGAATGG
GTCCTAATTCA -> TCCTAATTCAA
CCAAAAGGCTC -> CAAAAGGCTCT
CGAGATTCCAG -> GAGATTCCAGA
TACCCGCGAAC -> ACCCGCGAACA
TGCTCGCCAAA -> GCTCGCCAAAA
CGGAATGATTT -> GGAATGATTTA
TGAGAGCCAGC -> GAGAGCCAGCC
GCTAGGAACTT -> CTAGGAACTTT
CAAAGTTACGC -> AAAGTTACGCA
CCGAGGAGACG -> CGAGGAGACGG
GCCACATAACG -> CCACATAACGT
ACTATAAACTT -> CTATAAACTTC
CCCTATATCCC -> CCTATATCCCA
AATAAGGAGAC -> ATAAGGAGACT
GTGTATCTACA -> TGTATCTACAT
AAATAATCTGG -> AATAATCTGGC
CTCACGAGGAA -> TCACGAGGAAT
GGACGCGGTCT -> GACGCGGTCTA
TTGGGAATATT -> TGGGAATATTG
GGAACTTTCTT -> GAACTTTCTTA
AGCGCACCTCT -> GCGCACCTCTC
TAGACTTGCTC -> AGACTTGCTCG
ACTTTCTTATT -> CTTTCTTATTT
AAAGGCAGGAC -> AAGGCAGGACT
GGTCGTATAAA -> GTCGTATAAAC
GTGGTTAGTTA -> TGGTTAGTTAT
GCTATTTTCGC -> CTATTTTCGCT
GAGGAGACGGG -> AGGAGACGGGG
CGTCCACGCCC -> GTCCACGCCCA
TCTCTCTAAAC -> CTCTCTAAACT
TATGGCGGACT -> ATGGCGGACTG
TCTTACGACGA -> CTTACGACGAG
ATCCATCACGA -> TCCATCACGAT
TCTAAGTGAGA -> CTAAGTGAGAA
GAGGCATGCGA -> AGGCATGCGAC
CGTTGCTGATC -> GTTGCTGATCC
ATATTATCTGC -> TATTATCTGCC
GTGTGGGCGGC -> TGTGGGCGGCA
ATTTCGTGGTT -> TTTCGTGGTTA
GCTACCAATGT -> CTACCAATGTG
ACCATTCGATT -> CCATTCGATTT
AGCTGGGGAGA -> GCTGGGGAGAG
ATTTAGAACGT -> TTTAGAACGTA
CTGTCATTGAT -> TGTCATTGATC
AGGTGGCCTCA -> GGTGGCCTCAC
CGACGTAGATT -> GACGTAGATTT
GGAATGCCAAA -> GAATGCCAAAG
CCCGCGAGATT -> CCGCGAGATTC
TATCCCAGGTT -> ATCCCAGGTTT
CCGTCTCTTAG -> CGTCTCTTAGG
CTGGCTCACAG -> TGGCTCACAGT
CGTACCTCTGA -> GTACCTCTGAA
TAGTCGTCCAC -> AGTCGTCCACG
TGCCGGTTAAT -> GCCGGTTAATT
CTCTATAGTCC -> TCTATAGTCCT
GCGTGCTAGAC -> CGTGCTAGACT
ATTGACTGATA -> TTGACTGATAA
AATTCGATTGT -> ATTCGATTGTG
TTGCTCGCCAA -> TGCTCGCCAAA
AACGTGCGTCG -> ACGTGCGTCGT
CGATCGACCGT -> GATCGACCGTA
TTCAAATGTAG -> TCAAATGTAGT
TATAAACCATC -> ATAAACCATCA
CGTGTGGGCGG -> GTGTGGGCGGC
TTCCCCAAGAA -> TCCCCAAGAAC
AAACCGTTATC -> AACCGTTATCT
ACAATACGCTA -> CAATACGCTAC
GTAGCCTACAT -> TAGCCTACATC
TAACGAGCACA -> AACGAGCACAG
GGCTCCCCGGG -> GCTCCCCGGGT
CAGCGCATTTA -> AGCGCATTTAG
CCCCAAGGGGA -> CCCAAGGGGAC
GTATGGCGGAC -> TATGGCGGACT
AGTCGAACCCC -> GTCGAACCCCC
ACTGCTCTCTA -> CTGCTCTCTAC
TAGGAAGAAAC -> AGGAAGAAACG
CGATATTTCAT -> GATATTTCATT
GTGACGATATT -> TGACGATATTT
CTGCAAGGCGG -> TGCAAGGCGGG
TTTCGGAACTC -> TTCGGAACTCC
GCATGAAAGGT -> CATGAAAGGTG
AAATAATTTTC -> AATAATTTTCG
GTGCACGTTGG -> TGCACGTTGGG
GTTAACGGGGA -> TTAACGGGGAC
TGACCGAGGAG -> GACCGAGGAGA
GGTTCGGGACG -> GTTCGGGACGT
TGGTGCTACAA -> GGTGCTACAAT
TTTGTTGACAC -> TTGTTGACACT
TCTCTACAACA -> CTCTACAACAA
ACAGGAGTCCG -> CAGGAGTCCGG
CTGATCCGAGC -> TGATCCGAGCT
ATAACGTGTGG -> TAACGTGTGGG
CTCTAGGTGGC -> TCTAGGTGGCC
ACCAATGTGAA -> CCAATGTGAAC
GGCAAACAGCT -> GCAAACAGCTG
ACCTTAGACCA -> CCTTAGACCAA
AACTCTTTTGG -> ACTCTTTTGGC
ACTCTCCGGGA -> CTCTCCGGGAT
TCGGAACTCCT -> CGGAACTCCTA
GCTCAGACCCT -> CTCAGACCCTG
TAATTCAACGT -> AATTCAACGTG
CGAGCTCTCTT -> GAGCTCTCTTA
TTCCTCCCACC -> TCCTCCCACCG
CGAATGGTGCC -> GAATGGTGCCA
GCAAACAGCAG -> CAAACAGCAGT
TTTGTTAACGG -> TTGTTAACGGG
TGCACAAGTAG -> GCACAAGTAGC
GCAAACCCGTC -> CAAACCCGTCA
CAGGAGTCCGG -> AGGAGTCCGGG
TGTCCTCACGA -> GTCCTCACGAG
GCTCGCCAAAA -> CTCGCCAAAAG
GGTAGCCTACA -> GTAGCCTACAT
GGACATAGTCC -> GACATAGTCCA
CTTGCACATGG -> TTGCACATGGG
CCCTTCCCCAA -> CCTTCCCCAAG
AACGCGAGTGA -> ACGCGAGTGAT
TAGTTCCGGCG -> AGTTCCGGCGG
GGTCTAGCCGC -> GTCTAGCCGCA
CTATAGTCCTA -> TATAGTCCTAA
GTCTAAGTGAG -> TCTAAGTGAGA
GTGTCCCCAAG -> TGTCCCCAAGG
GCTACAATTAT -> CTACAATTATA
GATCGGAGTTG -> ATCGGAGTTGG
GCCGGACCGCA -> CCGGACCGCAT
GCACCTCTCCA -> CACCTCTCCAC
TCTTGAAGCGG -> CTTGAAGCGGC
GTCAGCGCATT -> TCAGCGCATTT
CGTTTGTTAAC -> GTTTGTTAACG
GTACCATTCGA -> TACCATTCGAT
AACGCCTGGGG -> ACGCCTGGGGG
CGTGTATCTAC -> GTGTATCTACA
CCGTCTAAGTG -> CGTCTAAGTGA
GTATTTCGTGG -> TATTTCGTGGT
TGCATGTGCAC -> GCATGTGCACG
CTTCGTACCTC -> TTCGTACCTCT
CGTGTCCCCAA -> GTGTCCCCAAG
TGCGTGCTAGA -> GCGTGCTAGAC
ACTCCGTGCTG -> CTCCGTGCTGT
CTTAAGACTCT -> TTAAGACTCTT
GCTAGAGGCCC -> CTAGAGGCCCT
TCTGTTTCCAA -> CTGTTTCCAAG
AGGACTGCAAA -> GGACTGCAAAG
ACGCGGGGAGG -> CGCGGGGAGGC
AGGTCGTATAA -> GGTCGTATAAA
CCGGTCGTTTT -> CGGTCGTTTTA
AGTCGTCCACG -> GTCGTCCACGC
CCCGGGAACGC -> CCGGGAACGCC
TCCTAATTCGA -> CCTAATTCGAT
TAGAGGCCCTA -> AGAGGCCCTAT
GGCCCTATATC -> GCCCTATATCC
TGCGAGAGATC -> GCGAGAGATCG
CCGTGTACCAT -> CGTGTACCATT
CCGACGTAGAT -> CGACGTAGATT
TGCTTGCCGTC -> GCTTGCCGTCT
GTGGCAAACAG -> TGGCAAACAGC
TATTATCTGCC -> ATTATCTGCCG
TACTAGCTAGA -> ACTAGCTAGAG
AGACCAATACA -> GACCAATACAC
TCAGACCCTGT -> CAGACCCTGTA
CCACGAGACGA -> CACGAGACGAT
TAAGATAGTAC -> AAGATAGTACC
TTTCTTATTTG -> TTCTTATTTGT
CAACTGACTTT -> AACTGACTTTT
AGTAGCAAACA -> GTAGCAAACAG
CTACCGCCAGT -> TACCGCCAGTA
CCAAAGTTACG -> CAAAGTTACGC
CCATTCGATTT -> CATTCGATTTA
GGACGTGCTCT -> GACGTGCTCTA
CTGCTCAGACC -> TGCTCAGACCC
GTTTGGCGGAC -> TTTGGCGGACA
AATAATCTGGC -> ATAATCTGGCT
TCGCCAAAAGG -> CGCCAAAAGGC
GAGTGATGCGA -> AGTGATGCGAG
TCTACATACCG -> CTACATACCGA
CCTAATTCGAT -> CTAATTCGATT
AAGGCTCTAGG -> AGGCTCTAGGT
CGCATGAAAGG -> GCATGAAAGGT
TGGCCTCACTT -> GGCCTCACTTA
GAGAGTCGAAC -> AGAGTCGAACC
GCGGTTCTTGC -> CGGTTCTTGCA
ACATGGGCGGT -> CATGGGCGGTA
CCGAGTGGCCC -> CGAGTGGCCCA
GAGGAGGATTA -> AGGAGGATTAG
GTGCTCTATAG -> TGCTCTATAGT
TAATTACACTA -> AATTACACTAT
TGATCTTTTTA -> GATCTTTTTAC
CCTATATCCCA -> CTATATCCCAG
GGACGTTCGTA -> GACGTTCGTAG
ATCCAAATAAT -> TCCAAATAATT
AGCATACACCA -> GCATACACCAC
TAGTACCTTAG -> AGTACCTTAGA
GTAAGGTCGTA -> TAAGGTCGTAT
TTTAGAACGTA -> TTAGAACGTAT
ACTTCGTACCT -> CTTCGTACCTC
GTCTTACGACG -> TCTTACGACGA
ACTCCGCTAGA -> CTCCGCTAGAC
CTCTCTCTAAA -> TCTCTCTAAAC
CGCGAGTGATG -> GCGAGTGATGC
AGTACCCGCGA -> GTACCCGCGAA
AGGCCCCGCGA -> GGCCCCGCGAG
CCTCTCCACGC -> CTCTCCACGCT
GAACCCCCCGA -> AACCCCCCGAG
ACGTTCGTAGT -> CGTTCGTAGTG
CACTATGTGTA -> ACTATGTGTAA
AGGAGACGGGG -> GGAGACGGGGC
TTGCACATGGG -> TGCACATGGGC
AGAACGAGCCA -> GAACGAGCCAG
GGCATGCGACG -> GCATGCGACGT
GATGCGTGCTA -> ATGCGTGCTAG
ACGTTGGGAAT -> CGTTGGGAATA
TAGTTAAACGC -> AGTTAAACGCG
TTGGGCAACTC -> TGGGCAACTCT
TGACGATATTT -> GACGATATTTC
TTAGCGGACTC -> TAGCGGACTCA
TTTTAGGCCCC -> TTTAGGCCCCG
GACGACGCGGG -> ACGACGCGGGG
CATCCCCCTCT -> ATCCCCCTCTT
GTAGCAAACAG -> TAGCAAACAGC
GCGACGTAATT -> CGACGTAATTA
AAGGTGCCCTT -> AGGTGCCCTTT
GGAAGTTAACG -> GAAGTTAACGT
CATAATGATTG -> ATAATGATTGA
CTATAAGGTTT -> TATAAGGTTTG
CAGGAAGTTAA -> AGGAAGTTAAC
TTCGGAATGAT -> TCGGAATGATT
TCTAAACTATA -> CTAAACTATAA
CGAGGAGACGG -> GAGGAGACGGG
TCGCTTCTGTA -> CGCTTCTGTAC
GCAACTCTCGT -> CAACTCTCGTG
TTTTACGCATC -> TTTACGCATCC
TACATACCGAT -> ACATACCGATC
GTTCTTGCATG -> TTCTTGCATGT
TGTAGTCGTCC -> GTAGTCGTCCA
ATGCGACGTAA -> TGCGACGTAAT
TATGCGCGGGA -> ATGCGCGGGAC
ACACTATGTGT -> CACTATGTGTA
CTTTCCTCCCA -> TTTCCTCCCAC
GTGGGCGGCAA -> TGGGCGGCAAA
AGTTAAACGCG -> GTTAAACGCGT
ATGAAAGGTGC -> TGAAAGGTGCC
ATAGTCCATTA -> TAGTCCATTAC
GTGTAAACGCC -> TGTAAACGCCA
TGGCCACATAA -> GGCCACATAAC
AGACCCTGTAT -> GACCCTGTATG
AGGCGTGGCAA -> GGCGTGGCAAA
GGGGGTGAAGG -> GGGGTGAAGGA
GTAAACGCCAA -> TAAACGCCAAA
GATAGTACCTT -> ATAGTACCTTA
GTAGATTTTTC -> TAGATTTTTCG
TCTTAGGAAGA -> CTTAGGAAGAA
GATCTTTTTAC -> ATCTTTTTACG
ATACACCACAG -> TACACCACAGA
CTTGCATGTGC -> TTGCATGTGCA
TAACACAGCAT -> AACACAGCATT
CTGTCTAGCCC -> TGTCTAGCCCA
TCTAGCCGCAC -> CTAGCCGCACT
CGATTGTGTAA -> GATTGTGTAAT
GAACGGATCCT -> AACGGATCCTA
TACCTCTGAAT -> ACCTCTGAATC
GACGCGGGGAG -> ACGCGGGGAGG
CTACAATTATA -> TACAATTATAA
GTGCTAGACTC -> TGCTAGACTCC
TTGTAGACGAC -> TGTAGACGACG
TTTTCGCTACC -> TTTCGCTACCG
CGTAATTACAC -> GTAATTACACT
ACCCCCCGAGA -> CCCCCCGAGAG
CCAGTCTTACG -> CAGTCTTACGA
TTGTTAACGGG -> TGTTAACGGGG
GACTCCGTGCT -> ACTCCGTGCTG
CGCATTCCGGT -> GCATTCCGGTT
AAGCGCCCTTC -> AGCGCCCTTCC
GGGCCCGTTTG -> GGCCCGTTTGT
GGGACGTTCGT -> GGACGTTCGTA
CCAATAGCATA -> CAATAGCATAC
TCACTAGAACG -> CACTAGAACGA
GAGAAGCAGCG -> AGAAGCAGCGG
TCAAGCGCCCT -> CAAGCGCCCTT
GGCAGGACTGC -> GCAGGACTGCA
CCCGTTTGTTA -> CCGTTTGTTAA
CTTAGGCGTGG -> TTAGGCGTGGC
TCTTCTGTCAT -> CTTCTGTCATT
CTTTTTTTCAT -> TTTTTTTCATC
CGTGTACCATT -> GTGTACCATTC
GCGTGTATCTA -> CGTGTATCTAC
TGTACCATTCG -> GTACCATTCGA
CTAAGTGAGAA -> TAAGTGAGAAT
GTAGTCGTCCA -> TAGTCGTCCAC
CTGGCTTTTAT -> TGGCTTTTATC
TCCGGGATTTA -> CCGGGATTTAT
TATGTATAGGG -> ATGTATAGGGT
CAAATGTAGTC -> AAATGTAGTCG
GCGGGGACTCT -> CGGGGACTCTC
TTTATACTAGC -> TTATACTAGCT
ATAGTACCTTA -> TAGTACCTTAG
CGCACCTCTCC -> GCACCTCTCCA
CCATTACCATC -> CATTACCATCG
ATCTGGCGTGT -> TCTGGCGTGTA
ACCCAGGGGGT -> CCCAGGGGGTG
GGACCCCCCCA -> GACCCCCCCAG
TTTCCAAGTTA -> TTCCAAGTTAA
ACGACGAGGGG -> CGACGAGGGGA
TAACGGGGACG -> AACGGGGACGT
GGAACGCCTGG -> GAACGCCTGGG
TCAGCGCATTT -> CAGCGCATTTA
CGAGGAATGCC -> GAGGAATGCCA
CCAAGAACTCT -> CAAGAACTCTT
TTAGAACGTAT -> TAGAACGTATG
GATTTAGGGTT -> ATTTAGGGTTC
CTGATAACATC -> TGATAACATCC
CAAAAGGCTCT -> AAAAGGCTCTA
TATAAGGTTTG -> ATAAGGTTTGG
AATTAAGTCAC -> ATTAAGTCACC
TAAGGAGACTG -> AAGGAGACTGC
AGGAGTCCGGG -> GGAGTCCGGGC
CCAGTAAGGTC -> CAGTAAGGTCG
CAGAACGGGCC -> AGAACGGGCCC
CGGACTGGCCG -> GGACTGGCCGT
CTGGGGGCCCG -> TGGGGGCCCGA
ACGACGCGGGG -> CGACGCGGGGA
AACGGGGACGT -> ACGGGGACGTG
CAGGAAGCTGA -> AGGAAGCTGAC
TGTTAACGGGG -> GTTAACGGGGA
TCAATAAGGAG -> CAATAAGGAGA
TTAACGTCAAT -> TAACGTCAATA
AGCAGTTCTTC -> GCAGTTCTTCT
CAGCAGTTCTT -> AGCAGTTCTTC
CGGGTTGTATA -> GGGTTGTATAC
AGTGACCGATT -> GTGACCGATTT
TAGTCCATTAC -> AGTCCATTACC
CCCCCCAGTCT -> CCCCCAGTCTT
CTCCCACCGAC -> TCCCACCGACG
ACGATTGACCG -> CGATTGACCGA
CTCTAAACTAT -> TCTAAACTATA
ATATCCCAGGT -> TATCCCAGGTT
TCCACGCCCAG -> CCACGCCCAGC
GCCCGATGAGT -> CCCGATGAGTT
GCCAAAAGGCT -> CCAAAAGGCTC
TCATCCCCCTC -> CATCCCCCTCT
TCCCACCGACG -> CCCACCGACGT
TGACTGGCTTT -> GACTGGCTTTT
AGTTCCGGCGG -> GTTCCGGCGGT
TCCCACGAGAC -> CCCACGAGACG
CATCACGATTT -> ATCACGATTTA
GCAGTTCTTCT -> CAGTTCTTCTG
CCCACCGACGT -> CCACCGACGTA
GCGCACCTCTC -> CGCACCTCTCC
CCCCAGTCTTA -> CCCAGTCTTAC
GGCCGTCTCTT -> GCCGTCTCTTA
TGATCAAGCGC -> GATCAAGCGCC
CCGATGAGTTC -> CGATGAGTTCT
AAGATAGTACC -> AGATAGTACCT
CGCTTCGGAAT -> GCTTCGGAATG
GAAAGGTGCCC -> AAAGGTGCCCT
CCCAGGGGGTG -> CCAGGGGGTGA
CATCGCTATTT -> ATCGCTATTTT
TGAACGCGAGT -> GAACGCGAGTG
ACGCATGAAAG -> CGCATGAAAGG
GGAGTTGGGCA -> GAGTTGGGCAA
CTCTCCGGGAT -> TCTCCGGGATT
GGCGAGATGAC -> GCGAGATGACC
GGGCCAGTATG -> GGCCAGTATGC
GAGAGAAATAA -> AGAGAAATAAT
ACGTGCACAAC -> CGTGCACAACT
AATCCAAATAA -> ATCCAAATAAT
GGGAGAGTCGA -> GGAGAGTCGAA
AAACGTTCTGG -> AACGTTCTGGC
TAATTCGATTG -> AATTCGATTGT
ATTATCTGCCG -> TTATCTGCCGG
TGAGTGACGAT -> GAGTGACGATA
TAGCGCACCTC -> AGCGCACCTCT
CATTTCCAGGG -> ATTTCCAGGGA
CACGAGACGAT -> ACGAGACGATT
ACGTATGGCGG -> CGTATGGCGGA
CAAAACGTTCT -> AAAACGTTCTG
GGCGGACATAG -> GCGGACATAGT
GCTGACTGGCT -> CTGACTGGCTT
AACTGCTCTCT -> ACTGCTCTCTA
GAACTCTTTTG -> AACTCTTTTGG
AAAACGTTCTG -> AAACGTTCTGG
TTGATCTTTTT -> TGATCTTTTTA
GGTTCTTGCAT -> GTTCTTGCATG
AGGATATTCAA -> GGATATTCAAA
CTACATCGGCC -> TACATCGGCCC
CATCCTTCCCC -> ATCCTTCCCCG
CTTTGTAGACG -> TTTGTAGACGA
CAAGCGCCCTT -> AAGCGCCCTTC
AGATGCGTGCT -> GATGCGTGCTA
TAACGTCAATA -> AACGTCAATAA
CGGGATTTATA -> GGGATTTATAC
ATTCCAGACAA -> TTCCAGACAAA
AGCGGCGAGAT -> GCGGCGAGATG
TAATTGCTTTG -> AATTGCTTTGT
TACGCATGAAA -> ACGCATGAAAG
CTCTGAATCGA -> TCTGAATCGAA
CCCCGGGAACG -> CCCGGGAACGC
CCAGGTTTTGT -> CAGGTTTTGTA
CCCACGAGACG -> CCACGAGACGA
TGAGAATGTTA -> GAGAATGTTAC
GATATTATCTG -> ATATTATCTGC
CCAGCCATATC -> CAGCCATATCT
CTAGTGAGTGA -> TAGTGAGTGAC
GGGCGGTAGCC -> GGCGGTAGCCT
AGGATTAGTGC -> GGATTAGTGCC
ACCATCACACA -> CCATCACACAG
TTCCAGACAAA -> TCCAGACAAAC
ACGAGCCAGGC -> CGAGCCAGGCG
CCTTTCCTCCC -> CTTTCCTCCCA
TCGAACCCCCC -> CGAACCCCCCG
CAAATAATTTT -> AAATAATTTTC
AGACTTGCTCG -> GACTTGCTCGC
GGCGGAGAAGC -> GCGGAGAAGCA
ATGTCCCACGA -> TGTCCCACGAG
TTTTCATCCCC -> TTTCATCCCCC
CATGAAAGGTG -> ATGAAAGGTGC
AACGCGTATTT -> ACGCGTATTTC
GTTAGTTATAG -> TTAGTTATAGC
ACCACAGATAT -> CCACAGATATT
TAGGAACTTTC -> AGGAACTTTCT
AGGTTTGGCGG -> GGTTTGGCGGA
ACAGATCGGAG -> CAGATCGGAGT
GCAGGACTGCA -> CAGGACTGCAA
AGTACCTTAGA -> GTACCTTAGAC
AGCAGCGGGGA -> GCAGCGGGGAC
TATAACGAGCA -> ATAACGAGCAC
GAATGATTTAT -> AATGATTTATG
ATCTCGAATGC -> TCTCGAATGCA
CTCTTAGCGCA -> TCTTAGCGCAC
TAGAACGTATG -> AGAACGTATGG
CGTCAATAAGG -> GTCAATAAGGA
TAGCTAGAGGC -> AGCTAGAGGCC
GCCGCACTAAG -> CCGCACTAAGG
ACTTAAGACTC -> CTTAAGACTCT
AGAACGTATGG -> GAACGTATGGC
GGGGCGGAGAA -> GGGCGGAGAAG
CGCTTCTGTAC -> GCTTCTGTACC
GGTTGTATACT -> GTTGTATACTC
AATTATAACTG -> ATTATAACTGC
CCGGGAACGCC -> CGGGAACGCCT
GAGACTGCTCA -> AGACTGCTCAG
CCCCGGTCGTT -> CCCGGTCGTTT
TCTAGCCCAGG -> CTAGCCCAGGC
CGCCAAAAGGC -> GCCAAAAGGCT
ACCCCCCCAGT -> CCCCCCCAGTC
GGGTTCGCTTC -> GGTTCGCTTCT
GACCAATACAC -> ACCAATACACG
CTTACGACGAG -> TTACGACGAGG
AACGGATCCTA -> ACGGATCCTAG
CCGGGTTGTAT -> CGGGTTGTATA
TGATTGACTGA -> GATTGACTGAT
AATTTTCGGAA -> ATTTTCGGAAC
TTCGATTTAGG -> TCGATTTAGGG
GCCAGTAAGGT -> CCAGTAAGGTC
TAAACCATCAC -> AAACCATCACA
ATGTGTAAACG -> TGTGTAAACGC
CTACATACCGA -> TACATACCGAT
GGCGTGGCAAA -> GCGTGGCAAAC
CTAGACTCCGC -> TAGACTCCGCT
CCGATCGACCG -> CGATCGACCGT
ACTAAGGGTTC -> CTAAGGGTTCG
GGGTTGTATAC -> GGTTGTATACT
AAGGTCGTATA -> AGGTCGTATAA
TGGCTCACAGT -> GGCTCACAGTG
CTTCTCCCGTG -> TTCTCCCGTGT
GGCGGCAAACC -> GCGGCAAACCC
GATTTATACTA -> ATTTATACTAG
TAGACTCCGCT -> AGACTCCGCTA
ATAACTGCTCT -> TAACTGCTCTC
CCCCCAGTCTT -> CCCCAGTCTTA
GATTCCAGACA -> ATTCCAGACAA
ATGTTACTATA -> TGTTACTATAA
CGTTGGGAATA -> GTTGGGAATAT
CCTAGTACCCG -> CTAGTACCCGC
TTATGTATAGG -> TATGTATAGGG
CGCCCAGCTTA -> GCCCAGCTTAG
CTCATACAGGA -> TCATACAGGAG
CGATTTAGGGT -> GATTTAGGGTT
ACGCCAAAACG -> CGCCAAAACGT
AAGTTAACACA -> AGTTAACACAG
CAGGTTTTGTA -> AGGTTTTGTAA
TGTGTAATTAA -> GTGTAATTAAG
TAGGGTTCGCT -> AGGGTTCGCTT
CATCCTGGACC -> ATCCTGGACCC
AAGGTTTGGCG -> AGGTTTGGCGG
TTATTATGTCT -> TATTATGTCTA
ACTGATAACAT -> CTGATAACATC
CCAATGTGAAC -> CAATGTGAACG
CTATATCCCAG -> TATATCCCAGG
CGGAACTCCTA -> GGAACTCCTAG
CCTTCCCCGGT -> CTTCCCCGGTC
AACAAGAGTCC -> ACAAGAGTCCT
GAGTCGAACCC -> AGTCGAACCCC
GAGTTGGGCAA -> AGTTGGGCAAC
ATTAGCGGACT -> TTAGCGGACTC
CTTCTGTACCG -> TTCTGTACCGG
TTCCAGGGACG -> TCCAGGGACGT
TATAGTCCTAA -> ATAGTCCTAAT
AGCGCCCCCGG -> GCGCCCCCGGG
CGGACATAGTC -> GGACATAGTCC
TTATGAACGGA -> TATGAACGGAT
GTTTCCAAGTT -> TTTCCAAGTTA
AGTTCTTGAAG -> GTTCTTGAAGC
AGGAATGCCAA -> GGAATGCCAAA
ACCCCAATAGC -> CCCCAATAGCA
CCTGGACCCCC -> CTGGACCCCCC
TTGTGTAATTA -> TGTGTAATTAA
AGATATTATCT -> GATATTATCTG
AGGAGGATTAG -> GGAGGATTAGT
CACAGTGACCG -> ACAGTGACCGA
ACCGTATCCAT -> CCGTATCCATC
GCATTTCCAGG -> CATTTCCAGGG
GTCTATAAGGT -> TCTATAAGGTT
ACGGGGCGGAG -> CGGGGCGGAGA
GCTTCGGAATG -> CTTCGGAATGA
TTAACACAGCA -> TAACACAGCAT
CCGCACTAAGG -> CGCACTAAGGG
TGGGGAGAGTC -> GGGGAGAGTCG
GAGAATGTTAC -> AGAATGTTACT
TCTACAACAAG -> CTACAACAAGA
ATGCGAGAGAT -> TGCGAGAGATC
TGGGAATATTG -> GGGAATATTGA
CCGCCAGTAAG -> CGCCAGTAAGG
ATTATAACTGC -> TTATAACTGCT
TGTGTAAACGC -> GTGTAAACGCC
GACATAGTCCA -> ACATAGTCCAT
AACGTGTGGGC -> ACGTGTGGGCG
TCACGAGGAAT -> CACGAGGAATG
ACTCTTTTGGC -> CTCTTTTGGCC
CCTCCCACCGA -> CTCCCACCGAC
CTAGGTGGCCT -> TAGGTGGCCTC
CTGTTTCCAAG -> TGTTTCCAAGT
TTATACTAGCT -> TATACTAGCTA
AGAAGCAGCGG -> GAAGCAGCGGG
AGCCAGCCATA -> GCCAGCCATAT
CAGATCGGAGT -> AGATCGGAGTT
GAAACGAAAAA -> AAACGAAAAAT
TGCCCTTTCCT -> GCCCTTTCCTC
GTCGTTTTAGG -> TCGTTTTAGGC
GCGAGTGATGC -> CGAGTGATGCG
ATGCGTGCTAG -> TGCGTGCTAGA
GCCTAAACCGT -> CCTAAACCGTT
GACTTGCTCGC -> ACTTGCTCGCC
AGAGGCCCTAT -> GAGGCCCTATA
CCTCACTTAAG -> CTCACTTAAGA
TCTCTTAGGAA -> CTCTTAGGAAG
GCATTCCGGTT -> CATTCCGGTTC
GTATCTACATA -> TATCTACATAA
CCCGGGTTGTA -> CCGGGTTGTAT
TGTCCCACGAG -> GTCCCACGAGA
GGACCGCATTC -> GACCGCATTCC
CTATAACGAGC -> TATAACGAGCA
ACTCTCTCTAA -> CTCTCTCTAAA
GCCAAAGGCAG -> CCAAAGGCAGG
GGTGCTACAAT -> GTGCTACAATT
CTCGAATGCAC -> TCGAATGCACA
TTCATCCCCCT -> TCATCCCCCTC
AGCCGGACCGC -> GCCGGACCGCA
GCTCTATAGTC -> CTCTATAGTCC
CGGTAGCCTAC -> GGTAGCCTACA
GAAATCAGGAA -> AAATCAGGAAG
TTTTTCGAGGA -> TTTTCGAGGAG
CGTGCTGTCTA -> GTGCTGTCTAG
AAGTTACGCAT -> AGTTACGCATG
CCTAGTGAGTG -> CTAGTGAGTGA
ATAGGGTTATG -> TAGGGTTATGA
CCGTCAGCGCA -> CGTCAGCGCAT
GTACCTTAGAC -> TACCTTAGACC
GAGCCAGGCGA -> AGCCAGGCGAA
TTACTATAACG -> TACTATAACGA
TACCGCCAGTA -> ACCGCCAGTAA
GTGTAATTAAG -> TGTAATTAAGT
GCAGCGGGGAC -> CAGCGGGGACT
AGATCGAGGTG -> GATCGAGGTGC
GTGCAACCATC -> TGCAACCATCG
CGCACTAAGGG -> GCACTAAGGGT
AAGAGTCCTAA -> AGAGTCCTAAT
GCGAGAGATCG -> CGAGAGATCGA
ATCGGCCCCTC -> TCGGCCCCTCT
ATACGCTACCA -> TACGCTACCAA
AGAGTCGAACC -> GAGTCGAACCC
TTCGCTTCTGT -> TCGCTTCTGTA
GCCCCTCTGTT -> CCCCTCTGTTT
TTAGGCCCCGC -> TAGGCCCCGCG
AGTTACGCATG -> GTTACGCATGA
CAGTGACCGAT -> AGTGACCGATT
TAGTGCCGATC -> AGTGCCGATCG
CGTAGATTTTT -> GTAGATTTTTC
GTGCCAAAGTT -> TGCCAAAGTTA
CACTGCAAGGC -> ACTGCAAGGCG
CGAGCCAGGCG -> GAGCCAGGCGA
CTGTATGTCCC -> TGTATGTCCCA
ATACACGCCTA -> TACACGCCTAA
ATTTCCAGGGA -> TTTCCAGGGAC
GTGGCCTCACT -> TGGCCTCACTT
GATTTGCTTGC -> ATTTGCTTGCC
CCACCGACGTA -> CACCGACGTAG
TTAGTTATAGC -> TAGTTATAGCT
GCCAGTATGCG -> CCAGTATGCGC
GAACATTAGCG -> AACATTAGCGG
TAAGTCACCTT -> AAGTCACCTTC
CCCAGCTTAGG -> CCAGCTTAGGC
TCCACGCTTCG -> CCACGCTTCGG
AAGAAACGAAA -> AGAAACGAAAA
ACACCACAGAT -> CACCACAGATA
GCCGTCTCTTA -> CCGTCTCTTAG
TAGCGGACTCA -> AGCGGACTCAT
ACCCTGTATGT -> CCCTGTATGTC
CCTCACGAGGA -> CTCACGAGGAA
CTCTTGGTGCT -> TCTTGGTGCTA
AACGAGCCAGG -> ACGAGCCAGGC
GGGACCGAGTG -> GGACCGAGTGG
ACAGCTGGGGA -> CAGCTGGGGAG
CTTCTGTCATT -> TTCTGTCATTG
AAACTTCGTAC -> AACTTCGTACC
CGTCGTTGCTG -> GTCGTTGCTGA
ATCGTTCCGCG -> TCGTTCCGCGT
GGGCGGCAAAC -> GGCGGCAAACC
CCATCACGATT -> CATCACGATTT
CCCCTCTTGGT -> CCCTCTTGGTG
TTGCTTGCCGT -> TGCTTGCCGTC
CCTCTTGGTGC -> CTCTTGGTGCT
CAAGGCGGGGT -> AAGGCGGGGTC
CGACGAGGGGA -> GACGAGGGGAG
GACAAACCCAG -> ACAAACCCAGG
CTAAGGGTTCG -> TAAGGGTTCGG
AACCGTTATCT -> ACCGTTATCTT
TCGTATAAACC -> CGTATAAACCA
GGGATTTATAC -> GGATTTATACT
ACAGACGGATC -> CAGACGGATCT
TAATGATTGAC -> AATGATTGACT
CCAAGTTAACA -> CAAGTTAACAC
CATTTAGCCGG -> ATTTAGCCGGA
TTCTTGCATGT -> TCTTGCATGTG
CGTCAGCGCAT -> GTCAGCGCATT
GCGGCGAGATG -> CGGCGAGATGA
TCCCAGGTTTT -> CCCAGGTTTTG
AGACGACGCGG -> GACGACGCGGG
TAGCATACACC -> AGCATACACCA
AGTGGCCCAGG -> GTGGCCCAGGA
CTTCCCCGGTC -> TTCCCCGGTCG
CAGATATTATC -> AGATATTATCT
CCATCACACAG -> CATCACACAGA
TTGAAGCGGCG -> TGAAGCGGCGA
CGTGCTAGACT -> GTGCTAGACTC
TGGCACTGCAA -> GGCACTGCAAG
AAAAATCAACA -> AAAATCAACAA
GTACCCGCGAA -> TACCCGCGAAC
CACCTCTCCAC -> ACCTCTCCACG
TAGCAAACAGC -> AGCAAACAGCA
ATGGGCGGTAG -> TGGGCGGTAGC
GCAACCATCGT -> CAACCATCGTT
TCCGGCGGTTC -> CCGGCGGTTCT
AGACGATTGAC -> GACGATTGACC
CAAAGATGCGT -> AAAGATGCGTG
CGAGAGATCGA -> GAGAGATCGAG
GTTGGGAATAT -> TTGGGAATATT
ACGTGCGTCGT -> CGTGCGTCGTT
ATAATCTGGCT -> TAATCTGGCTC
CACAAGTAGCA -> ACAAGTAGCAA
ATCCCCCTCTT -> TCCCCCTCTTG
CAACGTGCGTC -> AACGTGCGTCG
CCGTATCCATC -> CGTATCCATCA
GGGGACGCGGT -> GGGACGCGGTC
GGGACGCGGTC -> GGACGCGGTCT
TCTCCACGCTT -> CTCCACGCTTC
CGGGCCCGTTT -> GGGCCCGTTTG
TCTACGTAATC -> CTACGTAATCC
ATTGATCTTTT -> TTGATCTTTTT
AGACGGATCTG -> GACGGATCTGG
TCTATAAGGTT -> CTATAAGGTTT
AAACAGCTGGG -> AACAGCTGGGG
AAGCTGACTGG -> AGCTGACTGGC
GGTTATGAACG -> GTTATGAACGG
CTCCTAGTGAG -> TCCTAGTGAGT
TATGTCTACGT -> ATGTCTACGTA
AGAGTCCTAAT -> GAGTCCTAATT
TATTTCATTCG -> ATTTCATTCGT
GTGCCCTTTCC -> TGCCCTTTCCT
GGTTAGTTATA -> GTTAGTTATAG
GGATTTATACT -> GATTTATACTA
TGCTGATCCGA -> GCTGATCCGAG
AGACTCCGCTA -> GACTCCGCTAG
GGATTAGTGCC -> GATTAGTGCCG
CACAGATCGGA -> ACAGATCGGAG
CTGACTTTTTT -> TGACTTTTTTT
GACCGTATCCA -> ACCGTATCCAT
CGCCAAAACGT -> GCCAAAACGTT
ACATTAGCGGA -> CATTAGCGGAC
GGTTCGCTTCT -> GTTCGCTTCTG
CTTTTATCACT -> TTTTATCACTC
CGATTTAGAAC -> GATTTAGAACG
TCTATAGTCCT -> CTATAGTCCTA
TAGCTAGGAAC -> AGCTAGGAACT
TCTTTTGGCCA -> CTTTTGGCCAC
TAGAACGAGCC -> AGAACGAGCCA
CTGCTCTCTAC -> TGCTCTCTACA
ACGTGTGGGCG -> CGTGTGGGCGG
AATAGCATACA -> ATAGCATACAC
ACAACTGACTT -> CAACTGACTTT
ACAGTGACCGA -> CAGTGACCGAT
TGGGCGGCAAA -> GGGCGGCAAAC
CATAGTCCATT -> ATAGTCCATTA
AGGCGGGGTCT -> GGCGGGGTCTA
CGTCTCTTAGG -> GTCTCTTAGGA
AGGTTTTGTAA -> GGTTTTGTAAG
CTTCGGAATGA -> TTCGGAATGAT
CGCTACCGCCA -> GCTACCGCCAG
GTTATGAACGG -> TTATGAACGGA
ATCACACAGAT -> TCACACAGATC
CCTCTGAATCG -> CTCTGAATCGA
GCGGTCTAGCC -> CGGTCTAGCCG
TGCCGTCTAAG -> GCCGTCTAAGT
GAAGCTGACTG -> AAGCTGACTGG
GGCTTTTATCA -> GCTTTTATCAC
TTCCCCGGTCG -> TCCCCGGTCGT
CCAGGGACGTT -> CAGGGACGTTC
GTCCCACGAGA -> TCCCACGAGAC
AATACGCTACC -> ATACGCTACCA
CACGAGGAATG -> ACGAGGAATGC
AGGCAGGACTG -> GGCAGGACTGC
GTATAAACCAT -> TATAAACCATC
TGCTCTATAGT -> GCTCTATAGTC
CGGCAAACCCG -> GGCAAACCCGT
GACTCCGCTAG -> ACTCCGCTAGA
TGCACAACTGA -> GCACAACTGAC
GAGGCCCTATA -> AGGCCCTATAT
AGGAACTTTCT -> GGAACTTTCTT
AGGAAGCTGAC -> GGAAGCTGACT
CTACGTAATCC -> TACGTAATCCA
TAGGCGTGGCA -> AGGCGTGGCAA
CCCCAAGAACT -> CCCAAGAACTC
GCTTTTATCAC -> CTTTTATCACT
TCGGGACGTGC -> CGGGACGTGCT
ACGAGGGGAGC -> CGAGGGGAGCG
CAAACCCGTCA -> AAACCCGTCAG
GTCACCTTCTC -> TCACCTTCTCC
TAAACCGTTAT -> AAACCGTTATC
ACCGTTATCTT -> CCGTTATCTTA
TAACGTGTGGG -> AACGTGTGGGC
AGATCGGAGTT -> GATCGGAGTTG
GTGACCGATTT -> TGACCGATTTG
AAGGCTCCCCG -> AGGCTCCCCGG
TTCTTGAAGCG -> TCTTGAAGCGG
TCACGATTTAG -> CACGATTTAGA
ACGATTTAGAA -> CGATTTAGAAC
TTCGAGGAGGA -> TCGAGGAGGAT
GGAGGCATGCG -> GAGGCATGCGA
CTAAACCGTTA -> TAAACCGTTAT
TCTGCCGGTTA -> CTGCCGGTTAA
TGATCCGAGCT -> GATCCGAGCTC
CATGTGCACGT -> ATGTGCACGTT
TTATCTGCCGG -> TATCTGCCGGT
CGGACTCCGTG -> GGACTCCGTGC
GACCGAGTGGC -> ACCGAGTGGCC
ATTACCATCGC -> TTACCATCGCT
ATTATGTCTAC -> TTATGTCTACG
CTATTTTCGCT -> TATTTTCGCTA
CAAGGGGACGC -> AAGGGGACGCG
GAATCGAATGG -> AATCGAATGGT
TTTCGTGGTTA -> TTCGTGGTTAG
CAGCATTTCCA -> AGCATTTCCAG
CTCAGAACGGG -> TCAGAACGGGC
AAGGATATTCA -> AGGATATTCAA
CGCTACCAATG -> GCTACCAATGT
TATTTTCGCTA -> ATTTTCGCTAC
TCGTCCACGCC -> CGTCCACGCCC
TGTATCTACAT -> GTATCTACATA
CATTCGTGAGA -> ATTCGTGAGAG
GACGATATTTC -> ACGATATTTCA
ACGCCTAAACC -> CGCCTAAACCG
GTCTTGCACAT -> TCTTGCACATG
TCCAAGTTAAC -> CCAAGTTAACA
TTAAGTCACCT -> TAAGTCACCTT
GACTCTCTCTA -> ACTCTCTCTAA
GTTAACACAGC -> TTAACACAGCA
AATTCAACGTG -> ATTCAACGTGC
ACAAGAGTCCT -> CAAGAGTCCTA
GTGGATCTACA -> TGGATCTACAT
TCCTGGACCCC -> CCTGGACCCCC
AGCTCTCTTAG -> GCTCTCTTAGC
CTGGCACTGCA -> TGGCACTGCAA
AGACAAACCCA -> GACAAACCCAG
AGTTATAGCTA -> GTTATAGCTAG
CCCTGTATGTC -> CCTGTATGTCC
AGGAAGTTAAC -> GGAAGTTAACG
GCTTAGGCGTG -> CTTAGGCGTGG
TCCAAATAATT -> CCAAATAATTT
GCCAAAGTTAC -> CCAAAGTTACG
CACGTTGGGAA -> ACGTTGGGAAT
ACCATCGCTAT -> CCATCGCTATT
ACTTATTATGT -> CTTATTATGTC
ACTGACTTTTT -> CTGACTTTTTT
GCGCCCTTCCC -> CGCCCTTCCCC
ATTACACTATG -> TTACACTATGT
GATCAAGCGCC -> ATCAAGCGCCC
TGGCAAACAGC -> GGCAAACAGCT
CCAGGCGAAAT -> CAGGCGAAATC
TTCGGGACGTG -> TCGGGACGTGC
TCTTGCACATG -> CTTGCACATGG
ATGTAGTCGTC -> TGTAGTCGTCC
GGCCCAGGAAG -> GCCCAGGAAGC
TTAGCGCACCT -> TAGCGCACCTC
AAACGCCAAAA -> AACGCCAAAAC
GTCGTATAAAC -> TCGTATAAACC
CACGCCCAGCT -> ACGCCCAGCTT
TTCGTACCTCT -> TCGTACCTCTG
GAGCTCTCTTA -> AGCTCTCTTAG
TTGGCGGACAT -> TGGCGGACATA
TATTTGTCCTC -> ATTTGTCCTCA
CCCAATAGCAT -> CCAATAGCATA
TTTCATCCCCC -> TTCATCCCCCT
TGTGGGCGGCA -> GTGGGCGGCAA
ACATAATGATT -> CATAATGATTG
CATCGGCCCCT -> ATCGGCCCCTC
CCGGTTCGCGG -> CGGTTCGCGGA
CGACCGTATCC -> GACCGTATCCA
TCAGGAAGTTA -> CAGGAAGTTAA
TTAAGACTCTT -> TAAGACTCTTT
TTTGGCCACAT -> TTGGCCACATA
CAAACAGCAGT -> AAACAGCAGTT
TCAACAATACG -> CAACAATACGC
TCAACGTGCGT -> CAACGTGCGTC
GCGTGGCAAAC -> CGTGGCAAACA
GCATTTAGCCG -> CATTTAGCCGG
GAGTTCTTGAA -> AGTTCTTGAAG
TGCACATGGGC -> GCACATGGGCG
TTAGGAAGAAA -> TAGGAAGAAAC
GCTTTGTTGAC -> CTTTGTTGACA
CAGGGGGTGAA -> AGGGGGTGAAG
GAGCCAGCCAT -> AGCCAGCCATA
CTTTCTTATTT -> TTTCTTATTTG
ATTCAACGTGC -> TTCAACGTGCG
TTAGGCGTGGC -> TAGGCGTGGCA
ATCTGGCTCAC -> TCTGGCTCACA
TTTAGGCCCCG -> TTAGGCCCCGC
GAGATCGAGGT -> AGATCGAGGTG
TTACCATCGCT -> TACCATCGCTA
GAGTGACGATA -> AGTGACGATAT
ATGTATAGGGT -> TGTATAGGGTT
CTCTTAGGAAG -> TCTTAGGAAGA
CTGTACCGGTC -> TGTACCGGTCT
GCGGGACCGAG -> CGGGACCGAGT
GCTGATCCGAG -> CTGATCCGAGC
TAGACGACGCG -> AGACGACGCGG
AGTGAGTGACG -> GTGAGTGACGA
CCGGACCGCAT -> CGGACCGCATT
CTAGAACGAGC -> TAGAACGAGCC
AGAAACGAAAA -> GAAACGAAAAA
TATATCCCAGG -> ATATCCCAGGT
AATAATTTTCG -> ATAATTTTCGG
CAATAGCATAC -> AATAGCATACA
CAGCCATATCT -> AGCCATATCTC
TTTTTTTCATC -> TTTTTTCATCC
TTGTTGACACT -> TGTTGACACTT
CGCCTGGGGGC -> GCCTGGGGGCC
TTCCGGCGGTT -> TCCGGCGGTTC
CGGGGACGTGC -> GGGGACGTGCA
GGTCGTTTTAG -> GTCGTTTTAGG
CTGCCGGTTAA -> TGCCGGTTAAT
ATTTAGGGTTC -> TTTAGGGTTCG
AGGCAAGGCTC -> GGCAAGGCTCC
GTTCTTCTGTC -> TTCTTCTGTCA
GGTGCAACCAT -> GTGCAACCATC
GGCACTGCAAG -> GCACTGCAAGG
CTCTTTGTAGA -> TCTTTGTAGAC
GAGATTCCAGA -> AGATTCCAGAC
GTCTACGTAAT -> TCTACGTAATC
CCCAAGAACTC -> CCAAGAACTCT
CGCGGTCTAGC -> GCGGTCTAGCC
CTCACTTAAGA -> TCACTTAAGAC
GCCGATCGACC -> CCGATCGACCG
CCCAAGGGGAC -> CCAAGGGGACG
GAGTCCGGGCC -> AGTCCGGGCCA
CCGATTTGCTT -> CGATTTGCTTG
AAACCCAGGGG -> AACCCAGGGGG
GTACCGGTCTT -> TACCGGTCTTG
CGCCCCCGGGA -> GCCCCCGGGAA
TACCATCGCTA -> ACCATCGCTAT
TTCGATTGTGT -> TCGATTGTGTA
TTACGCATCCT -> TACGCATCCTT
TAACTGCTCTC -> AACTGCTCTCT
GTGAGTGACGA -> TGAGTGACGAT
GAACGTATGGC -> AACGTATGGCG
TGCTAGACTCC -> GCTAGACTCCG
GCCGTCTAAGT -> CCGTCTAAGTG
TTATTTGTCCT -> TATTTGTCCTC
GATCTGGCGTG -> ATCTGGCGTGT
CATTACCATCG -> ATTACCATCGC
GCAAAGATGCG -> CAAAGATGCGT
CGAATGCACAA -> GAATGCACAAG
GGAGCGCCCCC -> GAGCGCCCCCG
TGTCATTGATC -> GTCATTGATCA
TAGGTGGCCTC -> AGGTGGCCTCA
GTTTTAGGCCC -> TTTTAGGCCCC
CCAGGGGGTGA -> CAGGGGGTGAA
AGTGAGAATGT -> GTGAGAATGTT
AGGGGACGCGG -> GGGGACGCGGT
AACGTTCTGGC -> ACGTTCTGGCA
ATCTACATACC -> TCTACATACCG
AGGGACGTTCG -> GGGACGTTCGT
GATTTTTCGAG -> ATTTTTCGAGG
AGGGGGTGAAG -> GGGGGTGAAGG
GTTTTGTAAGA -> TTTTGTAAGAT
TACAGGAGTCC -> ACAGGAGTCCG
TATTGATCTTT -> ATTGATCTTTT
CCGGCGGTTCT -> CGGCGGTTCTT
AAACCATCACA -> AACCATCACAC
AGCCATATCTC -> GCCATATCTCG
CTCACAGTGAC -> TCACAGTGACC
ATAGCTAGGAA -> TAGCTAGGAAC
CCGCGTGTCCC -> CGCGTGTCCCC
CCGGGATTTAT -> CGGGATTTATA
ACGGATCTGGC -> CGGATCTGGCG
AACCCGTCAGC -> ACCCGTCAGCG
GAGGAATGCCA -> AGGAATGCCAA
ACCAATACACG -> CCAATACACGC
TAGACCAATAC -> AGACCAATACA
GCAAGGCTCCC -> CAAGGCTCCCC
ACGAGCACAGA -> CGAGCACAGAC
CGAACCCCCCG -> GAACCCCCCGA
TAACATCCTGG -> AACATCCTGGA
ATGGTGCCAAA -> TGGTGCCAAAG
CGAGTGGCCCA -> GAGTGGCCCAG
TGGCCCAGGAA -> GGCCCAGGAAG
GGGACTCTCTC -> GGACTCTCTCT
TAAGGGTTCGG -> AAGGGTTCGGG
CTATGTGTAAA -> TATGTGTAAAC
AGGCATGCGAC -> GGCATGCGACG
CTACCAATGTG -> TACCAATGTGA
TGATTTATGTA -> GATTTATGTAT
AATGTTACTAT -> ATGTTACTATA
TTAGTTAAACG -> TAGTTAAACGC
ACCGCCAGTAA -> CCGCCAGTAAG
CGTGAGAGCCA -> GTGAGAGCCAG
AAGAACTCTTT -> AGAACTCTTTT
TCCTAGTACCC -> CCTAGTACCCG
TTTGTCCTCAC -> TTGTCCTCACG
GTTAACGTCAA -> TTAACGTCAAT
TCTAGGTGGCC -> CTAGGTGGCCT
GCCCAGGCAAG -> CCCAGGCAAGG
GATGAGTTCTT -> ATGAGTTCTTG
TGAAAGGTGCC -> GAAAGGTGCCC
CGTTCCGCGTG -> GTTCCGCGTGT
TGCTCAGACCC -> GCTCAGACCCT
TAGTGAGTGAC -> AGTGAGTGACG
AGACGGGGCGG -> GACGGGGCGGA
TCCAGGGACGT -> CCAGGGACGTT
TGAGTTCTTGA -> GAGTTCTTGAA
TGCTTTGTTGA -> GCTTTGTTGAC
CATACCGATCA -> ATACCGATCAC
TGTATAGGGTT -> GTATAGGGTTA
CCTTAGACCAA -> CTTAGACCAAT
CACACAGATCG -> ACACAGATCGG
CACAACTGACT -> ACAACTGACTT
ATGCCAAAGGC -> TGCCAAAGGCA
GTATACTCAGA -> TATACTCAGAA
GCCTGGGGGCC -> CCTGGGGGCCC
GTTACGCATGA -> TTACGCATGAA
GCGGACATAGT -> CGGACATAGTC
CTCTACAACAA -> TCTACAACAAG
TTTCATTCGTG -> TTCATTCGTGA
GCGGGGAGGCA -> CGGGGAGGCAT
CGAGGGGAGCG -> GAGGGGAGCGC
ATCCTAGTACC -> TCCTAGTACCC
TACCAATGTGA -> ACCAATGTGAA
GACGCGGTCTA -> ACGCGGTCTAG
GAGGATTAGTG -> AGGATTAGTGC
ACGAAAAATCA -> CGAAAAATCAA
CCGGTTAATTG -> CGGTTAATTGC
TAAGACTCTTT -> AAGACTCTTTG
TCATTCGTGAG -> CATTCGTGAGA
GACTCTTTGTA -> ACTCTTTGTAG
CGGCGGTTCTT -> GGCGGTTCTTG
GCCAAAACGTT -> CCAAAACGTTC
CTATAAACTTC -> TATAAACTTCG
GACGTGCTCTA -> ACGTGCTCTAT
TCCGCTAGACT -> CCGCTAGACTT
ACGATATTTCA -> CGATATTTCAT
TCAGAACGGGC -> CAGAACGGGCC
ACGTAATTACA -> CGTAATTACAC
GACGTGCACAA -> ACGTGCACAAC
GCTCTAGGTGG -> CTCTAGGTGGC
GGACGTGCACA -> GACGTGCACAA
ATTTTCGGAAC -> TTTTCGGAACT
AAATGTAGTCG -> AATGTAGTCGT
CTCCGTGCTGT -> TCCGTGCTGTC
GAACTCCTAGT -> AACTCCTAGTG
GCAAGGCGGGG -> CAAGGCGGGGT
TATACTAGCTA -> ATACTAGCTAG
CTGACTGGCTT -> TGACTGGCTTT
AGTATGCGCGG -> GTATGCGCGGG
CGGGGAGGCAT -> GGGGAGGCATG
CACAGATATTA -> ACAGATATTAT
AATGCACAAGT -> ATGCACAAGTA
TCACTCTCCGG -> CACTCTCCGGG
CACGCTTCGGA -> ACGCTTCGGAA
TTATGTCTACG -> TATGTCTACGT
GACTGGCCGTC -> ACTGGCCGTCT
AAACGAAAAAT -> AACGAAAAATC
ATCTTTTTACG -> TCTTTTTACGC
TCGATTGTGTA -> CGATTGTGTAA
GCGGACTCATA -> CGGACTCATAC
GAACGGGCCCG -> AACGGGCCCGT
GGGGAGCGCCC -> GGGAGCGCCCC
TCCTCCCACCG -> CCTCCCACCGA
GACTGCAAAGA -> ACTGCAAAGAT
TCCGTGCTGTC -> CCGTGCTGTCT
GGGAATATTGA -> GGAATATTGAT
ACCCGCGAACA -> CCCGCGAACAT
CACTAAGGGTT -> ACTAAGGGTTC
GGCGGTTCTTG -> GCGGTTCTTGC
CAAGAGTCCTA -> AAGAGTCCTAA
ACGTAGATTTT -> CGTAGATTTTT
TTAACGGGGAC -> TAACGGGGACG
AAACAGCAGTT -> AACAGCAGTTC
TGGACCCCCCC -> GGACCCCCCCA
CGCGAACATTA -> GCGAACATTAG
TTCATTCGTGA -> TCATTCGTGAG
CCACATAACGT -> CACATAACGTG
AATGATTGACT -> ATGATTGACTG
GAATGCCAAAG -> AATGCCAAAGG
CGGGGTCTATA -> GGGGTCTATAA
TAGCCTACATC -> AGCCTACATCG
CAGACAAACCC -> AGACAAACCCA
AGAGCCAGCCA -> GAGCCAGCCAT
GTCGTTGCTGA -> TCGTTGCTGAT
TTGCTTTGTTG -> TGCTTTGTTGA
CGCGTATTTCG -> GCGTATTTCGT
ACTCCTAGTGA -> CTCCTAGTGAG
CCACAGATATT -> CACAGATATTA
ACATCCTGGAC -> CATCCTGGACC
TGTCTAGCCCA -> GTCTAGCCCAG
GTTCCGGCGGT -> TTCCGGCGGTT
TGACTTTTTTT -> GACTTTTTTTC
ACGCTTCGGAA -> CGCTTCGGAAT
TCGACCGTATC -> CGACCGTATCC
ACTTTTTTTCA -> CTTTTTTTCAT
ATGAGTTCTTG -> TGAGTTCTTGA
TCACTTAAGAC -> CACTTAAGACT
CGGGGACTCTC -> GGGGACTCTCT
GTGAACGCGAG -> TGAACGCGAGT
GATCGACCGTA -> ATCGACCGTAT
TAATTTTCGGA -> AATTTTCGGAA
CGGTCGTTTTA -> GGTCGTTTTAG
AACGCCAAAAC -> ACGCCAAAACG
CCAAGGGGACG -> CAAGGGGACGC
GTCTAGCCCAG -> TCTAGCCCAGG
TATTTCGTGGT -> ATTTCGTGGTT
ATGAACGGATC -> TGAACGGATCC
CCATCGTTCCG -> CATCGTTCCGC
TCGGCCCCTCT -> CGGCCCCTCTG
CGCGAGATTCC -> GCGAGATTCCA
GGTGCCAAAGT -> GTGCCAAAGTT
GGGAGGCATGC -> GGAGGCATGCG
CTAGGAACTTT -> TAGGAACTTTC
ATTCGATTGTG -> TTCGATTGTGT
GACACTTATTA -> ACACTTATTAT
GGAAGAAACGA -> GAAGAAACGAA
ATTTATACTAG -> TTTATACTAGC
GCCTACATCGG -> CCTACATCGGC
GGGGAGAGTCG -> GGGAGAGTCGA
CTCAGACCCTG -> TCAGACCCTGT
CCACGCCCAGC -> CACGCCCAGCT
GCTGGGGAGAG -> CTGGGGAGAGT
TACATAATGAT -> ACATAATGATT
CACCGACGTAG -> ACCGACGTAGA
GGTGGCCTCAC -> GTGGCCTCACT
AAAAGGCTCTA -> AAAGGCTCTAG
CGTTTTAGGCC -> GTTTTAGGCCC
CAGCGGGGACT -> AGCGGGGACTC
TAGCCGCACTA -> AGCCGCACTAA
GAGATGACCCC -> AGATGACCCCA
CTCCGGGATTT -> TCCGGGATTTA
TGCGACGTAAT -> GCGACGTAATT
TAAACTATAAA -> AAACTATAAAC
CAAACAGCTGG -> AAACAGCTGGG
GTCATTGATCA -> TCATTGATCAA
CAACAAGAGTC -> AACAAGAGTCC
TGGCGTGTATC -> GGCGTGTATCT
GCTAGACTCCG -> CTAGACTCCGC
ATGATTTATGT -> TGATTTATGTA
GTAAGATAGTA -> TAAGATAGTAC
TTACGCATGAA -> TACGCATGAAA
TAATTAAGTCA -> AATTAAGTCAC
GTTATCTTAGT -> TTATCTTAGTT
ATCGACCGTAT -> TCGACCGTATC
CGCGGACTCCG -> GCGGACTCCGT
CGTATCCATCA -> GTATCCATCAC
CCAGCTTAGGC -> CAGCTTAGGCG
CCCCCGAGAGA -> CCCCGAGAGAA
CAAAGGCAGGA -> AAAGGCAGGAC
CGAGACGATTG -> GAGACGATTGA
TACCATTCGAT -> ACCATTCGATT
GTAATTAAGTC -> TAATTAAGTCA
CGGAGTTGGGC -> GGAGTTGGGCA
AACTTTCTTAT -> ACTTTCTTATT
GGGGACGTGCA -> GGGACGTGCAC
GGGACGTGCTC -> GGACGTGCTCT
AGGCTCTAGGT -> GGCTCTAGGTG
GGGTTATGAAC -> GGTTATGAACG
AAATCAGGAAG -> AATCAGGAAGT
TATCTGCCGGT -> ATCTGCCGGTT
ATTTGTCCTCA -> TTTGTCCTCAC
TTGCTGATCCG -> TGCTGATCCGA
TCCCCAAGGGG -> CCCCAAGGGGA
CCCCCCGAGAG -> CCCCCGAGAGA
TGCACGTTGGG -> GCACGTTGGGA
ATAAACCATCA -> TAAACCATCAC
GGCGTGTATCT -> GCGTGTATCTA
ACCTTCTCCCG -> CCTTCTCCCGT
TCCCGTGTACC -> CCCGTGTACCA
TCTTGCATGTG -> CTTGCATGTGC
TGATGCGAGAG -> GATGCGAGAGA
CCGTTATCTTA -> CGTTATCTTAG
GGGCAACTCTC -> GGCAACTCTCG
AACGAAAAATC -> ACGAAAAATCA
CTCTTTTGGCC -> TCTTTTGGCCA
CCGCGAACATT -> CGCGAACATTA
CAGTAAGGTCG -> AGTAAGGTCGT
GTACCTCTGAA -> TACCTCTGAAT
TAGATTTTTCG -> AGATTTTTCGA
CAATAAGGAGA -> AATAAGGAGAC
GTAGACGACGC -> TAGACGACGCG
TACCTTAGACC -> ACCTTAGACCA
GTTATAGCTAG -> TTATAGCTAGG
AATGATTTATG -> ATGATTTATGT
CCCGAGAGAAA -> CCGAGAGAAAT
AAGGCGGGGTC -> AGGCGGGGTCT
GCGAGATGACC -> CGAGATGACCC
CTCCCCGGGTT -> TCCCCGGGTTG
TCCATCACGAT -> CCATCACGATT
CGACGTAATTA -> GACGTAATTAC
GGATCTACATA -> GATCTACATAC
CAAGTAGCAAA -> AAGTAGCAAAC
TGGGGGCCCGA -> GGGGGCCCGAT
TAAGTGAGAAT -> AAGTGAGAATG
CAGTTCTTCTG -> AGTTCTTCTGT
AACGTATGGCG -> ACGTATGGCGG
ATCACTCTCCG -> TCACTCTCCGG
ACCCGTCAGCG -> CCCGTCAGCGC
ACGTGCTCTAT -> CGTGCTCTATA
CACTTAAGACT -> ACTTAAGACTC
TCCCCGGTCGT -> CCCCGGTCGTT
ACTCATACAGG -> CTCATACAGGA
TCTTATTTGTC -> CTTATTTGTCC
AAGTGAGAATG -> AGTGAGAATGT
GGCGAAATCAG -> GCGAAATCAGG
ATCGAGGTGCA -> TCGAGGTGCAA
AGATTCCAGAC -> GATTCCAGACA
GGTTCGCGGAC -> GTTCGCGGACT
CGTATAAACCA -> GTATAAACCAT
GACTGCTCAGA -> ACTGCTCAGAC
AACAATACGCT -> ACAATACGCTA
GGGAACGCCTG -> GGAACGCCTGG
AACTGACTTTT -> ACTGACTTTTT
CGTGGCAAACA -> GTGGCAAACAG
GACGGGGCGGA -> ACGGGGCGGAG
TTTACGCATCC -> TTACGCATCCT
CATTCGATTTA -> ATTCGATTTAG
TTCTTATTTGT -> TCTTATTTGTC
CGTGCGTCGTT -> GTGCGTCGTTG
CCCCGAGAGAA -> CCCGAGAGAAA
CCCGTGTACCA -> CCGTGTACCAT
CTTTGTTGACA -> TTTGTTGACAC
GTCCTCACGAG -> TCCTCACGAGG
ACAGCAGTTCT -> CAGCAGTTCTT
ATCTACATAAT -> TCTACATAATG
GCACTGCAAGG -> CACTGCAAGGC
AAGTTAACGTC -> AGTTAACGTCA
CGGGACCGAGT -> GGGACCGAGTG
GATGACCCCAA -> ATGACCCCAAT
GGCCTCACTTA -> GCCTCACTTAA
GGACTCTCTCT -> GACTCTCTCTA
ACCGATTTGCT -> CCGATTTGCTT
GACCGATTTGC -> ACCGATTTGCT
ACCGACGTAGA -> CCGACGTAGAT
TGACTGATAAC -> GACTGATAACA
GAGAAATAATC -> AGAAATAATCT
ACACTTATTAT -> CACTTATTATG
GAGGTGCAACC -> AGGTGCAACCA
TGCAAGGCGGG -> GCAAGGCGGGG
GAGGGGAGCGC -> AGGGGAGCGCC
CCCGGTCGTTT -> CCGGTCGTTTT
AAGCAGCGGGG -> AGCAGCGGGGA
ACTATGTGTAA -> CTATGTGTAAA
CAAGGCTCCCC -> AAGGCTCCCCG
CTCTGTTTCCA -> TCTGTTTCCAA
CAACAATACGC -> AACAATACGCT
GGACCGAGTGG -> GACCGAGTGGC
TCCGAGCTCTC -> CCGAGCTCTCT
GGTCTTGCACA -> GTCTTGCACAT
GCCGGTTAATT -> CCGGTTAATTG
GAAGCGGCGAG -> AAGCGGCGAGA
GTTCTTGAAGC -> TTCTTGAAGCG
GGCGGGGTCTA -> GCGGGGTCTAT
AGTGACGATAT -> GTGACGATATT
TGTATACTCAG -> GTATACTCAGA
TACACCACAGA -> ACACCACAGAT
CACATGGGCGG -> ACATGGGCGGT
ACAGATATTAT -> CAGATATTATC
GCGAGATTCCA -> CGAGATTCCAG
AGGTGCAACCA -> GGTGCAACCAT
GGGGTGAAGGA -> GGGTGAAGGAT
GCCAGCCATAT -> CCAGCCATATC
ATTGATCAAGC -> TTGATCAAGCG
ACAAGTAGCAA -> CAAGTAGCAAA
GGAGAGTCGAA -> GAGAGTCGAAC
CTGCAAAGATG -> TGCAAAGATGC
AATCGAATGGT -> ATCGAATGGTG
TGCCAAAGGCA -> GCCAAAGGCAG
TAGCCGGACCG -> AGCCGGACCGC
GTCGTCCACGC -> TCGTCCACGCC
CCATCGCTATT -> CATCGCTATTT
ACGTAATCCAA -> CGTAATCCAAA
AGAATGTTACT -> GAATGTTACTA
TTACGACGAGG -> TACGACGAGGG
CACGCCTAAAC -> ACGCCTAAACC
TATCCATCACG -> ATCCATCACGA
TCGGAGTTGGG -> CGGAGTTGGGC
CCAAATAATTT -> CAAATAATTTT
CCCCTCTGTTT -> CCCTCTGTTTC
GACCCCAATAG -> ACCCCAATAGC
TAGTCCTAATT -> AGTCCTAATTC
CCGAGCTCTCT -> CGAGCTCTCTT
AACTCTCGTGG -> ACTCTCGTGGA
GCGGTAGCCTA -> CGGTAGCCTAC
TGTAGACGACG -> GTAGACGACGC
TCCATTACCAT -> CCATTACCATC
ACATAGTCCAT -> CATAGTCCATT
GTTGACACTTA -> TTGACACTTAT
CGAGTGATGCG -> GAGTGATGCGA
GCGGAGAAGCA -> CGGAGAAGCAG
CAGCTGGGGAG -> AGCTGGGGAGA
GGCCCGTTTGT -> GCCCGTTTGTT
GGTTAATTGCT -> GTTAATTGCTT
AGTAAGGTCGT -> GTAAGGTCGTA
GTGCCGATCGA -> TGCCGATCGAC
TCCTAATTCAA -> CCTAATTCAAC
AGTGCCGATCG -> GTGCCGATCGA
GGAAGCTGACT -> GAAGCTGACTG
AGCGCCCTTCC -> GCGCCCTTCCC
GGTGAAGGATA -> GTGAAGGATAT
TTCGTGGTTAG -> TCGTGGTTAGT
TCTTAGCGCAC -> CTTAGCGCACC
ATCACGATTTA -> TCACGATTTAG
GGAGTCCGGGC -> GAGTCCGGGCC
CTAGACTTGCT -> TAGACTTGCTC
CTCTCCACGCT -> TCTCCACGCTT
CTTAGACCAAT -> TTAGACCAATA
GGACTGGCCGT -> GACTGGCCGTC
ATGGCGGACTG -> TGGCGGACTGG
TGCCAAAGTTA -> GCCAAAGTTAC
ACATCGGCCCC -> CATCGGCCCCT
ACAGCATTTCC -> CAGCATTTCCA
CTTTTGGCCAC -> TTTTGGCCACA
AAACCCGTCAG -> AACCCGTCAGC
CATTCCGGTTC -> ATTCCGGTTCG
GGGGCCCGATG -> GGGCCCGATGA
GCTACCGCCAG -> CTACCGCCAGT
TTTTGTAAGAT -> TTTGTAAGATA
AGAACTCTTTT -> GAACTCTTTTG
TGGGCAACTCT -> GGGCAACTCTC
AGCACAGACGG -> GCACAGACGGA
ATCGAATGGTG -> TCGAATGGTGC
TACGCATCCTT -> ACGCATCCTTC
ATAATGATTGA -> TAATGATTGAC
CTTGAAGCGGC -> TTGAAGCGGCG
TACACTATGTG -> ACACTATGTGT
AGCGCATTTAG -> GCGCATTTAGC
CCAGACAAACC -> CAGACAAACCC
GACTGATAACA -> ACTGATAACAT
TCGAGGAGGAT -> CGAGGAGGATT
ATATTCAAATG -> TATTCAAATGT
GACGTTCGTAG -> ACGTTCGTAGT
GGAATGATTTA -> GAATGATTTAT
AATCTGGCTCA -> ATCTGGCTCAC
AGTCCATTACC -> GTCCATTACCA
GGCTCTAGGTG -> GCTCTAGGTGG
TATTATGTCTA -> ATTATGTCTAC
TTCTTCTGTCA -> TCTTCTGTCAT
TCCAGACAAAC -> CCAGACAAACC
CGGACCGCATT -> GGACCGCATTC
TGACACTTATT -> GACACTTATTA
ATTTAGCCGGA -> TTTAGCCGGAC
GGAGGATTAGT -> GAGGATTAGTG
TTTCGAGGAGG -> TTCGAGGAGGA
ACACAGCATTT -> CACAGCATTTC
TGTATGTCCCA -> GTATGTCCCAC
GGGCGGAGAAG -> GGCGGAGAAGC
GGGTCTATAAG -> GGTCTATAAGG
TACACGCCTAA -> ACACGCCTAAA
CGAGGTGCAAC -> GAGGTGCAACC
CAAACCCAGGG -> AAACCCAGGGG
CCCTCTTGGTG -> CCTCTTGGTGC
GTCTAGCCGCA -> TCTAGCCGCAC
CTGGCCGTCTC -> TGGCCGTCTCT
TCTCTAAACTA -> CTCTAAACTAT
CATTGATCAAG -> ATTGATCAAGC
CGCGTGTCCCC -> GCGTGTCCCCA
ACTAGAACGAG -> CTAGAACGAGC
TGGCGGACTGG -> GGCGGACTGGC
ACTGGCCGTCT -> CTGGCCGTCTC
GTGCGTCGTTG -> TGCGTCGTTGC
TCGCTACCGCC -> CGCTACCGCCA
TATCTCGAATG -> ATCTCGAATGC
AAACTATAAAC -> AACTATAAACT
TCTTGGTGCTA -> CTTGGTGCTAC
ACGCTACCAAT -> CGCTACCAATG
AATGCCAAAGG -> ATGCCAAAGGC
GTTCGCGGACT -> TTCGCGGACTC
CGAGGAGGATT -> GAGGAGGATTA
CACAGCATTTC -> ACAGCATTTCC
ATTTCATTCGT -> TTTCATTCGTG
AGACTCTTTGT -> GACTCTTTGTA
CTAAACTATAA -> TAAACTATAAA
ACCTCTCCACG -> CCTCTCCACGC
CACTTATTATG -> ACTTATTATGT
ATCAACAATAC -> TCAACAATACG
TACAATTATAA -> ACAATTATAAC
CGATTTGCTTG -> GATTTGCTTGC
AGTTAACGTCA -> GTTAACGTCAA
GCGAAATCAGG -> CGAAATCAGGA
CGGCGAGATGA -> GGCGAGATGAC
AGGCGAAATCA -> GGCGAAATCAG
ATCACTAGAAC -> TCACTAGAACG
TTGGTGCTACA -> TGGTGCTACAA
AACTTCGTACC -> ACTTCGTACCT
ACGCCTGGGGG -> CGCCTGGGGGC
TTTTGGCCACA -> TTTGGCCACAT
AGTTCTTCTGT -> GTTCTTCTGTC
TTGACTGATAA -> TGACTGATAAC
TATCACTCTCC -> ATCACTCTCCG
CAGCTTAGGCG -> AGCTTAGGCGT
AACAGCAGTTC -> ACAGCAGTTCT
GACTGGCTTTT -> ACTGGCTTTTA
GTTCGCTTCTG -> TTCGCTTCTGT
GAACGCGAGTG -> AACGCGAGTGA
ATCGGAGTTGG -> TCGGAGTTGGG
TCCCCCTCTTG -> CCCCCTCTTGG
CGAACATTAGC -> GAACATTAGCG
GAGACGATTGA -> AGACGATTGAC
GATTTATGTAT -> ATTTATGTATA
CGGGGCGGAGA -> GGGGCGGAGAA
CGCCAGTAAGG -> GCCAGTAAGGT
GCTCACAGTGA -> CTCACAGTGAC
CGGTCTTGCAC -> GGTCTTGCACA
AATTGCTTTGT -> ATTGCTTTGTT
CCGTTTGTTAA -> CGTTTGTTAAC
CACTCTCCGGG -> ACTCTCCGGGA
TGTCCCCAAGG -> GTCCCCAAGGG
GTCTCTTAGGA -> TCTCTTAGGAA
TTAGACCAATA -> TAGACCAATAC
AAGGGGACGCG -> AGGGGACGCGG
ATCGCTATTTT -> TCGCTATTTTC
CGCATCCTTCC -> GCATCCTTCCC
TGGATCTACAT -> GGATCTACATA
CTCCCGTGTAC -> TCCCGTGTACC
TGCCGATCGAC -> GCCGATCGACC
GAACGAGCCAG -> AACGAGCCAGG
CGCATTTAGCC -> GCATTTAGCCG
CGCGGGGAGGC -> GCGGGGAGGCA
AGGAAGAAACG -> GGAAGAAACGA
ACCTCTGAATC -> CCTCTGAATCG
GTGAGAATGTT -> TGAGAATGTTA
GGATCCTAGTA -> GATCCTAGTAC
CGGGACGTGCT -> GGGACGTGCTC
ACATACCGATC -> CATACCGATCA
TATCTACATAA -> ATCTACATAAT
GCGAACATTAG -> CGAACATTAGC
GCCCTTTCCTC -> CCCTTTCCTCC
GTATGTCCCAC -> TATGTCCCACG
TCACACAGATC -> CACACAGATCG
CGATGAGTTCT -> GATGAGTTCTT
AGCCGCACTAA -> GCCGCACTAAG
CCAATACACGC -> CAATACACGCC
AAGCGGCGAGA -> AGCGGCGAGAT
TCACAGTGACC -> CACAGTGACCG
CGGTTCGCGGA -> GGTTCGCGGAC
GCAAACAGCTG -> CAAACAGCTGG
GGTGCCCTTTC -> GTGCCCTTTCC
TCTACATAATG -> CTACATAATGA
ATCTGCCGGTT -> TCTGCCGGTTA
CGTTATCTTAG -> GTTATCTTAGT
TCACCTTCTCC -> CACCTTCTCCC
CGAGAGAAATA -> GAGAGAAATAA
AGAGAAATAAT -> GAGAAATAATC
CGTGGATCTAC -> GTGGATCTACA
CCTGTATGTCC -> CTGTATGTCCC
CGAAAAATCAA -> GAAAAATCAAC
ATATTGATCTT -> TATTGATCTTT
TGTTTCCAAGT -> GTTTCCAAGTT
GAGCACAGACG -> AGCACAGACGG
CCCCGGGTTGT -> CCCGGGTTGTA
CAACTCTCGTG -> AACTCTCGTGG
TGCGTCGTTGC -> GCGTCGTTGCT
CGGGCCAGTAT -> GGGCCAGTATG
GACGAGGGGAG -> ACGAGGGGAGC
TGACCCCAATA -> GACCCCAATAG
CCACGCTTCGG -> CACGCTTCGGA
CGTAATCCAAA -> GTAATCCAAAT
AATACACGCCT -> ATACACGCCTA