CGCGGTTCTTC -> GCGGTTCTTCT
GGGCCCCCCGT -> GGCCCCCCGTC
CCCATGATACT -> CCATGATACTG
TAAGCCGAAGG -> AAGCCGAAGGC
CTGCTCGCACG -> TGCTCGCACGG
TTTGCGTGCTA -> TTGCGTGCTAA
ACTCCGCGGTT -> CTCCGCGGTTC
GGATTCTACCC -> GATTCTACCCA
GACCCCTTTTC -> ACCCCTTTTCT
CTCTACATCCA -> TCTACATCCAG
TAACCCCTATT -> AACCCCTATTT
TAGTAGACAAC -> AGTAGACAACT
ATCAACTCTCT -> TCAACTCTCTT
CCCAGCGTGTG -> CCAGCGTGTGG
CATGACGGACT -> ATGACGGACTA
TCGGATTTGTA -> CGGATTTGTAT
AGTTCCCAAGG -> GTTCCCAAGGC
TGACGTCATGA -> GACGTCATGAT
TCATTCACTGA -> CATTCACTGAG
CGGTATGTCTG -> GGTATGTCTGG
GGTGCGTCTGA -> GTGCGTCTGAT
TACCCTGGCGA -> ACCCTGGCGAA
TAGGAAGACCA -> AGGAAGACCAT
CATTAGTAGAC -> ATTAGTAGACA
TTATCCGCGTA -> TATCCGCGTAG
TGGCAATTGCT -> GGCAATTGCTA
TTCGGCCGGGA -> TCGGCCGGGAA
CCTATAAGATG -> CTATAAGATGG
TTGCGTGTGGA -> TGCGTGTGGAA
TCTACATCCAG -> CTACATCCAGC
CTAGGAAGAGA -> TAGGAAGAGAG
TACGGGTACCA -> ACGGGTACCAA
CTGCGGGGACG -> TGCGGGGACGG
ATTATCTTAGG -> TTATCTTAGGT
TAGCCCAGTCC -> AGCCCAGTCCA
TTCAGACCCCT -> TCAGACCCCTT
TCAGTTAAAGT -> CAGTTAAAGTT
ATCTTTGTGTC -> TCTTTGTGTCT
CGGTTGCAAGG -> GGTTGCAAGGT
AGGATGGGGTC -> GGATGGGGTCG
TCATAACCCCT -> CATAACCCCTA
CGGGAATAGCT -> GGGAATAGCTG
AGTACATTCTG -> GTACATTCTGT
CTTTGAGGACA -> TTTGAGGACAA
GGCGTGGTAGA -> GCGTGGTAGAC
CAGCTTTTAAG -> AGCTTTTAAGC
TGATACTGGTT -> GATACTGGTTT
TTCCTCAGTTG -> TCCTCAGTTGG
TTCTACCCATG -> TCTACCCATGA
TTGCAAGGTCG -> TGCAAGGTCGC
TAATTATCTCC -> AATTATCTCCC
CGGATTTGTAT -> GGATTTGTATT
TAGGTCCGAGA -> AGGTCCGAGAA
AGTTAGAAGGC -> GTTAGAAGGCG
ATAACTTTGTC -> TAACTTTGTCG
TAGAGGAAGGT -> AGAGGAAGGTG
GAGGAAGTAGA -> AGGAAGTAGAT
GACTTACCGGA -> ACTTACCGGAC
CGGCCGGGAAT -> GGCCGGGAATA
AGGGGTATGCG -> GGGGTATGCGA
GTTGCCTATCT -> TTGCCTATCTA
GGTCCGGAACC -> GTCCGGAACCA
CGTAATCTGAG -> GTAATCTGAGG
ATAGGTAATTA -> TAGGTAATTAG
GGTTGCCTATC -> GTTGCCTATCT
TCCCGCTCACT -> CCCGCTCACTC
GCTAGGAAGCA -> CTAGGAAGCAT
ACTAACCCCGG -> CTAACCCCGGA
TTACACCCGTT -> TACACCCGTTC
TTAGTAGACAA -> TAGTAGACAAC
CGCGCTGATAC -> GCGCTGATACC
TTAGGCCCTGG -> TAGGCCCTGGC
CCAGGTCTTTG -> CAGGTCTTTGC
GGTTTGAAACA -> GTTTGAAACAG
AACCATAAGCT -> ACCATAAGCTG
CGCGAATATTG -> GCGAATATTGA
CGAATTACAGA -> GAATTACAGAT
TATAAAGTTCG -> ATAAAGTTCGG
CCCTATAAGAT -> CCTATAAGATG
CGCTGATACCT -> GCTGATACCTG
TGCGTCATTAG -> GCGTCATTAGT
ATTCTAATCAA -> TTCTAATCAAC
TGCAGGTTAAG -> GCAGGTTAAGA
GTCATTCACTG -> TCATTCACTGA
CTTGAAAGCCC -> TTGAAAGCCCT
CTGAGATATAA -> TGAGATATAAC
GTCGAGCGCGC -> TCGAGCGCGCT
TTTAAATAGGT -> TTAAATAGGTA
GTTAGCCCAGC -> TTAGCCCAGCG
TAAAGTTCGGC -> AAAGTTCGGCC
GCGGCACAACT -> CGGCACAACTA
ACGGTGACTAA -> CGGTGACTAAA
AATAGGTAATT -> ATAGGTAATTA
TGTTCCTCAGT -> GTTCCTCAGTT
GTGACTTTCAT -> TGACTTTCATA
AATGAACGTCC -> ATGAACGTCCA
ATACTAACCCC -> TACTAACCCCG
AGCTGTCATTC -> GCTGTCATTCA
GACGCGGTATG -> ACGCGGTATGT
GACTTAGAGAC -> ACTTAGAGACT
CAAGTCCAACC -> AAGTCCAACCA
GCGATTGTTAG -> CGATTGTTAGC
ATAGGTCCGAG -> TAGGTCCGAGA
GAGTATATGGT -> AGTATATGGTC
TACTGACATAT -> ACTGACATATC
GTTCCTCAGTT -> TTCCTCAGTTG
ACTTAGAGACT -> CTTAGAGACTT
GATTGAACCGA -> ATTGAACCGAG
CTGAGGAACGG -> TGAGGAACGGC
GCCAGAACTCC -> CCAGAACTCCA
TCACGGGCCGA -> CACGGGCCGAC
TCTCTGACGAG -> CTCTGACGAGG
GATAGGTCCGA -> ATAGGTCCGAG
TAGGCAGGTCT -> AGGCAGGTCTC
GACCCTGCTCG -> ACCCTGCTCGC
ATAACTATCTT -> TAACTATCTTT
AACTACTGACA -> ACTACTGACAT
CAGCAAGTGTT -> AGCAAGTGTTG
CTTATATGGTT -> TTATATGGTTA
CCGAGAACTTA -> CGAGAACTTAT
ATTACCCTGGC -> TTACCCTGGCG
TTATATGGTTA -> TATATGGTTAG
CACGGGCCGAC -> ACGGGCCGACA
ACCCCTATTTG -> CCCCTATTTGA
AAGTAGATCGA -> AGTAGATCGAA
TCCCACTTCTT -> CCCACTTCTTG
GTTTGAAACAG -> TTTGAAACAGG
AATTTAAGTAC -> ATTTAAGTACA
GTAGAGGAAGG -> TAGAGGAAGGT
CGGGCTTTTAG -> GGGCTTTTAGG
CAGGTAAGACC -> AGGTAAGACCA
CTACATTCTAA -> TACATTCTAAT
TCTGAGGAACG -> CTGAGGAACGG
GATCGAACGCA -> ATCGAACGCAG
ATCTTTAAATA -> TCTTTAAATAG
AGTAGAGTCGA -> GTAGAGTCGAC
GGAATAGCTGG -> GAATAGCTGGA
TTGTGACTTTG -> TGTGACTTTGA
GGCTTTTAGGC -> GCTTTTAGGCC
GCTGAGTAGAT -> CTGAGTAGATC
CGGGCAAACGG -> GGGCAAACGGT
TTTGTATTACT -> TTGTATTACTG
CGTGACTTTCA -> GTGACTTTCAT
CTGATCTTTGT -> TGATCTTTGTG
TGTGTGCGTAA -> GTGTGCGTAAT
ATGGAGGCGGC -> TGGAGGCGGCT
CCAAGGCTATC -> CAAGGCTATCA
TATTACTGATC -> ATTACTGATCT
TTCGCTGACCG -> TCGCTGACCGC
GAGCGCGCTGA -> AGCGCGCTGAT
GGGAGTAGAAA -> GGAGTAGAAAG
CCAACCACAAT -> CAACCACAATG
TACAGATAGGT -> ACAGATAGGTC
CGGTATGTTAC -> GGTATGTTACA
GAAATCGTGAC -> AAATCGTGACT
TGGAATTATCC -> GGAATTATCCG
CTCACAAGAAA -> TCACAAGAAAT
TATCAGATTCG -> ATCAGATTCGG
ATACTGGTTTG -> TACTGGTTTGA
GATTTGTATTA -> ATTTGTATTAC
CGAACGCAGAC -> GAACGCAGACG
TGGGGGATAAG -> GGGGGATAAGC
GAAGACCATCC -> AAGACCATCCT
TGGCAAGTCCA -> GGCAAGTCCAA
TCTTCTCCGTG -> CTTCTCCGTGG
GGCCCCCCGTC -> GCCCCCCGTCC
TGTCTGGCGCG -> GTCTGGCGCGG
GTCGCAGCAAG -> TCGCAGCAAGT
ACCCGTTCAAG -> CCCGTTCAAGT
GTGAGATGAAT -> TGAGATGAATA
AATTCCGCATT -> ATTCCGCATTC
GGAGGGGTATG -> GAGGGGTATGC
CTGTCATTCAC -> TGTCATTCACT
GCTGACCGCGA -> CTGACCGCGAA
AAGAGAGAACG -> AGAGAGAACGT
TCTCATTGCAG -> CTCATTGCAGT
GATGGGACATA -> ATGGGACATAT
GGCAGCTAGCG -> GCAGCTAGCGG
ATATAACTATC -> TATAACTATCT
GTTAAAGTTCA -> TTAAAGTTCAT
ACCATAAGCTG -> CCATAAGCTGT
TAAGTACATTC -> AAGTACATTCT
GGATGGAGGCG -> GATGGAGGCGG
TCAAAATAGAG -> CAAAATAGAGT
GCGGTTCTTCT -> CGGTTCTTCTC
CAAACACTCAG -> AAACACTCAGG
AGGTCTTTGCG -> GGTCTTTGCGT
GGTTCGGCCGG -> GTTCGGCCGGG
CGGCACAACTA -> GGCACAACTAT
CCTTGAGGATG -> CTTGAGGATGG
TGCGAAATAAC -> GCGAAATAACT
CCTCAGTTAAA -> CTCAGTTAAAG
TTAGTCGACGT -> TAGTCGACGTA
GGTTAACCCAG -> GTTAACCCAGG
TTCGGTTGCAA -> TCGGTTGCAAG
CCCCAGGTGAG -> CCCAGGTGAGA
GCGCTAGCATT -> CGCTAGCATTC,CGCTAGCATTA
CGCCTCTGTGT -> GCCTCTGTGTG
GCCGGGAATAG -> CCGGGAATAGC
ACTAAAGTTTG -> CTAAAGTTTGG
TTCGCAAGTTA -> TCGCAAGTTAT
TTTCTTCGATC -> TTCTTCGATCG
CCCAAGGCTAT -> CCAAGGCTATC
GCGTAATCTGA -> CGTAATCTGAG
CTCAGTTAAAG -> TCAGTTAAAGT
TAAGCTGTCAT -> AAGCTGTCATT
TAAGACCACAG -> AAGACCACAGT
GAGGTGACTAT -> AGGTGACTATG
GTCATGATCAT -> TCATGATCATC
GACTTTCATAA -> ACTTTCATAAC
GGGACTCTCAT -> GGACTCTCATA
CAGGATTCTAA -> AGGATTCTAAT
AGGTCCGAGAA -> GGTCCGAGAAC
CCGGATACGAC -> CGGATACGACA
TACACCCGTTC -> ACACCCGTTCA
AACTGGTTGAG -> ACTGGTTGAGG
ATTCGGATCAC -> TTCGGATCACC
AAAGCCCTATA -> AAGCCCTATAA
GAACGTCCATG -> AACGTCCATGA
CGGTTGTACCA -> GGTTGTACCAT
ATCCCGCTCAC -> TCCCGCTCACT
GACCGCGAATA -> ACCGCGAATAT
CAATAATGAAC -> AATAATGAACG
TTCTCCGTGGC -> TCTCCGTGGCA
TCAACTCTCTT -> CAACTCTCTTG
AAGGCTATCAC -> AGGCTATCACC
AATCGCCCCTT -> ATCGCCCCTTT
ACGCTAGGAAG -> CGCTAGGAAGC
ACCACAATGTT -> CCACAATGTTC
CACCGGACGCC -> ACCGGACGCCT
CCGCTTCCCTG -> CGCTTCCCTGA
AAACACTCAGG -> AACACTCAGGT
CCGCGGTTCTT -> CGCGGTTCTTC
AATAATGAACG -> ATAATGAACGT
CCCTTGAGGAT -> CCTTGAGGATG
CGTGACGTCAT -> GTGACGTCATG
ATTCGGTTGCC -> TTCGGTTGCCT
GGCTAGGTCCG -> GCTAGGTCCGG
GGATTTGTATT -> GATTTGTATTA
AACGCGAATGT -> ACGCGAATGTG
CCAAATATTCG -> CAAATATTCGC
CCATCTCTAGG -> CATCTCTAGGA
AGGAAGTAGAT -> GGAAGTAGATC
AAGCCGTCGGA -> AGCCGTCGGAT
AGACGCGGTAT -> GACGCGGTATG
GTTCCGTTGGG -> TTCCGTTGGGT
CCAGTCCAACT -> CAGTCCAACTT
AGGTTAAGAGG -> GGTTAAGAGGG
CCTATTTGATT -> CTATTTGATTG
CCCGTCCCACT -> CCGTCCCACTT
CACCCGTTCAA -> ACCCGTTCAAG
GTCGGATTTGT -> TCGGATTTGTA
AACGCAGACGC -> ACGCAGACGCG
CTGCGTCATTA -> TGCGTCATTAG
CGCAGACGCGG -> GCAGACGCGGT
GACCAAGCCCG -> ACCAAGCCCGC
GTAGAGTCGAC -> TAGAGTCGACT
TCAATTTAAGT -> CAATTTAAGTA
TAGGTGCGTCT -> AGGTGCGTCTG
CAAGTTATTAC -> AAGTTATTACC
TCGGTAGGGAG -> CGGTAGGGAGA
TGCGCTTCGGT -> GCGCTTCGGTT
GCCTAGAACTG -> CCTAGAACTGA
GCAGCAAGTGT -> CAGCAAGTGTT
TCCTCACCGGA -> CCTCACCGGAC
GTACATTCTGT -> TACATTCTGTC
TCCGAGGCGGG -> CCGAGGCGGGC
TGCTGAGTAGA -> GCTGAGTAGAT
CCGCACTGGAG -> CGCACTGGAGG
TAAAGTTCATT -> AAAGTTCATTG
CGCGAATTGAT -> GCGAATTGATT
GCCGACACGAT -> CCGACACGATA
ACACCCGTTCA -> CACCCGTTCAA
TAGAGTCGACT -> AGAGTCGACTG
CCGCCCCGACT -> CGCCCCGACTG
ACGCTGGCGCT -> CGCTGGCGCTA
GTTCGGCCGTT -> TTCGGCCGTTC
AGGATTCTAAT -> GGATTCTAATA
TCTAATAACTA -> CTAATAACTAC
CAGTTGGAGCC -> AGTTGGAGCCG
TTTGCGCTAGC -> TTGCGCTAGCA
GATCGTGGGTA -> ATCGTGGGTAT
AATTCACGGGC -> ATTCACGGGCC
GTACGATTGAG -> TACGATTGAGG
AAACGGTTCGG -> AACGGTTCGGC
TTGTATTACTG -> TGTATTACTGA
GCGAAATAACT -> CGAAATAACTT
AACTTATAAAG -> ACTTATAAAGT
GCATGTTGCAC -> CATGTTGCACC
TGCTAAGCTAT -> GCTAAGCTATA
TGTGCGTAATC -> GTGCGTAATCT
GAAGCATGTTG -> AAGCATGTTGC
CAGCGTGTGGG -> AGCGTGTGGGA
CGGACTAAGAG -> GGACTAAGAGG
GGCGCGGCGCG -> GCGCGGCGCGA
CCGCGAATATT -> CGCGAATATTG
TTAACCCAGGT -> TAACCCAGGTC
ATTACACCCGT -> TTACACCCGTT
CATTCTGTCTA -> ATTCTGTCTAG
AAACAGGATGG -> AACAGGATGGG
TAGGCCCTGGC -> AGGCCCTGGCA
TTGACCCTGCT -> TGACCCTGCTC
TAGCAGCGGCA -> AGCAGCGGCAC
AATTGGGAATC -> ATTGGGAATCG
TGCGAGTATAT -> GCGAGTATATG
GGTATGTCTGG -> GTATGTCTGGC
ACTTTGAGGAC -> CTTTGAGGACA
CGCTTCCCTGA -> GCTTCCCTGAA
GCGGCGCGACT -> CGGCGCGACTA
CTGACAGGCCA -> TGACAGGCCAG
CGAGGCGGGCC -> GAGGCGGGCCC
AGCGCGAATTG -> GCGCGAATTGA
ACCCAGGTCTT -> CCCAGGTCTTT
TGAATAAGTGC -> GAATAAGTGCG
ATCCGATGGGA -> TCCGATGGGAC
TCCGGGCTTTT -> CCGGGCTTTTA
CACTCCGCGGT -> ACTCCGCGGTT
CATATCAGATT -> ATATCAGATTC
TGCCTATCTAG -> GCCTATCTAGC
AGGGCGTGGTA -> GGGCGTGGTAG
CGTCCATGACG -> GTCCATGACGG
TCTGACGTCGA -> CTGACGTCGAG
ATTGACCCTGC -> TTGACCCTGCT
GTGCTAAGCTA -> TGCTAAGCTAT
CGGGGACGGCT -> GGGGACGGCTG
GCGGTATGTCT -> CGGTATGTCTG
CAGAACTCCAC -> AGAACTCCACT
CGTCGAGCGCG -> GTCGAGCGCGC
CCGGGAATAGC -> CGGGAATAGCT
TTTGACTGACA -> TTGACTGACAG
GGTGAGATGAA -> GTGAGATGAAT
TGACCTCAGTT -> GACCTCAGTTA
AGACGGTTAAC -> GACGGTTAACC
GGACTGAACGC -> GACTGAACGCG
TTCTTGGGGGA -> TCTTGGGGGAT
CCGGAACCATA -> CGGAACCATAA
TTCCGCATTCG -> TCCGCATTCGG
ATGGCGCGGTA -> TGGCGCGGTAT
CGGAACCATAA -> GGAACCATAAG
CGAAATAACTT -> GAAATAACTTT
CTAAGCTATAG -> TAAGCTATAGG
ATAATGAACGT -> TAATGAACGTC
ACTGAGATGAG -> CTGAGATGAGC
TTCGGCAGGAT -> TCGGCAGGATT
GTGTTAATTAT -> TGTTAATTATC
CTTGGGGGATA -> TTGGGGGATAA
AGTCCAACTTG -> GTCCAACTTGA
GGGTATGTTCC -> GGTATGTTCCT
TAACCCAGGTC -> AACCCAGGTCT
TGGCGCCTAGA -> GGCGCCTAGAA
CTGGCGCGGCG -> TGGCGCGGCGC
AGTTGGAGCCG -> GTTGGAGCCGG
ACCCCGGATAC -> CCCCGGATACG
GCCGTCGGATT -> CCGTCGGATTT
ATATACGGGTA -> TATACGGGTAC
CCAAGGGTACG -> CAAGGGTACGA
GTACGCGACTT -> TACGCGACTTA
GGCTGCGCTTC -> GCTGCGCTTCG
GAGTTAGAAGG -> AGTTAGAAGGC
GACCATCCTCA -> ACCATCCTCAC
GAACCATAAGC -> AACCATAAGCT
CACAGTAGAGT -> ACAGTAGAGTC
AGGTGACTATG -> GGTGACTATGC
TTGCGTGCTAA -> TGCGTGCTAAG
TTAGAGACTTT -> TAGAGACTTTT
AGCCCAGTCCA -> GCCCAGTCCAA
TCGCTGACCGC -> CGCTGACCGCG
ACCATCCTCAC -> CCATCCTCACC
AGGCAGCTAGC -> GGCAGCTAGCG
GGTGTGCGAAA -> GTGTGCGAAAT
GACTTTGACTG -> ACTTTGACTGA
ATCAAGAAGCG -> TCAAGAAGCGT
TCTTGGGGGAT -> CTTGGGGGATA
GGCCGTTCACA -> GCCGTTCACAT
ACAGGATGGGG -> CAGGATGGGGT
TAGAAAGCTTA -> AGAAAGCTTAT
CGCGGCGCGAC -> GCGGCGCGACT
CTAGAACTGAA -> TAGAACTGAAA
CAGGTCTTTGC -> AGGTCTTTGCG
GCGAATTGATT -> CGAATTGATTT
AGGTAAGACCA -> GGTAAGACCAC
GACGTCATGAT -> ACGTCATGATC
TGCACCCTTGA -> GCACCCTTGAG
GTTTGGCCCGC -> TTTGGCCCGCC
TAAGCCGTCGG -> AAGCCGTCGGA
TCTGTGTGTTA -> CTGTGTGTTAA
AGTAGAAAGCT -> GTAGAAAGCTT
TGTAGTGACCT -> GTAGTGACCTC
GCTGGCGCTAG -> CTGGCGCTAGC
ACCAAGTTCCC -> CCAAGTTCCCA
GTCTGCGGGGA -> TCTGCGGGGAC
GGCAAGTCCAA -> GCAAGTCCAAC
CGGGTAGCCCA -> GGGTAGCCCAG
CTTTCCTTCGC -> TTTCCTTCGCT
TTAAGAGGGAC -> TAAGAGGGACT
GACGGCTGCGC -> ACGGCTGCGCT
TCTTGGCGCCT -> CTTGGCGCCTA
TGGCGCGGCGC -> GGCGCGGCGCG
GAACGCGAATG -> AACGCGAATGT
TCTCCGGGCTT -> CTCCGGGCTTT
CGCGAATGTGT -> GCGAATGTGTG
TCCGCCCCGAC -> CCGCCCCGACT
AGTTCGGCCGT -> GTTCGGCCGTT
TCTGGCGCGGC -> CTGGCGCGGCG
GCAGCGGCACA -> CAGCGGCACAA
CATTAGTCGAC -> ATTAGTCGACG
GACTCTCCGGG -> ACTCTCCGGGC
ATTCACGGGCC -> TTCACGGGCCG
TCATTAGTAGA -> CATTAGTAGAC
ACGCCTCTGTG -> CGCCTCTGTGT
GTAGACTGCGT -> TAGACTGCGTC
GAAGGCGATTG -> AAGGCGATTGT
CCGCGTAGCAG -> CGCGTAGCAGC
ATCATCTGACG -> TCATCTGACGT
ACTGACAGGCC -> CTGACAGGCCA
CTGACGTCGAG -> TGACGTCGAGC
AGCAAGTGTTG -> GCAAGTGTTGT
TAACTACTGAC -> AACTACTGACA
CGATGCAGGTT -> GATGCAGGTTA
GAGGCGGCTCT -> AGGCGGCTCTT
AGCCGGTTGTA -> GCCGGTTGTAC
GAGAGTAGATT -> AGAGTAGATTA
GAGGCGGGCCC -> AGGCGGGCCCC
TCAGACCCCTT -> CAGACCCCTTT
AACCCAGGTCT -> ACCCAGGTCTT
GGAAGAGAGAA -> GAAGAGAGAAC
GCCTCTGTGTG -> CCTCTGTGTGT
ACGGTATACCT -> CGGTATACCTG
AAGGCAGGTCG -> AGGCAGGTCGC
GAAAGCTTATA -> AAAGCTTATAT
TTTGAGGACAA -> TTGAGGACAAT
AAGGGTACGAT -> AGGGTACGATT
CCGCATTCGGA -> CGCATTCGGAT
ACTGATCTTTG -> CTGATCTTTGT
CCCTTTAAGCC -> CCTTTAAGCCC
CCAGAACTCCA -> CAGAACTCCAC
CTAAAGTTTGG -> TAAAGTTTGGC
CGGCCAACTGG -> GGCCAACTGGT
AATAACTTTGT -> ATAACTTTGTC
GTAGTGACCTC -> TAGTGACCTCA
CAGACGCGGTA -> AGACGCGGTAT
TGTGGGACTGA -> GTGGGACTGAA
ATTGTTAGCCC -> TTGTTAGCCCA
TATATGGTTAG -> ATATGGTTAGG
ATGACGGACTA -> TGACGGACTAA
GACTCTCATAC -> ACTCTCATACT
TTGGGGGATAA -> TGGGGGATAAG
CGCTAGGAAGC -> GCTAGGAAGCA
GTGTGTTAATT -> TGTGTTAATTA
AAGCCCTATAA -> AGCCCTATAAG
GGGCGTGGTAG -> GGCGTGGTAGA
TTCGGTTGCCT -> TCGGTTGCCTA
CATTCAATTTA -> ATTCAATTTAA
GCGCGGCGCGA -> CGCGGCGCGAC
GTCTGGCGCGG -> TCTGGCGCGGC
AAGCGTGACGT -> AGCGTGACGTC
CCGTTCACATG -> CGTTCACATGG
TGGCGAATTAC -> GGCGAATTACA
CGGTTCAGACC -> GGTTCAGACCC
CATTGCAGTGG -> ATTGCAGTGGT
GCCGAAGGCAG -> CCGAAGGCAGG
ACGGCCAACTG -> CGGCCAACTGG
TCGACTGTCGT -> CGACTGTCGTC
ATACCTGCTGA -> TACCTGCTGAG
TCCGTTGGGTA -> CCGTTGGGTAC
ATGTTACAGAT -> TGTTACAGATG
CGGTAGGGAGA -> GGTAGGGAGAG
GATTCGGTTGC -> ATTCGGTTGCC
ATCCGCGTAGC -> TCCGCGTAGCA
GCCCGCACTGG -> CCCGCACTGGA
TCCAGCTTTTA -> CCAGCTTTTAA
GGTACGATTGA -> GTACGATTGAG
GGTTGTACCAT -> GTTGTACCATC
GGCGGCTCTTA -> GCGGCTCTTAG
CAGGATGGGGT -> AGGATGGGGTC
ATGAGCAGACG -> TGAGCAGACGG
CAGTTAAAGTT -> AGTTAAAGTTC
GGCTCTTAGAG -> GCTCTTAGAGC
CGGACTCTCCG -> GGACTCTCCGG
TTGAAACAGGA -> TGAAACAGGAT
CAAATATTCGC -> AAATATTCGCC
AGTTATTACCC -> GTTATTACCCT
ATCGTGACTTT -> TCGTGACTTTC
TTTAAGCCGAA -> TTAAGCCGAAG
CTAAGAGGAAG -> TAAGAGGAAGT
GTGACTAAAGT -> TGACTAAAGTT
TCGACAAACAC -> CGACAAACACT
AGCAGACGGTT -> GCAGACGGTTA
GTGACTTTGAC -> TGACTTTGACT
GAAATAACTTT -> AAATAACTTTG
CATAACCCCTA -> ATAACCCCTAT
CGCTGGCGCTA -> GCTGGCGCTAG
GCAAGGTCGCA -> CAAGGTCGCAG
ACCAAGCCCGC -> CCAAGCCCGCA
CAGATAGGTCC -> AGATAGGTCCG
GCCCTGGCAAT -> CCCTGGCAATT
TCGACGTATCA -> CGACGTATCAA
CGTCCCACTTC -> GTCCCACTTCT
TTGTGTCTGCG -> TGTGTCTGCGG
TCATTGACCCT -> CATTGACCCTG
TCCCCAGGTGA -> CCCCAGGTGAG
CTCCCCAGGTG -> TCCCCAGGTGA
TCTTAGAGCTA -> CTTAGAGCTAC
TGGAGGGTATC -> GGAGGGTATCT
CATAAGCTGTC -> ATAAGCTGTCA
CAAGCTTTCCT -> AAGCTTTCCTT
CGTGCTAAGCT -> GTGCTAAGCTA
GGTAGACTGCG -> GTAGACTGCGT
GTATGTTCCTC -> TATGTTCCTCA
GCGTGAGCTCA -> CGTGAGCTCAT
ACCCTTGAGGA -> CCCTTGAGGAT
CGGCTGCGCTT -> GGCTGCGCTTC
TACATCCAGCT -> ACATCCAGCTT
GAATTATCCGC -> AATTATCCGCG
GGCGAATTACA -> GCGAATTACAG
TCCCGATGCAG -> CCCGATGCAGG
GATACTGGTTT -> ATACTGGTTTG
GACCCTTCGGC -> ACCCTTCGGCA
CAACTCCCGAT -> AACTCCCGATG
ATCACCGAAAG -> TCACCGAAAGA
AGCGCGCTGAT -> GCGCGCTGATA
TTGAAAGCCCT -> TGAAAGCCCTA
AGACAACTCCC -> GACAACTCCCG
GAATTGATTTC -> AATTGATTTCC
CATCTCTAGGA -> ATCTCTAGGAA
GAACCGAGGAA -> AACCGAGGAAT
CACTGGAGGGG -> ACTGGAGGGGT
GGTTAGGGACG -> GTTAGGGACGG
CAAGTTCCCAA -> AAGTTCCCAAG
ATGATACTGGT -> TGATACTGGTT
TAGGGCGTGGT -> AGGGCGTGGTA
GGATAAGCCGT -> GATAAGCCGTC
CACTTACGCTG -> ACTTACGCTGG
TTGGAGCCGGA -> TGGAGCCGGAT
TAAGATACAAT -> AAGATACAATT
GCGCGCTGATA -> CGCGCTGATAC
CGGATCACCCG -> GGATCACCCGG
AAGTCCAACCA -> AGTCCAACCAC
CTGGTGTGCGA -> TGGTGTGCGAA
AAGAGGAAGTA -> AGAGGAAGTAG
AGATGAGCAGA -> GATGAGCAGAC
GAGGGGTATGC -> AGGGGTATGCG
ATCCAGCTTTT -> TCCAGCTTTTA
GTGTCTGCGGG -> TGTCTGCGGGG
CTAGCGTGAGC -> TAGCGTGAGCT
ACGCGACTTAC -> CGCGACTTACC
CAAGGGTACGA -> AAGGGTACGAT
TGTCTAGGGCG -> GTCTAGGGCGT
GGTCGGACTTA -> GTCGGACTTAG
GTAGCAGCGGC -> TAGCAGCGGCA
TGCGCTAGCAT -> GCGCTAGCATT
GGCGGTTCAGA -> GCGGTTCAGAC
GTCCATGACGG -> TCCATGACGGA
AGAACTTATAA -> GAACTTATAAA
AGCCCAAGCTT -> GCCCAAGCTTT
CCATCCTCACC -> CATCCTCACCG
AGATCCCGCTC -> GATCCCGCTCA
CGTCTGATCGT -> GTCTGATCGTG
CTCATATCCAA -> TCATATCCAAT
ATGTTCCGTTG -> TGTTCCGTTGG
CCCTGCTCGCA -> CCTGCTCGCAC
GAGTCGACTGT -> AGTCGACTGTC
TGGTCGGACTT -> GGTCGGACTTA
AGTTTGGCCCG -> GTTTGGCCCGC
CCAATGCTCTA -> CAATGCTCTAC
TGAGATGAGCA -> GAGATGAGCAG
GACGACCAAGC -> ACGACCAAGCC
AAGCTTTCCTT -> AGCTTTCCTTC
TCTCCCCAGGT -> CTCCCCAGGTG
AGGAATTCCGC -> GGAATTCCGCA
AGCTGGATCCG -> GCTGGATCCGA
CGGGCCCCCCG -> GGGCCCCCCGT
TACGGTGACTA -> ACGGTGACTAA
CGCCACCAAGT -> GCCACCAAGTT
CTGAGTAGATC -> TGAGTAGATCC
AGGCGATTGTT -> GGCGATTGTTA
CTAGGAAGACC -> TAGGAAGACCA
AAGTGTTGTAG -> AGTGTTGTAGT
TGTCGGTAGGG -> GTCGGTAGGGA
GCGGGGACGGC -> CGGGGACGGCT
GCAGGTCGCTT -> CAGGTCGCTTC
TGTGTCTGCGG -> GTGTCTGCGGG
TAGAGACTTTT -> AGAGACTTTTG
TCGGCCGGGAA -> CGGCCGGGAAT
GGTGCGTCCAA -> GTGCGTCCAAA
TACTTTGAGGA -> ACTTTGAGGAC
GAATTACAGAT -> AATTACAGATA
AGCCCTATAAG -> GCCCTATAAGA
ACGGGCCGACA -> CGGGCCGACAC
CAACTTGAAAG -> AACTTGAAAGC
ACTTTTGCGCT -> CTTTTGCGCTA
ATGTTCCTCAG -> TGTTCCTCAGT
GCTGTCATTCA -> CTGTCATTCAC
GCTAAGATACA -> CTAAGATACAA
ATTAGTAGACA -> TTAGTAGACAA
CGCGACTTACC -> GCGACTTACCG
TTCTCCGCTTC -> TCTCCGCTTCC
ATAAAGTTCGG -> TAAAGTTCGGC
AGTCGACGTAT -> GTCGACGTATC
CTACTGACATA -> TACTGACATAT
CTGAAATCGTG -> TGAAATCGTGA
ACAATTGGGAA -> CAATTGGGAAT
TCACCGGACGC -> CACCGGACGCC
TACAGATGTCC -> ACAGATGTCCG
AACGGTTCGGC -> ACGGTTCGGCC
TGGTTGAGGTG -> GGTTGAGGTGA
ATATTCGCCCA -> TATTCGCCCAT
TGGTTAGGGAC -> GGTTAGGGACG
AGAGTTAGAAG -> GAGTTAGAAGG
ACTGTTTGTCT -> CTGTTTGTCTA
TCGATCGAATG -> CGATCGAATGA
GTCATTAGTAG -> TCATTAGTAGA
GACTAAGAGGA -> ACTAAGAGGAA
TGGCGCTAGCA -> GGCGCTAGCAT
AGGCTATCACC -> GGCTATCACCG
CTAGCATTCAA -> TAGCATTCAAT
TCTTAGGTGCG -> CTTAGGTGCGT
TGTCGTCCTCA -> GTCGTCCTCAC
AGCTAGCGGTT -> GCTAGCGGTTG
GGTGACTATGC -> GTGACTATGCC
CCTGCTGAGTA -> CTGCTGAGTAG
TTTCCTTCGCT -> TTCCTTCGCTG
AGAAGGCGATT -> GAAGGCGATTG
ATAACCCCTAT -> TAACCCCTATT
GCGCCTAGAAC -> CGCCTAGAACT
CGTCCTCACAA -> GTCCTCACAAG
CCCCCCGTCCC -> CCCCCGTCCCA
GACTGACAGGC -> ACTGACAGGCC
AACTTGAAAGC -> ACTTGAAAGCC
TATAAGATGGC -> ATAAGATGGCG
ATTACTGATCT -> TTACTGATCTT
AATTATCCGCG -> ATTATCCGCGT
CGACTGTCGTC -> GACTGTCGTCC
GGGGATAAGCC -> GGGATAAGCCG
AGTATATGGTC -> GTATATGGTCG
ACTCTCCGGGC -> CTCTCCGGGCT
CTGACCGCGAA -> TGACCGCGAAT
TATCTCATTGC -> ATCTCATTGCA
CGGTTCGGCCG -> GGTTCGGCCGG
AGTGCGGGTAG -> GTGCGGGTAGC
TAATGAACGTC -> AATGAACGTCC
GTTGTACCATC -> TTGTACCATCT
ACCCGGGAGTA -> CCCGGGAGTAG
TATTTGATTGA -> ATTTGATTGAA
TAGTGACCTCA -> AGTGACCTCAG
GGGTACGATTG -> GGTACGATTGA
GACGCCTCTGT -> ACGCCTCTGTG
CTGGCGCTAGC -> TGGCGCTAGCA
GATATAACTAT -> ATATAACTATC
AGAAAGCTTAT -> GAAAGCTTATA
AAGTTCCCAAG -> AGTTCCCAAGG
CCGTTGGGTAC -> CGTTGGGTACG
CTCTTAGAGCT -> TCTTAGAGCTA
GCGACTACATT -> CGACTACATTA
GCTAAGCTATA -> CTAAGCTATAG
TGGGGCTAGGT -> GGGGCTAGGTC
CAGTCCAACTT -> AGTCCAACTTG
TATATGGTCGG -> ATATGGTCGGA
TCCGAGAACTT -> CCGAGAACTTA
TGACGAGGGTA -> GACGAGGGTAG
GACATATACGG -> ACATATACGGG
TAACTTTGTCG -> AACTTTGTCGG
CCCCTTTTCTT -> CCCTTTTCTTC
GAAAGCCCTAT -> AAAGCCCTATA
ACGACCAAGCC -> CGACCAAGCCC
CGTTGGGTACG -> GTTGGGTACGC
AGACTGCGTCA -> GACTGCGTCAT
AAAGAAAGCGG -> AAGAAAGCGGA
CCCTGGCAATT -> CCTGGCAATTG
CTGTCGTCCTC -> TGTCGTCCTCA
TACCATCTCTA -> ACCATCTCTAG
GCTGCGCTTCG -> CTGCGCTTCGG
AGCGTGTGGGA -> GCGTGTGGGAC
CCATAAGCTGT -> CATAAGCTGTC
GTTCGGCCGGG -> TTCGGCCGGGA
GACAAACACTC -> ACAAACACTCA
TGTGGAATTAT -> GTGGAATTATC
GCGGTTGCGTG -> CGGTTGCGTGT
CGACTACATTA -> GACTACATTAC
GCTAGCGGTTG -> CTAGCGGTTGC
CTTCTCCGCTT -> TTCTCCGCTTC
GCCCCTTTAAG -> CCCCTTTAAGC
CCGAAAGAAAG -> CGAAAGAAAGC
GTGGTGGGGCT -> TGGTGGGGCTA
AGTTAAAGTTC -> GTTAAAGTTCA
TGGAGGCGGCT -> GGAGGCGGCTC
CCGGGAGTAGA -> CGGGAGTAGAA
TAGAAGGCGAT -> AGAAGGCGATT
ATGGCGGTTCA -> TGGCGGTTCAG
CTTTTCTTCGA -> TTTTCTTCGAT
AGGCGGCTCTT -> GGCGGCTCTTA
CTTCTTGGGGG -> TTCTTGGGGGA
GATCATCTGAC -> ATCATCTGACG
GAATATTGAGC -> AATATTGAGCC
CATATCCAATG -> ATATCCAATGC
GGTTGAGGTGA -> GTTGAGGTGAC
TCGGTTGCAAG -> CGGTTGCAAGG
TGTTACAGATG -> GTTACAGATGT
CGCCCCGACTG -> GCCCCGACTGT
GTTAACCCAGG -> TTAACCCAGGT
TGGAGCCGGAT -> GGAGCCGGATT
CCCCGACTGTT -> CCCGACTGTTT
GCGTCCAAATA -> CGTCCAAATAT
CTTCGGTTGCA -> TTCGGTTGCAA
GCACCCTTGAG -> CACCCTTGAGG
TATGCGAGTAT -> ATGCGAGTATA
AAGCATGTTGC -> AGCATGTTGCA
AGACCACAGTA -> GACCACAGTAG
TATGCCTGGTG -> ATGCCTGGTGT
GTAGAAAGCTT -> TAGAAAGCTTA
GGTGACTAAAG -> GTGACTAAAGT
GCGTGTGGGAC -> CGTGTGGGACT
GACGTCGAGCG -> ACGTCGAGCGC
TTAGGTGCGTC -> TAGGTGCGTCT
CTAGGGCGTGG -> TAGGGCGTGGT
GCATTAGTCGA -> CATTAGTCGAC
CGCGGTATGTC -> GCGGTATGTCT
CTTAGGTGCGT -> TTAGGTGCGTC
CAAGAAGCGTG -> AAGAAGCGTGA
GAGGGTATCTT -> AGGGTATCTTG
GCAGGTCTCTG -> CAGGTCTCTGA
TTGAGGATGGA -> TGAGGATGGAG
CGCGGTATGTT -> GCGGTATGTTA
GCTATCACCGA -> CTATCACCGAA
GATACGACAGA -> ATACGACAGAC
CCTATCTAGCG -> CTATCTAGCGT
AGGATGGAGGC -> GGATGGAGGCG
TGTGTGTTAAT -> GTGTGTTAATT
ATATCCAATGC -> TATCCAATGCT
CGAGGGTAGAG -> GAGGGTAGAGG
AGGTGAGATGA -> GGTGAGATGAA
CTATAAGATGG -> TATAAGATGGC
GGTCAAAATAG -> GTCAAAATAGA
GTTCAAGTGGA -> TTCAAGTGGAG
GGTATACCTGA -> GTATACCTGAG
TAGCTGGATCC -> AGCTGGATCCG
CCGTCCCACTT -> CGTCCCACTTC
GGGCCGACACG -> GGCCGACACGA
GTGGGACTGAA -> TGGGACTGAAC
TGAGATATAAC -> GAGATATAACT
CAACTGGTTGA -> AACTGGTTGAG
AAGAAAGCGGA -> AGAAAGCGGAC
GCAGACGGTTA -> CAGACGGTTAA
TCCAATGCTCT -> CCAATGCTCTA
AATGTTCCGTT -> ATGTTCCGTTG
AAGCTATAGGC -> AGCTATAGGCA
GTGGCAAGTCC -> TGGCAAGTCCA
GGATTCTAATA -> GATTCTAATAA
CGATTGTTAGC -> GATTGTTAGCC
CGGTGACTAAA -> GGTGACTAAAG
GGAGAGTAGAT -> GAGAGTAGATT
GGAACCATAAG -> GAACCATAAGC
ACTTATAAAGT -> CTTATAAAGTT
TCTAGGAAGAC -> CTAGGAAGACC
TCTCCGTGGCA -> CTCCGTGGCAA
TCTAGGAAGAG -> CTAGGAAGAGA
ATACAATTGGG -> TACAATTGGGA
GTATCAAGAAG -> TATCAAGAAGC
ATGGTTAGGGA -> TGGTTAGGGAC
GAAGGCAGGTC -> AAGGCAGGTCG
TTTTAGGCCCT -> TTTAGGCCCTG
TTAGGGACGGT -> TAGGGACGGTC
GTTACAGATGT -> TTACAGATGTC
ACCCTTCGGCA -> CCCTTCGGCAG
ATTCAATTTAA -> TTCAATTTAAG
GTGGAGGGTAT -> TGGAGGGTATC
TATGTCTGGCG -> ATGTCTGGCGC
TCGCACGGGCA -> CGCACGGGCAA
ACTACTGACAT -> CTACTGACATA
GCGAATTACAG -> CGAATTACAGA
TACAATTGGGA -> ACAATTGGGAA
CGCGACTACAT -> GCGACTACATT
AAAGCTTATAT -> AAGCTTATATG
GACAATAATGA -> ACAATAATGAA
GTGGAATTATC -> TGGAATTATCC
TTAAGTACATT -> TAAGTACATTC
AGCGGTTGCGT -> GCGGTTGCGTG
GGCGCTAGCAT -> GCGCTAGCATT
ACGCGGTATGT -> CGCGGTATGTC
AGGAACGGCCA -> GGAACGGCCAA
CGAATATTGAG -> GAATATTGAGC
ATTTAAGTACA -> TTTAAGTACAT
TGAGTAGATCC -> GAGTAGATCCC
GTTAGAAGGCG -> TTAGAAGGCGA
GATTCTAATAA -> ATTCTAATAAC
TCGCAAGTTAT -> CGCAAGTTATT
TTGCTAAGATA -> TGCTAAGATAC
CCGAGGAATTC -> CGAGGAATTCC
ACTGCGTCATT -> CTGCGTCATTA
ATTCGCCCATT -> TTCGCCCATTA
TGGATCCGATG -> GGATCCGATGG
GAACGCAGACG -> AACGCAGACGC
TCCCAAGGCTA -> CCCAAGGCTAT
ACAGGCCAGAA -> CAGGCCAGAAC
ATTGGGAATCG -> TTGGGAATCGC
GGGAGAGTAGA -> GGAGAGTAGAT
ACAGTAGAGTC -> CAGTAGAGTCG
GGCAGGTCTCT -> GCAGGTCTCTG
ACGCAGACGCG -> CGCAGACGCGG
TGATCTTTGTG -> GATCTTTGTGT
CTCAGGTAAGA -> TCAGGTAAGAC
AGGCCAGAACT -> GGCCAGAACTC
CTGAACGCGAA -> TGAACGCGAAT
TGGCGGTTCAG -> GGCGGTTCAGA
TACGACAGACG -> ACGACAGACGA
TATTCGCCCAT -> ATTCGCCCATT
AAAGTTCGGCC -> AAGTTCGGCCG
GCAGGTTAAGA -> CAGGTTAAGAG
TGGTGGGGCTA -> GGTGGGGCTAG
TGACATATCAG -> GACATATCAGA
GTTCAGACCCC -> TTCAGACCCCT
GTAGACAACTC -> TAGACAACTCC
ATGCGAGTATA -> TGCGAGTATAT
ATTTGTATTAC -> TTTGTATTACT
ACGTCATGATC -> CGTCATGATCA
GCTAGCATTCA -> CTAGCATTCAA
CCGAAGGCAGG -> CGAAGGCAGGT
CACTCAGGTAA -> ACTCAGGTAAG
TAGCATTAGTC -> AGCATTAGTCG
CTCTCTTGTGA -> TCTCTTGTGAC
GTACTTTGAGG -> TACTTTGAGGA
GAGCTCATATC -> AGCTCATATCC
ACTGGAGGGGT -> CTGGAGGGGTA
GGGTATCTTGG -> GGTATCTTGGC
AAGTTCGGCCG -> AGTTCGGCCGT
GGGACATATAC -> GGACATATACG
GACTATGCCTG -> ACTATGCCTGG
CATTCACTGAG -> ATTCACTGAGA
ACATTCTGTCT -> CATTCTGTCTA
CTTCCCTGAAT -> TTCCCTGAATT
CCGACTGTTTG -> CGACTGTTTGT
TGAGCTCATAT -> GAGCTCATATC
GAACGGCCAAC -> AACGGCCAACT
TTGTTAGCCCA -> TGTTAGCCCAG
AAGGTCGCAGC -> AGGTCGCAGCA
GACCTCAGTTA -> ACCTCAGTTAA
GAGTAGAAAGC -> AGTAGAAAGCT
GGACGGTCAAA -> GACGGTCAAAA
TTAAGCCGAAG -> TAAGCCGAAGG
GCCAACTGGTT -> CCAACTGGTTG
CGTGGTAGACT -> GTGGTAGACTG
GAGCCGGATTC -> AGCCGGATTCT
TGTTGCACCCT -> GTTGCACCCTT
TAAGTGCGGGT -> AAGTGCGGGTA
CAGGCCAGAAC -> AGGCCAGAACT
GTCTTTGCGTG -> TCTTTGCGTGC
CGACACGATAC -> GACACGATACG
TAGGGAGAGTA -> AGGGAGAGTAG
AGTTCATTGAC -> GTTCATTGACC
AGATTAAGATT -> GATTAAGATTT
CGTCATTAGTA -> GTCATTAGTAG
CTCTGTGTGTT -> TCTGTGTGTTA
CCAAGCCCGCA -> CAAGCCCGCAC
TGGTAGACTGC -> GGTAGACTGCG
CGGTTGCCTAT -> GGTTGCCTATC
CTTGAGGATGG -> TTGAGGATGGA
GGACAATAATG -> GACAATAATGA
GGGGACGGCTG -> GGGACGGCTGC
TCATACTAACC -> CATACTAACCC
GTATGTCTGGC -> TATGTCTGGCG
TGTCATTCACT -> GTCATTCACTG
GCGAATGTGTG -> CGAATGTGTGC
CATGATACTGG -> ATGATACTGGT
AGGGTATCTTG -> GGGTATCTTGG
ACATGGCGGTT -> CATGGCGGTTC
CCCTGGCGAAT -> CCTGGCGAATT
CACCGAAAGAA -> ACCGAAAGAAA
CGCAGCAAGTG -> GCAGCAAGTGT
GTCTAGGGCGT -> TCTAGGGCGTG
CCAAGCTTTCC -> CAAGCTTTCCT
AATTATCTCCC -> ATTATCTCCCC
CGAGCGCGCTG -> GAGCGCGCTGA
GATGGCGCGGT -> ATGGCGCGGTA
AGGTCTCTGAC -> GGTCTCTGACG
GGCCGACACGA -> GCCGACACGAT
TAGGTCCGGAA -> AGGTCCGGAAC
GCGGGTAGCCC -> CGGGTAGCCCA
CCTTCGCTGAC -> CTTCGCTGACC
GAGGGTAGAGG -> AGGGTAGAGGA
CCTTTTCTTCG -> CTTTTCTTCGA
TGAATTCACGG -> GAATTCACGGG
ACATTCTAATC -> CATTCTAATCA
CTATCTAGCGT -> TATCTAGCGTG
AGTAGATTAAG -> GTAGATTAAGA
TCTCTAGGAAG -> CTCTAGGAAGA
TTCACATGGCG -> TCACATGGCGG
AGAGGAAGTAG -> GAGGAAGTAGA
GGAAGACCATC -> GAAGACCATCC
TACCGGACTCT -> ACCGGACTCTC
CTCATTGCAGT -> TCATTGCAGTG
CGTTCACATGG -> GTTCACATGGC
CTAATAACTAC -> TAATAACTACT
TGTTAGCCCAG -> GTTAGCCCAGC
TATAACTATCT -> ATAACTATCTT
TGTCCGAGGCG -> GTCCGAGGCGG
GGACGGCTGCG -> GACGGCTGCGC
ACAATAATGAA -> CAATAATGAAC
CCGATGCAGGT -> CGATGCAGGTT
CACAATGTTCC -> ACAATGTTCCG
GTGACCTCAGT -> TGACCTCAGTT
CTGGAGGGGTA -> TGGAGGGGTAT
GAAACAGGATG -> AAACAGGATGG
GCCACCAAGTT -> CCACCAAGTTC
TCGGCAGGATT -> CGGCAGGATTC
GACGGTTAACC -> ACGGTTAACCC
AGCATGTTGCA -> GCATGTTGCAC
CTGACGAGGGT -> TGACGAGGGTA
CGACAAACACT -> GACAAACACTC
TTACCGGACTC -> TACCGGACTCT
GACCACAGTAG -> ACCACAGTAGA
AGTGGAGGGTA -> GTGGAGGGTAT
GACTACATTAC -> ACTACATTACA
ATACGGTGACT -> TACGGTGACTA
AAATATTCGCC -> AATATTCGCCC
TGAGCAGACGG -> GAGCAGACGGT
AGCTTATATGG -> GCTTATATGGT
GCAGTGGTGGG -> CAGTGGTGGGG
ACAACTATCTC -> CAACTATCTCA
TGTTTGTCTAG -> GTTTGTCTAGG
GGTGGGGCTAG -> GTGGGGCTAGG
CCAGGTGAGAT -> CAGGTGAGATG
GTATTACTGAT -> TATTACTGATC
AGTCCAACCAC -> GTCCAACCACA
TGCCTGGTGTG -> GCCTGGTGTGC
GGGCTTTTAGG -> GGCTTTTAGGC
ACCGAGGAATT -> CCGAGGAATTC
CACTGAGATGA -> ACTGAGATGAG
ACTGGTTGAGG -> CTGGTTGAGGT
CACAACTATCT -> ACAACTATCTC
TATGGTCGGAC -> ATGGTCGGACT
GCTTCGGTTGC -> CTTCGGTTGCA
ACTATCTCATT -> CTATCTCATTG
GGACGCCTCTG -> GACGCCTCTGT
GGCCCGCCACC -> GCCCGCCACCA
TGGTGTGCGAA -> GGTGTGCGAAA
CACTTCTTGGG -> ACTTCTTGGGG
GTCCGAGGCGG -> TCCGAGGCGGG
CTGGCGAATTA -> TGGCGAATTAC
TGTGTTAATTA -> GTGTTAATTAT
CTATGCCTGGT -> TATGCCTGGTG
GGGAATAGCTG -> GGAATAGCTGG
CGGACGCCTCT -> GGACGCCTCTG
CGTGGCAAGTC -> GTGGCAAGTCC
ATAAGATGGCG -> TAAGATGGCGC
CGGACGGTATA -> GGACGGTATAC
TTGGGTACGCG -> TGGGTACGCGA
TGAACGTCCAT -> GAACGTCCATG
CAGTGGTGGGG -> AGTGGTGGGGC
CGTCGGATTTG -> GTCGGATTTGT
TTCTTCGATCG -> TCTTCGATCGA
CCCACTTCTTG -> CCACTTCTTGG
CGCTAGCATTC -> GCTAGCATTCA
CGCTAGCATTA -> GCTAGCATTAG
CTTACGCTGGC -> TTACGCTGGCG
AGTAGACAACT -> GTAGACAACTC
AACTGAAATCG -> ACTGAAATCGT
TTTCCGCCCCG -> TTCCGCCCCGA
CTGGCAATTGC -> TGGCAATTGCT
GAATCGCCCCT -> AATCGCCCCTT
CTTTCATAACC -> TTTCATAACCC
GTTGGAGCCGG -> TTGGAGCCGGA
TAGACTGCGTC -> AGACTGCGTCA
ATACGGGTACC -> TACGGGTACCA
AGCGGACGGTA -> GCGGACGGTAT
CCCTGAATTCA -> CCTGAATTCAC
GTCCAAATATT -> TCCAAATATTC
CGGTTAACCCA -> GGTTAACCCAG
ACCCATGATAC -> CCCATGATACT
ATAGAGTTAGA -> TAGAGTTAGAA
GAGGAACGGCC -> AGGAACGGCCA
CAGCTAGCGGT -> AGCTAGCGGTT
TTGGCCCGCCA -> TGGCCCGCCAC
CGTGAGCTCAT -> GTGAGCTCATA
CGTGGGTATGT -> GTGGGTATGTT
CCAACTGGTTG -> CAACTGGTTGA
ATGTGTGCGTA -> TGTGTGCGTAA
GGCGATTGTTA -> GCGATTGTTAG
TGATACCTGCT -> GATACCTGCTG
TTGAGGTGACT -> TGAGGTGACTA
TAGAGCTACAT -> AGAGCTACATT
GCGACTTACCG -> CGACTTACCGG
GCGGACGGTAT -> CGGACGGTATA
GCAATTGCTAA -> CAATTGCTAAG
TGACCCTGCTC -> GACCCTGCTCG
GAACTTATAAA -> AACTTATAAAG
ACGTCGAGCGC -> CGTCGAGCGCG
GTCTAGGAAGA -> TCTAGGAAGAG
TGTCTAGGAAG -> GTCTAGGAAGA
CCGGACGCCTC -> CGGACGCCTCT
AGAAATTCGCA -> GAAATTCGCAA
CTTAGAGCTAC -> TTAGAGCTACA
AAGGTGCGTCC -> AGGTGCGTCCA
GAATGACGCTA -> AATGACGCTAG
GGGAATCGCCC -> GGAATCGCCCC
CAATGTTCCGT -> AATGTTCCGTT
CAAGTGGAGGG -> AAGTGGAGGGT
TGACGTCGAGC -> GACGTCGAGCG
CCGTTCAAGTG -> CGTTCAAGTGG
GACACGATACG -> ACACGATACGG
GCGAGTATATG -> CGAGTATATGG
ATGCTCTACAT -> TGCTCTACATC
AAGTGGAGGGT -> AGTGGAGGGTA
CAAAATAGAGT -> AAAATAGAGTT
AGGGAGAGTAG -> GGGAGAGTAGA
GGGCTAGGTCC -> GGCTAGGTCCG
CAATTGCTAAG -> AATTGCTAAGA
CACCAAGTTCC -> ACCAAGTTCCC
ATATGGTCGGA -> TATGGTCGGAC
TTTCATAACCC -> TTCATAACCCC
GACGGTATACC -> ACGGTATACCT
GTGTGGGACTG -> TGTGGGACTGA
GCAAGTTATTA -> CAAGTTATTAC
AGCCCAGCGTG -> GCCCAGCGTGT
GTGACGTCATG -> TGACGTCATGA
AGCCGGATTCT -> GCCGGATTCTA
ACATTACACCC -> CATTACACCCG
GAGTAGATCCC -> AGTAGATCCCG
CCAGCGTGTGG -> CAGCGTGTGGG
CTGGTTGAGGT -> TGGTTGAGGTG
GTCGTCCTCAC -> TCGTCCTCACA
CGCTTCGGTTG -> GCTTCGGTTGC
TATGGTTAGGG -> ATGGTTAGGGA
TAGCCCAGCGT -> AGCCCAGCGTG
GAACTGAAATC -> AACTGAAATCG
GGAAGCATGTT -> GAAGCATGTTG
ACAAACACTCA -> CAAACACTCAG
TCCTTCGCTGA -> CCTTCGCTGAC
CAAGAAATTCG -> AAGAAATTCGC
TTATCTCCCCA -> TATCTCCCCAG
AGCATTCAATT -> GCATTCAATTT
ACATATACGGG -> CATATACGGGT
ATTATCCGCGT -> TTATCCGCGTA
GTATGCGAGTA -> TATGCGAGTAT
ATCAGATTCGG -> TCAGATTCGGT
GTCGACAAACA -> TCGACAAACAC
TTTGAAACAGG -> TTGAAACAGGA
CCAAGTTCCCA -> CAAGTTCCCAA
AGAGAACGTAC -> GAGAACGTACT
CGCATTCGGAT -> GCATTCGGATC
TCTTCGATCGA -> CTTCGATCGAA
CGCACTGGAGG -> GCACTGGAGGG
GAGATGAGCAG -> AGATGAGCAGA
TCAAGTGGAGG -> CAAGTGGAGGG
TCAAGAAGCGT -> CAAGAAGCGTG
TACATTCTGTC -> ACATTCTGTCT
ATAAGCCGTCG -> TAAGCCGTCGG
CGGCGCGACTA -> GGCGCGACTAC
GCTATAGGCAG -> CTATAGGCAGG
TGACTGACAGG -> GACTGACAGGC
CTCCCGATGCA -> TCCCGATGCAG
CGCACGGGCAA -> GCACGGGCAAA
CCCCTATTTGA -> CCCTATTTGAT
ATGTCCGAGGC -> TGTCCGAGGCG
CAGATGTCCGA -> AGATGTCCGAG
GGCGCGACTAC -> GCGCGACTACA
CTGAATTCACG -> TGAATTCACGG
GAACTCCACTT -> AACTCCACTTA
GGTCCGAGAAC -> GTCCGAGAACT
CGGGAGTAGAA -> GGGAGTAGAAA
GTGTTGTAGTG -> TGTTGTAGTGA
GCGCGACTACA -> CGCGACTACAT
TAAGATGGCGC -> AAGATGGCGCG
TACCAAGGGTA -> ACCAAGGGTAC
CAAACGGTTCG -> AAACGGTTCGG
TACTGATCTTT -> ACTGATCTTTG
GTTGCGTGTGG -> TTGCGTGTGGA
AAGTTATTACC -> AGTTATTACCC
TCGGTTGCCTA -> CGGTTGCCTAT
GCAGACGCGGT -> CAGACGCGGTA
GAGAACTTATA -> AGAACTTATAA
GTTGAGGTGAC -> TTGAGGTGACT
AGGTGCGTCCA -> GGTGCGTCCAA
TAAGCTATAGG -> AAGCTATAGGC
AACTTTGTCGG -> ACTTTGTCGGT
CTGATCGTGGG -> TGATCGTGGGT
GTAGATCGAAC -> TAGATCGAACG
AAGGCGATTGT -> AGGCGATTGTT
TAGGAAGAGAG -> AGGAAGAGAGA
GCTAGGTCCGG -> CTAGGTCCGGA
GTCCAACTTGA -> TCCAACTTGAA
CGAAAGAAAGC -> GAAAGAAAGCG
CGACTGTTTGT -> GACTGTTTGTC
GGTATGTTACA -> GTATGTTACAG
AAGACCATCCT -> AGACCATCCTC
AACGTACTTTG -> ACGTACTTTGA
CATGATCATCT -> ATGATCATCTG
GCACTGGAGGG -> CACTGGAGGGG
ACGACAGACGA -> CGACAGACGAC
CGGCTCTTAGA -> GGCTCTTAGAG
GATGGGGTCGA -> ATGGGGTCGAC
ACTTTCATAAC -> CTTTCATAACC
ATGAACGTCCA -> TGAACGTCCAT
AGATAGGTCCG -> GATAGGTCCGA
TAAGCCCAAGC -> AAGCCCAAGCT
TTCGCCCATTA -> TCGCCCATTAT
TAACTATCTTT -> AACTATCTTTA
GGGACGGCTGC -> GGACGGCTGCG
TGGGACATATA -> GGGACATATAC
AGCTATAGGCA -> GCTATAGGCAG
GGAATTATCCG -> GAATTATCCGC
CTCCGCTTCCC -> TCCGCTTCCCT
GAGATGAATAA -> AGATGAATAAG
AACCACAATGT -> ACCACAATGTT
AGCTTTTAAGC -> GCTTTTAAGCC
CATGGCGGTTC -> ATGGCGGTTCA
TTCTTCTCCGT -> TCTTCTCCGTG
TTCACTGAGAT -> TCACTGAGATG
AAAGCGGACGG -> AAGCGGACGGT
AAGAGGGACTC -> AGAGGGACTCT
CTTCGGCAGGA -> TTCGGCAGGAT
GGTCGCTTCTC -> GTCGCTTCTCC
AACTATCTTTA -> ACTATCTTTAA
AATTCGCAAGT -> ATTCGCAAGTT
GACAACTCCCG -> ACAACTCCCGA
AATCGTGACTT -> ATCGTGACTTT
CTACCCATGAT -> TACCCATGATA
AGATGTCCGAG -> GATGTCCGAGG
GTATACCTGAG -> TATACCTGAGA
CCCCGGATACG -> CCCGGATACGA
ACGTCCATGAC -> CGTCCATGACG
TGCGGGTAGCC -> GCGGGTAGCCC
AGGAAGAGAGA -> GGAAGAGAGAA
CATATACGGGT -> ATATACGGGTA
GACTGTTTGTC -> ACTGTTTGTCT
GGTAGAGGAAG -> GTAGAGGAAGG
CAATTGGGAAT -> AATTGGGAATC
CAGACGGTTAA -> AGACGGTTAAC
CGACTTACCGG -> GACTTACCGGA
CAAGGCTATCA -> AAGGCTATCAC
GGCCAACTGGT -> GCCAACTGGTT
ACCTCAGTTAA -> CCTCAGTTAAA
TAGATCGAACG -> AGATCGAACGC
AGAGGGACTCT -> GAGGGACTCTC
GGGACTGAACG -> GGACTGAACGC
AGAAAGCGGAC -> GAAAGCGGACG
TGCAGTGGTGG -> GCAGTGGTGGG
TGATTTCCGCC -> GATTTCCGCCC
CGGTATACCTG -> GGTATACCTGA
TACCTGAGATA -> ACCTGAGATAT
TCTGCGGGGAC -> CTGCGGGGACG
TGACTTTCATA -> GACTTTCATAA
AAAGTTCATTG -> AAGTTCATTGA
GCCTATCTAGC -> CCTATCTAGCG
ATATGGTTAGG -> TATGGTTAGGG
GATACCTGCTG -> ATACCTGCTGA
TGGGAATCGCC -> GGGAATCGCCC
CCCGCACTGGA -> CCGCACTGGAG
TAGCATTCAAT -> AGCATTCAATT
GCCCAGTCCAA -> CCCAGTCCAAC
TTCAATTTAAG -> TCAATTTAAGT
CCACTTACGCT -> CACTTACGCTG
CGATTGAGGCA -> GATTGAGGCAG
CAGACCCCTTT -> AGACCCCTTTT
CGTATCAAGAA -> GTATCAAGAAG
ACCCTGGCGAA -> CCCTGGCGAAT
TCCGCGGTTCT -> CCGCGGTTCTT
TGTCTGCGGGG -> GTCTGCGGGGA
TCTAGCGTGAG -> CTAGCGTGAGC
CCCCCGTCCCA -> CCCCGTCCCAC
CCCTTCGGCAG -> CCTTCGGCAGG
CTCACCGGACG -> TCACCGGACGC
TCGCCCCTTTA -> CGCCCCTTTAA
CATCCAGCTTT -> ATCCAGCTTTT
GAATGTGTGCG -> AATGTGTGCGT
CCACTTCTTGG -> CACTTCTTGGG
CGTAGCAGCGG -> GTAGCAGCGGC
TCATATCCAAT -> CATATCCAATG
CGAATTGATTT -> GAATTGATTTC
AGCGTGACGTC -> GCGTGACGTCA
GAAGGTGCGTC -> AAGGTGCGTCC
GTGTGCGAAAT -> TGTGCGAAATA
ATGCCTGGTGT -> TGCCTGGTGTG
CTAGCGGTTGC -> TAGCGGTTGCG
TTTTAAGCCGA -> TTTAAGCCGAA
GGTATGCGAGT -> GTATGCGAGTA
TGGCCCGCCAC -> GGCCCGCCACC
CTAGGAAGCAT -> TAGGAAGCATG
GTGTGGAATTA -> TGTGGAATTAT
GGATCACCCGG -> GATCACCCGGG
GGATGGGGTCG -> GATGGGGTCGA
CCGGATTCTAC -> CGGATTCTACC
GCAAGTCCAAC -> CAAGTCCAACC
CAAGCCCGCAC -> AAGCCCGCACT
CCTCACAAGAA -> CTCACAAGAAA
ATGAATAAGTG -> TGAATAAGTGC
GGTCTTTGCGT -> GTCTTTGCGTG
AATAAGTGCGG -> ATAAGTGCGGG
GTGCGTAATCT -> TGCGTAATCTG
CTGAGATGAGC -> TGAGATGAGCA
TTACAGATGTC -> TACAGATGTCC
GATTCTACCCA -> ATTCTACCCAT
GAGCTACATTC -> AGCTACATTCT
TAGGAAGCATG -> AGGAAGCATGT
ATTGAGCCGGT -> TTGAGCCGGTT
ATCTGACGTCG -> TCTGACGTCGA
GGCAAACGGTT -> GCAAACGGTTC
CCCGGGAGTAG -> CCGGGAGTAGA
GTAGATTAAGA -> TAGATTAAGAT
AGGTCGCAGCA -> GGTCGCAGCAA
CACAAGAAATT -> ACAAGAAATTC
CTCTCCGGGCT -> TCTCCGGGCTT
ATCGAATGACG -> TCGAATGACGC
AATAGAGTTAG -> ATAGAGTTAGA
TGATTGAACCG -> GATTGAACCGA
CGAATGTGTGC -> GAATGTGTGCG
GGTTGCAAGGT -> GTTGCAAGGTC
CAGTAGAGTCG -> AGTAGAGTCGA
TAATTAGCGCG -> AATTAGCGCGA
GCTGATACCTG -> CTGATACCTGC
TTTTCTTCGAT -> TTTCTTCGATC
GCTCATATCCA -> CTCATATCCAA
CTTTTGCGCTA -> TTTTGCGCTAG
CCCGATGCAGG -> CCGATGCAGGT
TGTTGTAGTGA -> GTTGTAGTGAC
GCTCGCACGGG -> CTCGCACGGGC
GTTGCACCCTT -> TTGCACCCTTG
TTTGTCGGTAG -> TTGTCGGTAGG
AAGTTCATTGA -> AGTTCATTGAC
GGTTCAGACCC -> GTTCAGACCCC
CTGTGTGTTAA -> TGTGTGTTAAT
GGCCCTGGCAA -> GCCCTGGCAAT
TCGGCCGTTCA -> CGGCCGTTCAC
GTGACTATGCC -> TGACTATGCCT
GGACTAAGAGG -> GACTAAGAGGA
TTCGATCGAAT -> TCGATCGAATG
ACGGTTCGGCC -> CGGTTCGGCCG
ATCACCCGGGA -> TCACCCGGGAG
TGATCGTGGGT -> GATCGTGGGTA
TATTGAGCCGG -> ATTGAGCCGGT
ATTACAGATAG -> TTACAGATAGG
CCTGAATTCAC -> CTGAATTCACG
CCGGGCTTTTA -> CGGGCTTTTAG
ATGGGACATAT -> TGGGACATATA
TCACATGGCGG -> CACATGGCGGT
ACTTACCGGAC -> CTTACCGGACT
GGTCTCTGACG -> GTCTCTGACGA
TCAGTTGGAGC -> CAGTTGGAGCC
ATCTTAGGTGC -> TCTTAGGTGCG
CTTATAAAGTT -> TTATAAAGTTC
GAGTAGATTAA -> AGTAGATTAAG
ACTGACATATC -> CTGACATATCA
TCGTGACTTTC -> CGTGACTTTCA
CGGGTACCAAG -> GGGTACCAAGG
CCCAGGTGAGA -> CCAGGTGAGAT
CTGGTTTGAAA -> TGGTTTGAAAC
CGGTTCTTCTC -> GGTTCTTCTCC
TTAGCGCGAAT -> TAGCGCGAATT
GCAGGATTCTA -> CAGGATTCTAA
AGTGTTGTAGT -> GTGTTGTAGTG
CAGGTGAGATG -> AGGTGAGATGA
GTTTGTCTAGG -> TTTGTCTAGGG
ACTGAAATCGT -> CTGAAATCGTG
CATCCTCACCG -> ATCCTCACCGG
GTCAAAATAGA -> TCAAAATAGAG
TCTTTAAATAG -> CTTTAAATAGG
ATAACTACTGA -> TAACTACTGAC
GAGGCAGCTAG -> AGGCAGCTAGC
AATGCTCTACA -> ATGCTCTACAT
GGAAGTAGATC -> GAAGTAGATCG
ATATCAGATTC -> TATCAGATTCG
CAATTTAAGTA -> AATTTAAGTAC
TCACCGAAAGA -> CACCGAAAGAA
CTCCACTTACG -> TCCACTTACGC
GTCTGATCGTG -> TCTGATCGTGG
CCAGCTTTTAA -> CAGCTTTTAAG
GGAACGGCCAA -> GAACGGCCAAC
GAAGTAGATCG -> AAGTAGATCGA
CCGCTCACTCC -> CGCTCACTCCG
GTGCGTCCAAA -> TGCGTCCAAAT
GCCGTTCACAT -> CCGTTCACATG
GATCGAATGAC -> ATCGAATGACG
AGAACGTACTT -> GAACGTACTTT
TATCTCCCCAG -> ATCTCCCCAGG
AACGGCCAACT -> ACGGCCAACTG
GATGCAGGTTA -> ATGCAGGTTAA
GATACAATTGG -> ATACAATTGGG
TTTAGGCCCTG -> TTAGGCCCTGG
CTATCTCATTG -> TATCTCATTGC
GTGCGTCTGAT -> TGCGTCTGATC
TTGCGCTAGCA -> TGCGCTAGCAT
GGACTCTCCGG -> GACTCTCCGGG
GACTGTCGTCC -> ACTGTCGTCCT
ATGCAGGTTAA -> TGCAGGTTAAG
TGTGACTTTGA -> GTGACTTTGAC
AGCGTGAGCTC -> GCGTGAGCTCA
GATGGAGGCGG -> ATGGAGGCGGC
ATTCGCAAGTT -> TTCGCAAGTTA
TGTTCCGTTGG -> GTTCCGTTGGG
AATTAGCGCGA -> ATTAGCGCGAA
CCATGATACTG -> CATGATACTGG
TGACGCTAGGA -> GACGCTAGGAA
ACCCCTTTTCT -> CCCCTTTTCTT
AGGCAGGTCGC -> GGCAGGTCGCT
GCGGTATGTTA -> CGGTATGTTAC
GTAATTAGCGC -> TAATTAGCGCG
GAATTCCGCAT -> AATTCCGCATT
AGATCGAACGC -> GATCGAACGCA
ACAACTCCCGA -> CAACTCCCGAT
CGATCGAATGA -> GATCGAATGAC
GGGGTCGACAA -> GGGTCGACAAA
TTTGGCCCGCC -> TTGGCCCGCCA
TTGAGCCGGTT -> TGAGCCGGTTG
TTAAATAGGTA -> TAAATAGGTAA
CCCCGTCCCAC -> CCCGTCCCACT
AAATTCGCAAG -> AATTCGCAAGT
TATACGGGTAC -> ATACGGGTACC
GTATATGGTCG -> TATATGGTCGG
GAGCCGGTTGT -> AGCCGGTTGTA
GCCCGCCACCA -> CCCGCCACCAA
CGACCAAGCCC -> GACCAAGCCCG
TTTAAGTACAT -> TTAAGTACATT
AGTGGTGGGGC -> GTGGTGGGGCT
GCATTCAATTT -> CATTCAATTTA
AGTAGATCCCG -> GTAGATCCCGC
CGGACTTAGAG -> GGACTTAGAGA
GTCCCACTTCT -> TCCCACTTCTT
GGAGTAGAAAG -> GAGTAGAAAGC
GTGAGCTCATA -> TGAGCTCATAT
GCCCCCCGTCC -> CCCCCCGTCCC
AGTAGATCGAA -> GTAGATCGAAC
ATGGTCGGACT -> TGGTCGGACTT
GGCGCGGTATG -> GCGCGGTATGT
GCGAATATTGA -> CGAATATTGAG
GGCAGGATTCT -> GCAGGATTCTA
TAGAGTTAGAA -> AGAGTTAGAAG
AATATTGAGCC -> ATATTGAGCCG
ACGGTCAAAAT -> CGGTCAAAATA
GAGGATGGAGG -> AGGATGGAGGC
ACCTGCTGAGT -> CCTGCTGAGTA
TCCAACTTGAA -> CCAACTTGAAA
GAATAAGTGCG -> AATAAGTGCGG
ATAGCTGGATC -> TAGCTGGATCC
GTCGACGTATC -> TCGACGTATCA
CATTCTAATCA -> ATTCTAATCAA
TCGCCCATTAT -> CGCCCATTATC
ATTATCTCCCC -> TTATCTCCCCA
TGAGCCGGTTG -> GAGCCGGTTGT
TTCGGATCACC -> TCGGATCACCC
CAACCACAATG -> AACCACAATGT
TGAACGCGAAT -> GAACGCGAATG
GATTTCCGCCC -> ATTTCCGCCCC
GGTATGTTCCT -> GTATGTTCCTC
GGAGGGTATCT -> GAGGGTATCTT
CTTCTCCGTGG -> TTCTCCGTGGC
AAGCCGAAGGC -> AGCCGAAGGCA
GCTTCTCCGCT -> CTTCTCCGCTT
AGAGAGAACGT -> GAGAGAACGTA
ACGTATCAAGA -> CGTATCAAGAA
TTAGCCCAGCG -> TAGCCCAGCGT
AATTACAGATA -> ATTACAGATAG
CCTGGCGAATT -> CTGGCGAATTA
TTCCCAAGGCT -> TCCCAAGGCTA
CGCGTAGCAGC -> GCGTAGCAGCG
CCGGACTCTCC -> CGGACTCTCCG
TAGCGCGAATT -> AGCGCGAATTG
AACTCTCTTGT -> ACTCTCTTGTG
GCTTTTAAGCC -> CTTTTAAGCCG
GAATTCACGGG -> AATTCACGGGC
ATAAGTGCGGG -> TAAGTGCGGGT
CCCAGGTCTTT -> CCAGGTCTTTG
GATCCGATGGG -> ATCCGATGGGA
GGACATATACG -> GACATATACGG
ACCGGACGCCT -> CCGGACGCCTC
GTATCTTGGCG -> TATCTTGGCGC
GTAGGGAGAGT -> TAGGGAGAGTA
TGACTAAAGTT -> GACTAAAGTTT
TTGGGAATCGC -> TGGGAATCGCC
AAGCGGACGGT -> AGCGGACGGTA
CTCTGACGAGG -> TCTGACGAGGG
GGCTATCACCG -> GCTATCACCGA
TTCACGGGCCG -> TCACGGGCCGA
TCACCCGGGAG -> CACCCGGGAGT
ACCTGAGATAT -> CCTGAGATATA
CATTCGGATCA -> ATTCGGATCAC
GAGACTTTTGC -> AGACTTTTGCG
ACTTCTTGGGG -> CTTCTTGGGGG
TTCGGCCGTTC -> TCGGCCGTTCA
AGCGGCACAAC -> GCGGCACAACT
TATACCTGAGA -> ATACCTGAGAT
AAAATAGAGTT -> AAATAGAGTTA
TTGTCGGTAGG -> TGTCGGTAGGG
GCTTATATGGT -> CTTATATGGTT
AGAAGCGTGAC -> GAAGCGTGACG
CCACAGTAGAG -> CACAGTAGAGT
TACTGGTTTGA -> ACTGGTTTGAA
ACTTTGACTGA -> CTTTGACTGAC
GGTTAAGAGGG -> GTTAAGAGGGA
GTTCATTGACC -> TTCATTGACCC
CTGCGCTTCGG -> TGCGCTTCGGT
ACTGTCGTCCT -> CTGTCGTCCTC
CTTTGTGTCTG -> TTTGTGTCTGC
ATAGGCAGGTC -> TAGGCAGGTCT
TAAGATTTCTG -> AAGATTTCTGC
ATTCACTGAGA -> TTCACTGAGAT
GATTGAGGCAG -> ATTGAGGCAGC
TCCGGAACCAT -> CCGGAACCATA
AGACCCCTTTT -> GACCCCTTTTC
AGGGACTCTCA -> GGGACTCTCAT
CCTAGAACTGA -> CTAGAACTGAA
GGCAGGTCGCT -> GCAGGTCGCTT
GTGGTAGACTG -> TGGTAGACTGC
TCTTTGCGTGC -> CTTTGCGTGCT
GTCCTCACAAG -> TCCTCACAAGA
ATTTGATTGAA -> TTTGATTGAAC
ATGACGCTAGG -> TGACGCTAGGA
AACTCCACTTA -> ACTCCACTTAC
CAGGTCGCTTC -> AGGTCGCTTCT
ACCACAGTAGA -> CCACAGTAGAG
GTCGCTTCTCC -> TCGCTTCTCCG
ACCATCTCTAG -> CCATCTCTAGG
AACACTCAGGT -> ACACTCAGGTA
CAATGCTCTAC -> AATGCTCTACA
TATCCGCGTAG -> ATCCGCGTAGC
CTTTTAAGCCG -> TTTTAAGCCGA
AAGTTTGGCCC -> AGTTTGGCCCG
CTAGCATTAGT -> TAGCATTAGTC
TCACTGAGATG -> CACTGAGATGA
CTCACTCCGCG -> TCACTCCGCGG
GGACTTAGAGA -> GACTTAGAGAC
GGAGGCGGCTC -> GAGGCGGCTCT
TTCATTGACCC -> TCATTGACCCT
CGTCATGATCA -> GTCATGATCAT
CGGCCGTTCAC -> GGCCGTTCACA
CAGGTCTCTGA -> AGGTCTCTGAC
CCATTATCTTA -> CATTATCTTAG
AGACGACCAAG -> GACGACCAAGC
CCCCTTTAAGC -> CCCTTTAAGCC
TGTTAATTATC -> GTTAATTATCT
GAAGCGTGACG -> AAGCGTGACGT
TTACCCTGGCG -> TACCCTGGCGA
ACGGACTAAGA -> CGGACTAAGAG
GACTTTTGCGC -> ACTTTTGCGCT
GACAGGCCAGA -> ACAGGCCAGAA
ATCTAGCGTGA -> TCTAGCGTGAG
CGTCCAAATAT -> GTCCAAATATT
CCTGCTCGCAC -> CTGCTCGCACG
GATGAGCAGAC -> ATGAGCAGACG
CGTGTGGAATT -> GTGTGGAATTA
ACATATCAGAT -> CATATCAGATT
AGAGTCGACTG -> GAGTCGACTGT
GTAATCTGAGG -> TAATCTGAGGA
AACAGGATGGG -> ACAGGATGGGG
GCTTCCCTGAA -> CTTCCCTGAAT
TTCCGCCCCGA -> TCCGCCCCGAC
TGCTCTACATC -> GCTCTACATCC
GGCACAACTAT -> GCACAACTATC
AAAGTTTGGCC -> AAGTTTGGCCC
GCGTGCTAAGC -> CGTGCTAAGCT
ATCTCATTGCA -> TCTCATTGCAG
TTATAAAGTTC -> TATAAAGTTCG
ACTGGTTTGAA -> CTGGTTTGAAA
GCAAACGGTTC -> CAAACGGTTCG
CCACAATGTTC -> CACAATGTTCC
TTCATAACCCC -> TCATAACCCCT
AAGCTTATATG -> AGCTTATATGG
TGCTAAGATAC -> GCTAAGATACA
CGGTTGCGTGT -> GGTTGCGTGTG
AATATTCGCCC -> ATATTCGCCCA
TACGCGACTTA -> ACGCGACTTAC
TCTTGTGACTT -> CTTGTGACTTT
TCGCAGCAAGT -> CGCAGCAAGTG
AGCTTTCCTTC -> GCTTTCCTTCG
ACTCCCGATGC -> CTCCCGATGCA
TCCACTTACGC -> CCACTTACGCT
CAGACGACCAA -> AGACGACCAAG
TTCCGTTGGGT -> TCCGTTGGGTA
GGTACGCGACT -> GTACGCGACTT
AAGTACATTCT -> AGTACATTCTG
CCTTCGGCAGG -> CTTCGGCAGGA
GAGATATAACT -> AGATATAACTA
ACCGCGAATAT -> CCGCGAATATT
ACACTCAGGTA -> CACTCAGGTAA
AGGAAGGTGCG -> GGAAGGTGCGT
TATCCAATGCT -> ATCCAATGCTC
TTAGAGCTACA -> TAGAGCTACAT
GATAAGCCGTC -> ATAAGCCGTCG
TGCGGGGACGG -> GCGGGGACGGC
CATGTTGCACC -> ATGTTGCACCC
AGCTACATTCT -> GCTACATTCTA
TAGATCCCGCT -> AGATCCCGCTC
TCCCTGAATTC -> CCCTGAATTCA
AAGCTGTCATT -> AGCTGTCATTC
AGAACTCCACT -> GAACTCCACTT
TATCTTTAAAT -> ATCTTTAAATA
GGGTAGCCCAG -> GGTAGCCCAGT
AATAGCTGGAT -> ATAGCTGGATC
TGCTCGCACGG -> GCTCGCACGGG
TTCTGTCTAGG -> TCTGTCTAGGA
ACCCTGCTCGC -> CCCTGCTCGCA
TTACGCTGGCG -> TACGCTGGCGC
CGACGTATCAA -> GACGTATCAAG
TCTACCCATGA -> CTACCCATGAT
CTCAGTTGGAG -> TCAGTTGGAGC
GGCCGGGAATA -> GCCGGGAATAG
GGTACCAAGGG -> GTACCAAGGGT
AATGTGTGCGT -> ATGTGTGCGTA
ACAAGAAATTC -> CAAGAAATTCG
AACGTCCATGA -> ACGTCCATGAC
GCCTGGTGTGC -> CCTGGTGTGCG
TCTAGGGCGTG -> CTAGGGCGTGG
CTCTCATACTA -> TCTCATACTAA
TGAAATCGTGA -> GAAATCGTGAC
GTTCTTCTCCG -> TTCTTCTCCGT
CTGGATCCGAT -> TGGATCCGATG
GCATTCGGATC -> CATTCGGATCA
GCGCTGATACC -> CGCTGATACCT
GTCCGGAACCA -> TCCGGAACCAT
ATCCTCACCGG -> TCCTCACCGGA
GTTCACATGGC -> TTCACATGGCG
CCGATGGGACA -> CGATGGGACAT
CTCCGTGGCAA -> TCCGTGGCAAG
TCGTGGGTATG -> CGTGGGTATGT
ACCGAAAGAAA -> CCGAAAGAAAG
TCCGATGGGAC -> CCGATGGGACA
TGCGTCCAAAT -> GCGTCCAAATA
ACTCAGGTAAG -> CTCAGGTAAGA
TTAAAGTTCAT -> TAAAGTTCATT
TCCTCACAAGA -> CCTCACAAGAA
AGCAGCGGCAC -> GCAGCGGCACA
GAAAGAAAGCG -> AAAGAAAGCGG
AGAGGAAGGTG -> GAGGAAGGTGC
ATTGCTAAGAT -> TTGCTAAGATA
GCGGCTCTTAG -> CGGCTCTTAGA
GGTCGCAGCAA -> GTCGCAGCAAG
CGCCCATTATC -> GCCCATTATCT
AACCCCGGATA -> ACCCCGGATAC
AATCAACTCTC -> ATCAACTCTCT
GCCGGATTCTA -> CCGGATTCTAC
GACAGACGACC -> ACAGACGACCA
CCTGAGATATA -> CTGAGATATAA
TTGTAGTGACC -> TGTAGTGACCT
AGGTCGCTTCT -> GGTCGCTTCTC
TACCTGCTGAG -> ACCTGCTGAGT
CCCGACTGTTT -> CCGACTGTTTG
TGTACCATCTC -> GTACCATCTCT
GGTCGACAAAC -> GTCGACAAACA
AGCCGAAGGCA -> GCCGAAGGCAG
ACAGACGACCA -> CAGACGACCAA
GCTTTCCTTCG -> CTTTCCTTCGC
AATAACTACTG -> ATAACTACTGA
CTCCGCGGTTC -> TCCGCGGTTCT
CGGTCAAAATA -> GGTCAAAATAG
TGCGTCTGATC -> GCGTCTGATCG
TACCCATGATA -> ACCCATGATAC
TTGACTGACAG -> TGACTGACAGG
GTTGGGTACGC -> TTGGGTACGCG
TATGTTCCTCA -> ATGTTCCTCAG
TGAGGAACGGC -> GAGGAACGGCC
GCTCTTAGAGC -> CTCTTAGAGCT
AAGAAATTCGC -> AGAAATTCGCA
ATCGAACGCAG -> TCGAACGCAGA
AAGATGGCGCG -> AGATGGCGCGG
TTGAGGCAGCT -> TGAGGCAGCTA
ATCCAATGCTC -> TCCAATGCTCT
GAACGTACTTT -> AACGTACTTTG
CCCAAGCTTTC -> CCAAGCTTTCC
GATCTTTGTGT -> ATCTTTGTGTC
TTGAACCGAGG -> TGAACCGAGGA
GGCGCCTAGAA -> GCGCCTAGAAC
CTTAGAGACTT -> TTAGAGACTTT
GGGACGGTCAA -> GGACGGTCAAA
ATTAAGATTTC -> TTAAGATTTCT
TCCATGACGGA -> CCATGACGGAC
CGGCAGGATTC -> GGCAGGATTCT
TCGAATGACGC -> CGAATGACGCT
CGCCTAGAACT -> GCCTAGAACTG
TCGAACGCAGA -> CGAACGCAGAC
CACGGGCAAAC -> ACGGGCAAACG
GAGGAATTCCG -> AGGAATTCCGC
AATTGCTAAGA -> ATTGCTAAGAT
AAGATACAATT -> AGATACAATTG
TCTGACGAGGG -> CTGACGAGGGT
GTAAGACCACA -> TAAGACCACAG
AGGAAGCATGT -> GGAAGCATGTT
AGTCGACTGTC -> GTCGACTGTCG
TGACGGACTAA -> GACGGACTAAG
TCTCATACTAA -> CTCATACTAAC
CCTCACCGGAC -> CTCACCGGACG
TTTGATTGAAC -> TTGATTGAACC
AGCATTAGTCG -> GCATTAGTCGA
CTTTAAATAGG -> TTTAAATAGGT
GATGTCCGAGG -> ATGTCCGAGGC
AACCGAGGAAT -> ACCGAGGAATT
CTTACCGGACT -> TTACCGGACTC
AGGGTAGAGGA -> GGGTAGAGGAA
GAAAGCGGACG -> AAAGCGGACGG
CCTTTAAGCCC -> CTTTAAGCCCA
TTCCTTCGCTG -> TCCTTCGCTGA
GGGGGATAAGC -> GGGGATAAGCC
GTCCGAGAACT -> TCCGAGAACTT
AGATACAATTG -> GATACAATTGG
GAATAGCTGGA -> AATAGCTGGAT
CACGATACGGT -> ACGATACGGTG
ACGGGTACCAA -> CGGGTACCAAG
TTAATTATCTC -> TAATTATCTCC
TTGCCTATCTA -> TGCCTATCTAG
GCGGGCCCCCC -> CGGGCCCCCCG
AGATGGCGCGG -> GATGGCGCGGT
AAGTGCGGGTA -> AGTGCGGGTAG
CCACCAAGTTC -> CACCAAGTTCC
GAGCAGACGGT -> AGCAGACGGTT
CGCCCCTTTAA -> GCCCCTTTAAG
CCGACACGATA -> CGACACGATAC
CGAGGAATTCC -> GAGGAATTCCG
TAGAACTGAAA -> AGAACTGAAAT
ACAGATGTCCG -> CAGATGTCCGA
AGGCCCTGGCA -> GGCCCTGGCAA
ACTTGAAAGCC -> CTTGAAAGCCC
TGCAAGGTCGC -> GCAAGGTCGCA
GGAAGGTGCGT -> GAAGGTGCGTC
GGACGGTATAC -> GACGGTATACC
CCCTTTTCTTC -> CCTTTTCTTCG
AAATAACTTTG -> AATAACTTTGT
GGCAATTGCTA -> GCAATTGCTAA
GCGTGACGTCA -> CGTGACGTCAT
CCCGTTCAAGT -> CCGTTCAAGTG
GATCACCCGGG -> ATCACCCGGGA
AGATGAATAAG -> GATGAATAAGT
CGAGAACTTAT -> GAGAACTTATA
AGCCGTCGGAT -> GCCGTCGGATT
TAACCCCGGAT -> AACCCCGGATA
CGCTTCTCCGC -> GCTTCTCCGCT
TAGGGACGGTC -> AGGGACGGTCA
TGCGTGTGGAA -> GCGTGTGGAAT
CTAGGTCCGGA -> TAGGTCCGGAA
GTCTCTGACGA -> TCTCTGACGAG
ACGCGAATGTG -> CGCGAATGTGT
TATCTTGGCGC -> ATCTTGGCGCC
CCTCTGTGTGT -> CTCTGTGTGTT
ATCGTGGGTAT -> TCGTGGGTATG
GGGTACCAAGG -> GGTACCAAGGG
AGTGACCTCAG -> GTGACCTCAGT
TAGGTAATTAG -> AGGTAATTAGC
GTGGGTATGTT -> TGGGTATGTTC
GGGTAGAGGAA -> GGTAGAGGAAG
CTGTTTGTCTA -> TGTTTGTCTAG
ACACGATACGG -> CACGATACGGT
TCAGGTAAGAC -> CAGGTAAGACC
CGCTGACCGCG -> GCTGACCGCGA
TTAAGCCCAAG -> TAAGCCCAAGC
GCGTGTGGAAT -> CGTGTGGAATT
TGAGGCAGCTA -> GAGGCAGCTAG
GCTTTTAGGCC -> CTTTTAGGCCC
TCTAATCAACT -> CTAATCAACTC
ACGAGGGTAGA -> CGAGGGTAGAG
ATTGAGGCAGC -> TTGAGGCAGCT
AACTATCTCAT -> ACTATCTCATT
ATTAGTCGACG -> TTAGTCGACGT
AGAACTGAAAT -> GAACTGAAATC
AGAGACTTTTG -> GAGACTTTTGC
GGACTCTCATA -> GACTCTCATAC
GGTAAGACCAC -> GTAAGACCACA
ATGTTGCACCC -> TGTTGCACCCT
CATTACACCCG -> ATTACACCCGT
TGAACCGAGGA -> GAACCGAGGAA
TCCGCATTCGG -> CCGCATTCGGA
GTCCAACCACA -> TCCAACCACAA
GACGAGGGTAG -> ACGAGGGTAGA
ACGGGCAAACG -> CGGGCAAACGG
CCGTGGCAAGT -> CGTGGCAAGTC
ACGATTGAGGC -> CGATTGAGGCA
GCGTAGCAGCG -> CGTAGCAGCGG
ACTACATTACA -> CTACATTACAC
GACATATCAGA -> ACATATCAGAT
CTTCGATCGAA -> TTCGATCGAAT
ATCGCCCCTTT -> TCGCCCCTTTA
TCCGTGGCAAG -> CCGTGGCAAGT
TATCACCGAAA -> ATCACCGAAAG
GACTGCGTCAT -> ACTGCGTCATT
AGACCATCCTC -> GACCATCCTCA
TTCTAATAACT -> TCTAATAACTA
TCCAAATATTC -> CCAAATATTCG
GCGTCATTAGT -> CGTCATTAGTA
ATTGAACCGAG -> TTGAACCGAGG
AAATCGTGACT -> AATCGTGACTT
ATATTGAGCCG -> TATTGAGCCGG
AACTCCCGATG -> ACTCCCGATGC
ACAATGTTCCG -> CAATGTTCCGT
GTTAATTATCT -> TTAATTATCTC
GCCCTATAAGA -> CCCTATAAGAT
ACATCCAGCTT -> CATCCAGCTTT
GTTAAGAGGGA -> TTAAGAGGGAC
CATACTAACCC -> ATACTAACCCC
AGCCCGCACTG -> GCCCGCACTGG
AGGCAGGTCTC -> GGCAGGTCTCT
TGAGGTGACTA -> GAGGTGACTAT
CTCTAGGAAGA -> TCTAGGAAGAC
ATTAGCGCGAA -> TTAGCGCGAAT
GAGGAAGGTGC -> AGGAAGGTGCG
TTGTCTAGGGC -> TGTCTAGGGCG
CCCTATTTGAT -> CCTATTTGATT
CTGACATATCA -> TGACATATCAG
TAATCAACTCT -> AATCAACTCTC
TCTGATCGTGG -> CTGATCGTGGG
CGCAAGTTATT -> GCAAGTTATTA
GACGGTCAAAA -> ACGGTCAAAAT
CTTTAAGCCCA -> TTTAAGCCCAA
TAGACAACTCC -> AGACAACTCCC
TTGCACCCTTG -> TGCACCCTTGA
GACGTATCAAG -> ACGTATCAAGA
CCCAGTCCAAC -> CCAGTCCAACT
AAATAGAGTTA -> AATAGAGTTAG
AGCTCATATCC -> GCTCATATCCA
TCGTCCTCACA -> CGTCCTCACAA
TACGATTGAGG -> ACGATTGAGGC
GTACCAAGGGT -> TACCAAGGGTA
GGGTCGACAAA -> GGTCGACAAAC
TGAGGATGGAG -> GAGGATGGAGG
TATCTAGCGTG -> ATCTAGCGTGA
CCCGCTCACTC -> CCGCTCACTCC
TATCTTAGGTG -> ATCTTAGGTGC
TCCGCGTAGCA -> CCGCGTAGCAG
CAAGTGTTGTA -> AAGTGTTGTAG
TTGTACCATCT -> TGTACCATCTC
TACGCTGGCGC -> ACGCTGGCGCT
TCATCTGACGT -> CATCTGACGTC
CCTGGCAATTG -> CTGGCAATTGC
TTATTACCCTG -> TATTACCCTGG
TTACAGATAGG -> TACAGATAGGT
TTTGTGTCTGC -> TTGTGTCTGCG
TCACTCCGCGG -> CACTCCGCGGT
TTCTAATCAAC -> TCTAATCAACT
GCGTCTGATCG -> CGTCTGATCGT
ACTGAACGCGA -> CTGAACGCGAA
TACTAACCCCG -> ACTAACCCCGG
ATCTTGGCGCC -> TCTTGGCGCCT
TCCGCTTCCCT -> CCGCTTCCCTG
GGTAATTAGCG -> GTAATTAGCGC
ATTCTAATAAC -> TTCTAATAACT
GCTAGCATTAG -> CTAGCATTAGT
TACATTACACC -> ACATTACACCC
CGTACTTTGAG -> GTACTTTGAGG
TCTTTGTGTCT -> CTTTGTGTCTG
GTACCATCTCT -> TACCATCTCTA
AGGGTACGATT -> GGGTACGATTG
GATTGTTAGCC -> ATTGTTAGCCC
CACCCTTGAGG -> ACCCTTGAGGA
ACCAAGGGTAC -> CCAAGGGTACG
GCGTGGTAGAC -> CGTGGTAGACT
CAAGGTCGCAG -> AAGGTCGCAGC
TTTAAGCCCAA -> TTAAGCCCAAG
GTTATTACCCT -> TTATTACCCTG
CTGATACCTGC -> TGATACCTGCT
ATGTCTGGCGC -> TGTCTGGCGCG
GATGAATAAGT -> ATGAATAAGTG
TCGGACTTAGA -> CGGACTTAGAG
CGTGTGGGACT -> GTGTGGGACTG
AACCCCTATTT -> ACCCCTATTTG
GGTATCTTGGC -> GTATCTTGGCG
TGGCGCGGTAT -> GGCGCGGTATG
GTCGGACTTAG -> TCGGACTTAGA
AGGAAGACCAT -> GGAAGACCATC
ATGATCATCTG -> TGATCATCTGA
ATGGGGTCGAC -> TGGGGTCGACA
GTATGTTACAG -> TATGTTACAGA
ACTTACGCTGG -> CTTACGCTGGC
GCAAGTGTTGT -> CAAGTGTTGTA
AGGTCCGGAAC -> GGTCCGGAACC
TAATCTGAGGA -> AATCTGAGGAA
GTGCGAAATAA -> TGCGAAATAAC
GCGCGAATTGA -> CGCGAATTGAT
AGGACAATAAT -> GGACAATAATG
CAACTATCTCA -> AACTATCTCAT
AATCTGAGGAA -> ATCTGAGGAAC
GCCGGTTGTAC -> CCGGTTGTACC
CGACAGACGAC -> GACAGACGACC
GTCGGTAGGGA -> TCGGTAGGGAG
CGCTCACTCCG -> GCTCACTCCGC
AGGTGCGTCTG -> GGTGCGTCTGA
GGAATTCCGCA -> GAATTCCGCAT
TTAGAAGGCGA -> TAGAAGGCGAT
TTCAAGTGGAG -> TCAAGTGGAGG
AAGAAGCGTGA -> AGAAGCGTGAC
ATACCTGAGAT -> TACCTGAGATA
TAAATAGGTAA -> AAATAGGTAAT
GTAGCCCAGTC -> TAGCCCAGTCC
TACATTCTAAT -> ACATTCTAATC
CGGGCCGACAC -> GGGCCGACACG
TAGCGTGAGCT -> AGCGTGAGCTC
GATTAAGATTT -> ATTAAGATTTC
GGTTGCGTGTG -> GTTGCGTGTGG
TGTATTACTGA -> GTATTACTGAT
TCATTGCAGTG -> CATTGCAGTGG
ATTCTACCCAT -> TTCTACCCATG
GGTTCTTCTCC -> GTTCTTCTCCG
CTTTTAGGCCC -> TTTTAGGCCCT
ACTAAGAGGAA -> CTAAGAGGAAG
GAAATTCGCAA -> AAATTCGCAAG
GGAATCGCCCC -> GAATCGCCCCT
TCTGTCTAGGA -> CTGTCTAGGAA
GTGCGGGTAGC -> TGCGGGTAGCC
ACTATGCCTGG -> CTATGCCTGGT
GACTAAAGTTT -> ACTAAAGTTTG
CCGAGGCGGGC -> CGAGGCGGGCC
TTACTGATCTT -> TACTGATCTTT
GCTCACTCCGC -> CTCACTCCGCG
CTCCGGGCTTT -> TCCGGGCTTTT
TCCAACCACAA -> CCAACCACAAT
GTAGATCCCGC -> TAGATCCCGCT
GAGGGACTCTC -> AGGGACTCTCA
CGGATTCTACC -> GGATTCTACCC
TAGATTAAGAT -> AGATTAAGATT
CTATCTTTAAA -> TATCTTTAAAT
GTTGTAGTGAC -> TTGTAGTGACC
CGTTCAAGTGG -> GTTCAAGTGGA
TGGTTTGAAAC -> GGTTTGAAACA
TGGGTATGTTC -> GGGTATGTTCC
ACTCTCATACT -> CTCTCATACTA
CTAAGATACAA -> TAAGATACAAT
TAGCGGTTGCG -> AGCGGTTGCGT
ACTATCTTTAA -> CTATCTTTAAA
TTGAGGACAAT -> TGAGGACAATA
TGTGCGAAATA -> GTGCGAAATAA
AGGGACGGTCA -> GGGACGGTCAA
CCGCCACCAAG -> CGCCACCAAGT
GGGGTATGCGA -> GGGTATGCGAG
TGGGTACGCGA -> GGGTACGCGAC
TCTCTTGTGAC -> CTCTTGTGACT
CCCGGATACGA -> CCGGATACGAC
TCAGATTCGGT -> CAGATTCGGTT
TGAGATGAATA -> GAGATGAATAA
TATTACCCTGG -> ATTACCCTGGC
GGAGCCGGATT -> GAGCCGGATTC
TGAAAGCCCTA -> GAAAGCCCTAT
GGGGCTAGGTC -> GGGCTAGGTCC
TGAGGACAATA -> GAGGACAATAA
CTATCACCGAA -> TATCACCGAAA
GACGGACTAAG -> ACGGACTAAGA
GACTGAACGCG -> ACTGAACGCGA
GCGCGGTATGT -> CGCGGTATGTT
GCACAACTATC -> CACAACTATCT
TGCGTGCTAAG -> GCGTGCTAAGC
AAATAGGTAAT -> AATAGGTAATT
GGCGGGCCCCC -> GCGGGCCCCCC
CTTTGCGTGCT -> TTTGCGTGCTA
GAGAACGTACT -> AGAACGTACTT
GATACGGTGAC -> ATACGGTGACT
ATAAGCTGTCA -> TAAGCTGTCAT
TCGCTTCTCCG -> CGCTTCTCCGC
GCGGTTCAGAC -> CGGTTCAGACC
CTAATCAACTC -> TAATCAACTCT
ACTCTCTTGTG -> CTCTCTTGTGA
TCCTCAGTTGG -> CCTCAGTTGGA
ATTTCCGCCCC -> TTTCCGCCCCG
GCAGCTAGCGG -> CAGCTAGCGGT
TATAGGCAGGT -> ATAGGCAGGTC
ATCTCTAGGAA -> TCTCTAGGAAG
CCCGCCACCAA -> CCGCCACCAAG
AGAGTAGATTA -> GAGTAGATTAA
TTTTGCGCTAG -> TTTGCGCTAGC
GGATCCGATGG -> GATCCGATGGG
GGATACGACAG -> GATACGACAGA
ATTGATTTCCG -> TTGATTTCCGC
GGTAGCCCAGT -> GTAGCCCAGTC
TGACTTTGACT -> GACTTTGACTG
CATTATCTTAG -> ATTATCTTAGG
CCCATTATCTT -> CCATTATCTTA
GAGAGAACGTA -> AGAGAACGTAC
ACAGATAGGTC -> CAGATAGGTCC
TATGTTACAGA -> ATGTTACAGAT
AATTGATTTCC -> ATTGATTTCCG
GTTCCCAAGGC -> TTCCCAAGGCT
GGGCAAACGGT -> GGCAAACGGTT
ATACGACAGAC -> TACGACAGACG
TCATGATCATC -> CATGATCATCT
TGATCATCTGA -> GATCATCTGAC
CTATAGGCAGG -> TATAGGCAGGT
GCTGGATCCGA -> CTGGATCCGAT
ATCTGAGGAAC -> TCTGAGGAACG
CGATACGGTGA -> GATACGGTGAC
ACGGTTAACCC -> CGGTTAACCCA
CCGGTTGTACC -> CGGTTGTACCA
GTGTGCGTAAT -> TGTGCGTAATC
CTCGCACGGGC -> TCGCACGGGCA
CTACATTACAC -> TACATTACACC
ACGTACTTTGA -> CGTACTTTGAG
TCACAAGAAAT -> CACAAGAAATT
GCCCATTATCT -> CCCATTATCTT
GGGATAAGCCG -> GGATAAGCCGT
CAGGTTAAGAG -> AGGTTAAGAGG
CTTTGTCGGTA -> TTTGTCGGTAG
AGATTCGGTTG -> GATTCGGTTGC
GCCCAAGCTTT -> CCCAAGCTTTC
ACTCCACTTAC -> CTCCACTTACG
CTCTTGTGACT -> TCTTGTGACTT
CACCCGGGAGT -> ACCCGGGAGTA
GCCCAGCGTGT -> CCCAGCGTGTG
TTGATTGAACC -> TGATTGAACCG
AGACTTTTGCG -> GACTTTTGCGC
TAAGAGGAAGT -> AAGAGGAAGTA
GATCCCGCTCA -> ATCCCGCTCAC
TAAGAGGGACT -> AAGAGGGACTC
TTTGTCTAGGG -> TTGTCTAGGGC
CCAACTTGAAA -> CAACTTGAAAG
CTTTGACTGAC -> TTTGACTGACA
CTTGTGACTTT -> TTGTGACTTTG
GGGTATGCGAG -> GGTATGCGAGT
CGATGGGACAT -> GATGGGACATA
CATCTGACGTC -> ATCTGACGTCG
TAAAGTTTGGC -> AAAGTTTGGCC
CCGTCGGATTT -> CGTCGGATTTG
GTTAGGGACGG -> TTAGGGACGGT
CTGTCTAGGAA -> TGTCTAGGAAG
TTCCCTGAATT -> TCCCTGAATTC
CGAATGACGCT -> GAATGACGCTA
ATTCCGCATTC -> TTCCGCATTCG
CTGCTGAGTAG -> TGCTGAGTAGA
TGACTATGCCT -> GACTATGCCTG
TGGGACTGAAC -> GGGACTGAACG
GCACGGGCAAA -> CACGGGCAAAC
TTGCAGTGGTG -> TGCAGTGGTGG
ATTGCAGTGGT -> TTGCAGTGGTG
TTGGCGCCTAG -> TGGCGCCTAGA
ATCTCCCCAGG -> TCTCCCCAGGT
TCGAGCGCGCT -> CGAGCGCGCTG
ACGATACGGTG -> CGATACGGTGA
CAGCGGCACAA -> AGCGGCACAAC
AGGCGGGCCCC -> GGCGGGCCCCC
CTAACCCCGGA -> TAACCCCGGAT
TGACAGGCCAG -> GACAGGCCAGA
ACTTTGTCGGT -> CTTTGTCGGTA
GAAGAGAGAAC -> AAGAGAGAACG
AAGCCCGCACT -> AGCCCGCACTG
GCTACATTCTA -> CTACATTCTAA
TCGGATCACCC -> CGGATCACCCG
TAGTCGACGTA -> AGTCGACGTAT
GTCGACTGTCG -> TCGACTGTCGT
GAGGACAATAA -> AGGACAATAAT
TGAAACAGGAT -> GAAACAGGATG
AAGCCCAAGCT -> AGCCCAAGCTT
CGAGTATATGG -> GAGTATATGGT
AGAGCTACATT -> GAGCTACATTC
TGGGGTCGACA -> GGGGTCGACAA
CTATTTGATTG -> TATTTGATTGA
AAGACCACAGT -> AGACCACAGTA
GCCCCGACTGT -> CCCCGACTGTT
CGGATACGACA -> GGATACGACAG
ATTCTGTCTAG -> TTCTGTCTAGG
GCTCTACATCC -> CTCTACATCCA
CAGATTCGGTT -> AGATTCGGTTG
GGTAGGGAGAG -> GTAGGGAGAGT
CTACATCCAGC -> TACATCCAGCT
CATTGACCCTG -> ATTGACCCTGC
ACCGGACTCTC -> CCGGACTCTCC
AGGTAATTAGC -> GGTAATTAGCG
GGCCAGAACTC -> GCCAGAACTCC
CTTCGCTGACC -> TTCGCTGACCG
GTGGGGCTAGG -> TGGGGCTAGGT
GACGCTAGGAA -> ACGCTAGGAAG
TGCGTAATCTG -> GCGTAATCTGA
AATGACGCTAG -> ATGACGCTAGG
TATCAAGAAGC -> ATCAAGAAGCG
GCGCTTCGGTT -> CGCTTCGGTTG
TTAAGATTTCT -> TAAGATTTCTG
CTCATACTAAC -> TCATACTAACC
CGAAGGCAGGT -> GAAGGCAGGTC
TGACCGCGAAT -> GACCGCGAATA
GGGTACGCGAC -> GGTACGCGACT
TAATAACTACT -> AATAACTACTG
GTTGCAAGGTC -> TTGCAAGGTCG
ACGGCTGCGCT -> CGGCTGCGCTT
CACATGGCGGT -> ACATGGCGGTT
TTATCTTAGGT -> TATCTTAGGTG
CCTGGTGTGCG -> CTGGTGTGCGA
CAACTCTCTTG -> AACTCTCTTGT
CCTCAGTTGGA -> CTCAGTTGGAG
CCATGACGGAC -> CATGACGGACT
TTGATTTCCGC -> TGATTTCCGCC
TCTCCGCTTCC -> CTCCGCTTCCC
AGATATAACTA -> GATATAACTAT
TGGAGGGGTAT -> GGAGGGGTATG
CTTGGCGCCTA -> TTGGCGCCTAG