30 100
TACATGTCACGCTTCGCGGTAAAGCGCTCT|CGTCTTCCAACCTGCTGTCTTCCAACCTGC
TTTCTATATGGCGTCTTCCAACCTGCTAAT|CTTCCAACCTGCTGACGGAGGGAGACGAAT
TCTATATGGCGTCTTCCAACCTGCTGTCTT|ATCGTAGCACGGGTGTCTCTATAGACGCTG
AATTACGATCACACCGACGTCCTAATTTTC|TCCATTGATTATAACTATAGATGCCCACCC
GGAATTTTCTATATGGCGTCTTCCAACCTG|GGTGCAATTCGGGCCAATAAATCGGAGAGA
ATAAATGCAATAATTTTCTATATGGCGTCT|CTATATGAATTTTCTATATGGCGTCTTCCA
GGAACCCGCAGGGGGGTGCAATTCGGGCCA|TGTATGGCCTATCGTAGCATCATTCCGATA
CCTACGATGGGGGAACCCGCAGGGGGGTGC|AGTTGTCTGGTTGTATGGCCTATCGTAGCA
ACCCGAATCACCAATTTTCTATATGGCGTC|GGACCTTTCCGTCCGAAGCGAGGATAATTT
ACGGGTGTCTCTATAGACGCTGGAATTTTC|CGATGGGGGAACCCGCAGGGGGGTGCAATT
TTCGGATCAGCGCCAACACGAGGTAAAGCA|TTCTATATGGCGTCTTCCAACCTGCTTAGC
GACGAATAGACCCGAATCACCAATTTTCTA|CAGGACTAGGGACCTTTCCGTCCGAAGCGA
TGGGCACTCTACGCCAAAGTTCAAATGTGA|CTCAGCAAAGCCATTCTCTACTGGGACTAA
ATATGGCGTCTTCCAACCTGCTCAGCAAAG|CGAATCACCAATTTTCTATATGGCGTCTTC
GTATGAGCGATGTACGCTCATTTCCCATCC|GGCGTCTTCCAACCTGCTTTTGTCTTTAAT
TTCGACATGGCGACGACACGGGCTTTGGCC|CTTCCAACCTGCTATGAGGCCAAATAGATT
TTTCTATATGGCGTCTTCCAACCTGCTACG|ACACCGACGTCCTAATTTTCTATATGGCGT
TTCATGACCCGACACTAATGAATTTTCTAT|CGTAGCGTGTGATCACGTTTAACTAATGGG
GCGTCTTCCAACCTGCTGTTTCCTAGGCAG|AATAAATCGGAGAGACCATGTGTGCAAAGA
ACCTGCTTCGGATATGTACAATCAGAATGC|ATGGCGTCTTCCAACCTGCTACGAAGTAGG
ATGAATTTTCTATATGGCGTCTTCCAACCT|TTTAACTAATGGGCACTCTACGCCAAAGTT
GGGGGAACCCGCAGGGGGGTGCAATTCGGG|GGTTGTATGGCCTATCGTAGCATCATTCCG
TTCTATATGGCGTCTTCCAACCTGCTCAGC|GACCCGAATCACCAATTTTCTATATGGCGT
AGGCCAAATAGATTCCGAGGGGAGCAATCT|CAACCTGCTTTTCTATATGGCGTCTTCCAA
GAGGATAATTTTCTATATGGCGTCTTCCAA|ATTACGATCACACCGACGTCCTAATTTTCT
CCTAATTTTCTATATGGCGTCTTCCAACCT|ATGCCCACCCCCAGGAGGCTTTTAGTGGTT
CGACACTAATGAATTTTCTATATGGCGTCT|TGATCACGTTTAACTAATGGGCACTCTACG
CTAATGAATTTTCTATATGGCGTCTTCCAA|ACGTTTAACTAATGGGCACTCTACGCCAAA
CTACGAAGTAGGTTGTTGACCTGGATGCGC|GGCGTCTTCCAACCTGCTTTTAGCGTCGCA
GGCGTCTTCCAACCTGCTTCGGATATGTAC|TAATTTTCTATATGGCGTCTTCCAACCTGC
TGGCGTCTTCCAACCTGCTTAGCCCCATAC|GGGTTTCCAGTGCAAAGGTCCTATGTGTGC
CGTAGCACGGGTGTCTCTATAGACGCTGGA|CCCCTACGATGGGGGAACCCGCAGGGGGGT
CTGCTACGAAGTAGGTTGTTGACCTGGATG|TATGGCGTCTTCCAACCTGCTTTTAGCGTC
CAACCTGCTTTTGTCTTTAATTTTCTATAT|AAAGTTCAAATGTGACGGTATAAATGCAAT
TCTATAACTTGTGGCCAATCGGATTACGGG|CTTCCAACCTGCTCTCAGGGACTAAGGGCC
TCCCCGAAGTCAATCAAAGTCCGTTGTGCG|TGACCTGGATGCGCGGTGATAACGCCCTCT
GAATTTTCTATATGGCGTCTTCCAACCTGC|TAACTAATGGGCACTCTACGCCAAAGTTCA
CGAATCACCAATTTTCTATATGGCGTCTTC|CCTTTCCGTCCGAAGCGAGGATAATTTTCT
ACGTAGCGTGTGATCACGTTTAACTAATGG|ATTTTCTATATGGCGTCTTCCAACCTGCTC
ATATGGCAATTTTCTATATGGCGTCTTCCA|TAAAGCACCTGTATCGTAGCACGGGTGTCT
GGCTCCGCAGATGATCACGGTCAATACTAG|ATGACCCGACACTAATGAATTTTCTATATG
GTGTGATCACGTTTAACTAATGGGCACTCT|ATATGGCGTCTTCCAACCTGCTCAGCAAAG
GCTGTTTCCTAGGCAGGCACAGATATCCTC|ACCATGTGTGCAAAGATTCTATAACTTGTG
CAGGGGGGTGCAATTCGGGCCAATAAATCG|CTATCGTAGCATCATTCCGATACATCCTAT
CTTCCAACCTGCTCAGCAAAGCCATTCTCT|AATTTTCTATATGGCGTCTTCCAACCTGCT
CCTTCCGACGCGATTCGACATGGCGACGAC|TTCTATATGGCGTCTTCCAACCTGCTATGA
CAAATTTTCTATATGGCGTCTTCCAACCTG|CCAATCGGATTACGGGTTTCCAGTGCAAAG
GTCTTCCAACCTGCTGACGGAGGGAGACGA|GCGGTCAGGGTGCATGTTCTCAGGCCAGGA
TCAGCAAAGCCATTCTCTACTGGGACTAAT|GGCGTCTTCCAACCTGCTTCGGATATGTAC
CACGTTTAACTAATGGGCACTCTACGCCAA|GTCTTCCAACCTGCTCAGCAAAGCCATTCT
TACGTACAAAAATGATGACCCGTTCATGAC|GAGGGGAGCAATCTGTCAGGAACGTAGCGT
GATCAGCGCCAACACGAGGTAAAGCACCTG|ATATGGCGTCTTCCAACCTGCTTAGCCCCA
GTGCAAAGATTCTATAACTTGTGGCCAATC|TATATGGCGTCTTCCAACCTGCTCTCAGGG
CTGCTGTTTCCTAGGCAGGCACAGATATCC|AGACCATGTGTGCAAAGATTCTATAACTTG
GCTTCGGATATGTACAATCAGAATGCGCGC|CGTCTTCCAACCTGCTACGAAGTAGGTTGT
TGACGGTATAAATGCAATAATTTTCTATAT|TAATTTTCTATATGAATTTTCTATATGGCG
CCCGTTCATGACCCGACACTAATGAATTTT|GGAACGTAGCGTGTGATCACGTTTAACTAA
CGCTCTAATTACGATCACACCGACGTCCTA|ACCTGCTCCATTGATTATAACTATAGATGC
TCTATATGGCGTCTTCCAACCTGCTCAGCA|ACCCGAATCACCAATTTTCTATATGGCGTC
GGCCAATCGGATTACGGGTTTCCAGTGCAA|TCTCAGGGACTAAGGGCCGGACATTTTACG
TCAATACTAGTATGAGCGATGTACGCTCAT|TTTCTATATGGCGTCTTCCAACCTGCTTTT
GCTGCGTCTTCCAACCTGCTGACGGAGGGA|GTTGTGCGGTCAGGGTGCATGTTCTCAGGC
CCTGCTGCGTCTTCCAACCTGCTGACGGAG|TCCGTTGTGCGGTCAGGGTGCATGTTCTCA
GTTCAAATGTGACGGTATAAATGCAATAAT|TACTGGGACTAATTTTCTATATGAATTTTC
CGTCTTCCAACCTGCTATGAGGCCAAATAG|TTTTCTATATGGCGTCTTCCAACCTGCTTT
GCGGTGATAACGCCCTCTGCAAGATGGTTT|CAAGTACCAATTTTCTATATGGCAATTTTC
TAACTAATGGGCACTCTACGCCAAAGTTCA|CAACCTGCTCAGCAAAGCCATTCTCTACTG
GCGCCAACACGAGGTAAAGCACCTGTATCG|GCGTCTTCCAACCTGCTTAGCCCCATACCC
GGGTTTCCAGTGCAAAGGTCCTATGTGTGC|GCCGGACATTTTACGTAGAGGTATCTACTA
GACGCTGGAATTTTCTATATGGCGTCTTCC|CAGGGGGGTGCAATTCGGGCCAATAAATCG
TGTGATCACGTTTAACTAATGGGCACTCTA|TATGGCGTCTTCCAACCTGCTCAGCAAAGC
CTTCGGATATGTACAATCAGAATGCGCGCT|GTCTTCCAACCTGCTACGAAGTAGGTTGTT
CCATACCCCCTACGATGGGGGAACCCGCAG|GTGTGCAAAGTTGTCTGGTTGTATGGCCTA
CAACCTGCTGACGGAGGGAGACGAATAGAC|AGGGTGCATGTTCTCAGGCCAGGACTAGGG
CCAACCTGCTCCATTGATTATAACTATAGA|GAATTTTCTATATGGCGTCTTCCAACCTGC
AGGGGAGCAATCTGTCAGGAACGTAGCGTG|TGGCGTCTTCCAACCTGCTAATTTTCTATA
GGCGTCTTCCAACCTGCTGTTTCCTAGGCA|CAATAAATCGGAGAGACCATGTGTGCAAAG
CAGTGCAAAGGTCCTATGTGTGCAAAGTTG|ATTTTACGTAGAGGTATCTACTAAGATCTC
GTACAATCAGAATGCGCGCTCCCCGAAGTC|CTGCTACGAAGTAGGTTGTTGACCTGGATG
CTGCTTTTAGCGTCGCAAGTACCAATTTTC|TTTTTCGGTTCGGATCAGCGCCAACACGAG
CCAAATAGATTCCGAGGGGAGCAATCTGTC|CCTGCTTTTCTATATGGCGTCTTCCAACCT
AGCGTGTGATCACGTTTAACTAATGGGCAC|TCTATATGGCGTCTTCCAACCTGCTCAGCA
ACACCGACGTCCTAATTTTCTATATGGCGT|ATAACTATAGATGCCCACCCCCAGGAGGCT
CCGACACTAATGAATTTTCTATATGGCGTC|GTGATCACGTTTAACTAATGGGCACTCTAC
TTCTATATGGCGTCTTCCAACCTGCTTCGG|AGCGAGGATAATTTTCTATATGGCGTCTTC
TCCAACCTGCTTTTAGCGTCGCAAGTACCA|TAGTGGTTTTTCGGTTCGGATCAGCGCCAA
ACATGTCACGCTTCGCGGTAAAGCGCTCTA|GTCTTCCAACCTGCTGTCTTCCAACCTGCT
AACCTGCTAATTTTCTATATGGCGTCTTCC|GGGAGACGAATAGACCCGAATCACCAATTT
CAAAGATTCTATAACTTGTGGCCAATCGGA|ATGGCGTCTTCCAACCTGCTCTCAGGGACT
CTATATGGCGTCTTCCAACCTGCTTTTGTC|TGGGCACTCTACGCCAAAGTTCAAATGTGA
GTTGTGCGGTCAGGGTGCATGTTCTCAGGC|CGCCCTCTGCAAGATGGTTTGTATGCGTAC
ATGGCGTCTTCCAACCTGCTTTTCTATATG|CGTCTTCCAACCTGCTGCGTCTTCCAACCT
TCTATATGGCGTCTTCCAACCTGCTTTTCT|TATGGCGTCTTCCAACCTGCTGCGTCTTCC
TTTTCTATATGGCGTCTTCCAACCTGCTCA|TAGACCCGAATCACCAATTTTCTATATGGC
GTTTCCTAGGCAGGCACAGATATCCTCGCA|ATGTGTGCAAAGATTCTATAACTTGTGGCC
AATGATGACCCGTTCATGACCCGACACTAA|ATCTGTCAGGAACGTAGCGTGTGATCACGT
TCTTCCAACCTGCTGTTTCCTAGGCAGGCA|AAATCGGAGAGACCATGTGTGCAAAGATTC
AACCTGCTTTTGTCTTTAATTTTCTATATG|AAGTTCAAATGTGACGGTATAAATGCAATA
GTCTTCCAACCTGCTACGAAGTAGGTTGTT|TAATTTTCTATATGGCGTCTTCCAACCTGC
CGAATAGACCCGAATCACCAATTTTCTATA|GGACTAGGGACCTTTCCGTCCGAAGCGAGG
AGTAGGTTGTTGACCTGGATGCGCGGTGAT|TTCCAACCTGCTTTTAGCGTCGCAAGTACC
TCAGAATGCGCGCTCCCCGAAGTCAATCAA|CGAAGTAGGTTGTTGACCTGGATGCGCGGT
CCATTCTCTACTGGGACTAATTTTCTATAT|CAACCTGCTTCGGATATGTACAATCAGAAT
TGCTGTCTTCCAACCTGCTCCATTGATTAT|TAGACGCTGGAATTTTCTATATGGCGTCTT
TTCCTAGGCAGGCACAGATATCCTCGCAAA|GTGTGCAAAGATTCTATAACTTGTGGCCAA
CACCAATTTTCTATATGGCGTCTTCCAACC|CCGTCCGAAGCGAGGATAATTTTCTATATG
ATTTTCTATATGGCGTCTTCCAACCTGCTC|ATAGACCCGAATCACCAATTTTCTATATGG
AAAGCCATTCTCTACTGGGACTAATTTTCT|CTTCCAACCTGCTTCGGATATGTACAATCA
TGGCGTCTTCCAACCTGCTTTTAGCGTCGC|GAGGCTTTTAGTGGTTTTTCGGTTCGGATC
CTCTATAGACGCTGGAATTTTCTATATGGC|GAACCCGCAGGGGGGTGCAATTCGGGCCAA
ATTTTCTATATGGCGTCTTCCAACCTGCTG|GCGCTCCCCGAAGTCAATCAAAGTCCGTTG
CTCTGCAAGATGGTTTGTATGCGTACATGT|CTATATGGCAATTTTCTATATGGCGTCTTC
GTTGTCTGGTTGTATGGCCTATCGTAGCAT|TCTCTACGCTGACTCTCCATCTGAGGGCTG
CTAATTTTCTATATGAATTTTCTATATGGC|TGTACAATCAGAATGCGCGCTCCCCGAAGT
CGAGGGGAGCAATCTGTCAGGAACGTAGCG|TATGGCGTCTTCCAACCTGCTAATTTTCTA
AATAAATCGGAGAGACCATGTGTGCAAAGA|ACATCCTATCGAGGAATTTTCTATATGGCG
ATCAGCGCCAACACGAGGTAAAGCACCTGT|TATGGCGTCTTCCAACCTGCTTAGCCCCAT
TGCGTCTTCCAACCTGCTGACGGAGGGAGA|TGTGCGGTCAGGGTGCATGTTCTCAGGCCA
CCGAATCACCAATTTTCTATATGGCGTCTT|ACCTTTCCGTCCGAAGCGAGGATAATTTTC
ATATGAATTTTCTATATGGCGTCTTCCAAC|GAATGCGCGCTCCCCGAAGTCAATCAAAGT
CTATACGTACAAAAATGATGACCCGTTCAT|TCCGAGGGGAGCAATCTGTCAGGAACGTAG
CGTAGCGTGTGATCACGTTTAACTAATGGG|TTTTCTATATGGCGTCTTCCAACCTGCTCA
GAGGCCAAATAGATTCCGAGGGGAGCAATC|CCAACCTGCTTTTCTATATGGCGTCTTCCA
CTTCCAACCTGCTCCATTGATTATAACTAT|CTGGAATTTTCTATATGGCGTCTTCCAACC
GCGTGTGATCACGTTTAACTAATGGGCACT|CTATATGGCGTCTTCCAACCTGCTCAGCAA
CCCCAGGAGGCTTTTAGTGGTTTTTCGGTT|TAGGCAGGCACAGATATCCTCGCAAATTTT
GCGCGCTCCCCGAAGTCAATCAAAGTCCGT|GGTTGTTGACCTGGATGCGCGGTGATAACG
TAGCGTCGCAAGTACCAATTTTCTATATGG|GTTCGGATCAGCGCCAACACGAGGTAAAGC
GCGTCTTCCAACCTGCTTTTGTCTTTAATT|TCTACGCCAAAGTTCAAATGTGACGGTATA
CTTCCAACCTGCTAATTTTCTATATGGCGT|ACGGAGGGAGACGAATAGACCCGAATCACC
TGCTTTTGTCTTTAATTTTCTATATGGCGT|TCAAATGTGACGGTATAAATGCAATAATTT
GGAGAGACCATGTGTGCAAAGATTCTATAA|TCGAGGAATTTTCTATATGGCGTCTTCCAA
CAATTTTCTATATGGCAATTTTCTATATGG|AACACGAGGTAAAGCACCTGTATCGTAGCA
GGTCAGGGTGCATGTTCTCAGGCCAGGACT|TGCAAGATGGTTTGTATGCGTACATGTCAC
TAGATTCCGAGGGGAGCAATCTGTCAGGAA|TTTTCTATATGGCGTCTTCCAACCTGCTAA
TCATGACCCGACACTAATGAATTTTCTATA|GTAGCGTGTGATCACGTTTAACTAATGGGC
TTTTCTATATGGCGTCTTCCAACCTGCTGC|CGCTCCCCGAAGTCAATCAAAGTCCGTTGT
ATTTTCTATATGGCGTCTTCCAACCTGCTG|GCAATTCGGGCCAATAAATCGGAGAGACCA
ACGATCACACCGACGTCCTAATTTTCTATA|TTGATTATAACTATAGATGCCCACCCCCAG
GGTTTTTCGGTTCGGATCAGCGCCAACACG|CTCGCAAATTTTCTATATGGCGTCTTCCAA
ATTTTCTATATGGCGTCTTCCAACCTGCTT|CCACCCCCAGGAGGCTTTTAGTGGTTTTTC
TAATGAATTTTCTATATGGCGTCTTCCAAC|CGTTTAACTAATGGGCACTCTACGCCAAAG
GTCTCTATAGACGCTGGAATTTTCTATATG|GGGAACCCGCAGGGGGGTGCAATTCGGGCC
TTTCTATATGGCGTCTTCCAACCTGCTTTT|TATATGGCGTCTTCCAACCTGCTGCGTCTT
GGCGACGACACGGGCTTTGGCCTATACGTA|CTGCTATGAGGCCAAATAGATTCCGAGGGG
ATATGGCGTCTTCCAACCTGCTTTTAGCGT|CAGGAGGCTTTTAGTGGTTTTTCGGTTCGG
GAGACGAATAGACCCGAATCACCAATTTTC|GCCAGGACTAGGGACCTTTCCGTCCGAAGC
CTCATTTCCCATCCCCCTTCCGACGCGATT|CTTTTGTCTTTAATTTTCTATATGGCGTCT
AATTCGGGCCAATAAATCGGAGAGACCATG|TCATTCCGATACATCCTATCGAGGAATTTT
TTAGCCCCATACCCCCTACGATGGGGGAAC|TCCTATGTGTGCAAAGTTGTCTGGTTGTAT
GTGCAATTCGGGCCAATAAATCGGAGAGAC|AGCATCATTCCGATACATCCTATCGAGGAA
TTTTGTCTTTAATTTTCTATATGGCGTCTT|AATGTGACGGTATAAATGCAATAATTTTCT
CGGAGAGACCATGTGTGCAAAGATTCTATA|ATCGAGGAATTTTCTATATGGCGTCTTCCA
GGCAATTTTCTATATGGCGTCTTCCAACCT|GCACCTGTATCGTAGCACGGGTGTCTCTAT
CCTGCTCCATTGATTATAACTATAGATGCC|TTTCTATATGGCGTCTTCCAACCTGCTGTT
GACCCGTTCATGACCCGACACTAATGAATT|CAGGAACGTAGCGTGTGATCACGTTTAACT
TGCTTTTAGCGTCGCAAGTACCAATTTTCT|TTTTCGGTTCGGATCAGCGCCAACACGAGG
ACTAATTTTCTATATGAATTTTCTATATGG|ATGTACAATCAGAATGCGCGCTCCCCGAAG
TTCCAACCTGCTTTTAGCGTCGCAAGTACC|TTAGTGGTTTTTCGGTTCGGATCAGCGCCA
CTGTTTCCTAGGCAGGCACAGATATCCTCG|CCATGTGTGCAAAGATTCTATAACTTGTGG
CAACCTGCTATGAGGCCAAATAGATTCCGA|TATGGCGTCTTCCAACCTGCTTTTCTATAT
TATAAATGCAATAATTTTCTATATGGCGTC|TCTATATGAATTTTCTATATGGCGTCTTCC
AGAGACCATGTGTGCAAAGATTCTATAACT|GAGGAATTTTCTATATGGCGTCTTCCAACC
ATATGGCGTCTTCCAACCTGCTGTCTTCCA|GTAGCACGGGTGTCTCTATAGACGCTGGAA
ATGATGACCCGTTCATGACCCGACACTAAT|TCTGTCAGGAACGTAGCGTGTGATCACGTT
AAAGGTCCTATGTGTGCAAAGTTGTCTGGT|CGTAGAGGTATCTACTAAGATCTCTACGCT
AATGAATTTTCTATATGGCGTCTTCCAACC|GTTTAACTAATGGGCACTCTACGCCAAAGT
AGTCCGTTGTGCGGTCAGGGTGCATGTTCT|GATAACGCCCTCTGCAAGATGGTTTGTATG
CTATATGGCGTCTTCCAACCTGCTGCGTCT|CCCCGAAGTCAATCAAAGTCCGTTGTGCGG
TGTGACGGTATAAATGCAATAATTTTCTAT|ACTAATTTTCTATATGAATTTTCTATATGG
TTTCTATATGGCGTCTTCCAACCTGCTTCG|AAGCGAGGATAATTTTCTATATGGCGTCTT
AGATTCTATAACTTGTGGCCAATCGGATTA|GCGTCTTCCAACCTGCTCTCAGGGACTAAG
TGAGGCCAAATAGATTCCGAGGGGAGCAAT|TCCAACCTGCTTTTCTATATGGCGTCTTCC
TCTCTACTGGGACTAATTTTCTATATGAAT|CTGCTTCGGATATGTACAATCAGAATGCGC
CTCGCAAATTTTCTATATGGCGTCTTCCAA|GTGGCCAATCGGATTACGGGTTTCCAGTGC
CCGTTCATGACCCGACACTAATGAATTTTC|GAACGTAGCGTGTGATCACGTTTAACTAAT
GAAGCGAGGATAATTTTCTATATGGCGTCT|CTCTAATTACGATCACACCGACGTCCTAAT
TTTCTATATGGCGTCTTCCAACCTGCTTTT|TAATGGGCACTCTACGCCAAAGTTCAAATG
CAGGCCAGGACTAGGGACCTTTCCGTCCGA|CGTACATGTCACGCTTCGCGGTAAAGCGCT
CTACGCCAAAGTTCAAATGTGACGGTATAA|AGCCATTCTCTACTGGGACTAATTTTCTAT
TTTAGCGTCGCAAGTACCAATTTTCTATAT|CGGTTCGGATCAGCGCCAACACGAGGTAAA
CGGTCAATACTAGTATGAGCGATGTACGCT|AATTTTCTATATGGCGTCTTCCAACCTGCT
TGCAATAATTTTCTATATGGCGTCTTCCAA|TGAATTTTCTATATGGCGTCTTCCAACCTG
ACATGGCGACGACACGGGCTTTGGCCTATA|CAACCTGCTATGAGGCCAAATAGATTCCGA
AGGGACCTTTCCGTCCGAAGCGAGGATAAT|GCTTCGCGGTAAAGCGCTCTAATTACGATC
TCCGTTGTGCGGTCAGGGTGCATGTTCTCA|TAACGCCCTCTGCAAGATGGTTTGTATGCG
AAATGCAATAATTTTCTATATGGCGTCTTC|ATATGAATTTTCTATATGGCGTCTTCCAAC
GGCCAGGACTAGGGACCTTTCCGTCCGAAG|TACATGTCACGCTTCGCGGTAAAGCGCTCT
CTATATGGCGTCTTCCAACCTGCTTTTAGC|CCCAGGAGGCTTTTAGTGGTTTTTCGGTTC
TATGTACAATCAGAATGCGCGCTCCCCGAA|AACCTGCTACGAAGTAGGTTGTTGACCTGG
ACCTGCTGACGGAGGGAGACGAATAGACCC|GGTGCATGTTCTCAGGCCAGGACTAGGGAC
TTTTCTATATGGCGTCTTCCAACCTGCTTT|CACCCCCAGGAGGCTTTTAGTGGTTTTTCG
TGCAATTCGGGCCAATAAATCGGAGAGACC|GCATCATTCCGATACATCCTATCGAGGAAT
GGGTGCAATTCGGGCCAATAAATCGGAGAG|GTAGCATCATTCCGATACATCCTATCGAGG
TTCCGAGGGGAGCAATCTGTCAGGAACGTA|CTATATGGCGTCTTCCAACCTGCTAATTTT
AGCCATTCTCTACTGGGACTAATTTTCTAT|TCCAACCTGCTTCGGATATGTACAATCAGA
TTTCTATATGAATTTTCTATATGGCGTCTT|AATCAGAATGCGCGCTCCCCGAAGTCAATC
CCTGCTAATTTTCTATATGGCGTCTTCCAA|GAGACGAATAGACCCGAATCACCAATTTTC
TGCAAAGTTGTCTGGTTGTATGGCCTATCG|CTAAGATCTCTACGCTGACTCTCCATCTGA
TGGGACTAATTTTCTATATGAATTTTCTAT|GGATATGTACAATCAGAATGCGCGCTCCCC
GCTTTTAGCGTCGCAAGTACCAATTTTCTA|TTTCGGTTCGGATCAGCGCCAACACGAGGT
ACCTTTCCGTCCGAAGCGAGGATAATTTTC|CGCGGTAAAGCGCTCTAATTACGATCACAC
TTCTATATGGCGTCTTCCAACCTGCTATGA|AATGCAATAATTTTCTATATGGCGTCTTCC
GTGACGGTATAAATGCAATAATTTTCTATA|CTAATTTTCTATATGAATTTTCTATATGGC
CAACCTGCTTCGGATATGTACAATCAGAAT|ATATGGCGTCTTCCAACCTGCTACGAAGTA
GTCAGGGTGCATGTTCTCAGGCCAGGACTA|GCAAGATGGTTTGTATGCGTACATGTCACG
CGTCTTCCAACCTGCTTTTAGCGTCGCAAG|GCTTTTAGTGGTTTTTCGGTTCGGATCAGC
TTCGCGGTAAAGCGCTCTAATTACGATCAC|TGCTGTCTTCCAACCTGCTCCATTGATTAT
TAATTACGATCACACCGACGTCCTAATTTT|CTCCATTGATTATAACTATAGATGCCCACC
CTTCCAACCTGCTGTTTCCTAGGCAGGCAC|AATCGGAGAGACCATGTGTGCAAAGATTCT
AACCTGCTACGAAGTAGGTTGTTGACCTGG|CTATATGGCGTCTTCCAACCTGCTTTTAGC
GTCAATCAAAGTCCGTTGTGCGGTCAGGGT|ATGCGCGGTGATAACGCCCTCTGCAAGATG
GATGCGCGGTGATAACGCCCTCTGCAAGAT|CGTCGCAAGTACCAATTTTCTATATGGCAA
CACCTGTATCGTAGCACGGGTGTCTCTATA|GCCCCATACCCCCTACGATGGGGGAACCCG
CCAGGAGGCTTTTAGTGGTTTTTCGGTTCG|GGCAGGCACAGATATCCTCGCAAATTTTCT
CCAATAAATCGGAGAGACCATGTGTGCAAA|ATACATCCTATCGAGGAATTTTCTATATGG
ATTTTCTATATGGCGTCTTCCAACCTGCTA|ATAAATGCAATAATTTTCTATATGGCGTCT
TTGTCTTTAATTTTCTATATGGCGTCTTCC|TGTGACGGTATAAATGCAATAATTTTCTAT
TCTTCCAACCTGCTGTCTTCCAACCTGCTC|GGTGTCTCTATAGACGCTGGAATTTTCTAT
ATCAAAGTCCGTTGTGCGGTCAGGGTGCAT|GCGGTGATAACGCCCTCTGCAAGATGGTTT
TCCAACCTGCTTCGGATATGTACAATCAGA|CTATATGGCGTCTTCCAACCTGCTACGAAG
TATATGGCGTCTTCCAACCTGCTTTTCTAT|TGGCGTCTTCCAACCTGCTGCGTCTTCCAA
GTCCTAATTTTCTATATGGCGTCTTCCAAC|AGATGCCCACCCCCAGGAGGCTTTTAGTGG
CCTGGATGCGCGGTGATAACGCCCTCTGCA|TTAGCGTCGCAAGTACCAATTTTCTATATG
AAAAATGATGACCCGTTCATGACCCGACAC|GCAATCTGTCAGGAACGTAGCGTGTGATCA
TTTCTATATGGCGTCTTCCAACCTGCTGTC|GTATCGTAGCACGGGTGTCTCTATAGACGC
TATAGACGCTGGAATTTTCTATATGGCGTC|CCCGCAGGGGGGTGCAATTCGGGCCAATAA
ATACGTACAAAAATGATGACCCGTTCATGA|CGAGGGGAGCAATCTGTCAGGAACGTAGCG
GCCTATACGTACAAAAATGATGACCCGTTC|ATTCCGAGGGGAGCAATCTGTCAGGAACGT
GCCAGGACTAGGGACCTTTCCGTCCGAAGC|ACATGTCACGCTTCGCGGTAAAGCGCTCTA
CTGCTAATTTTCTATATGGCGTCTTCCAAC|AGACGAATAGACCCGAATCACCAATTTTCT
GTGATCACGTTTAACTAATGGGCACTCTAC|ATGGCGTCTTCCAACCTGCTCAGCAAAGCC
GGTCCTATGTGTGCAAAGTTGTCTGGTTGT|AGAGGTATCTACTAAGATCTCTACGCTGAC
TAATTTTCTATATGAATTTTCTATATGGCG|GTACAATCAGAATGCGCGCTCCCCGAAGTC
AAGCACCTGTATCGTAGCACGGGTGTCTCT|TTAGCCCCATACCCCCTACGATGGGGGAAC
ACCAATTTTCTATATGGCGTCTTCCAACCT|CGTCCGAAGCGAGGATAATTTTCTATATGG
AAATTTTCTATATGGCGTCTTCCAACCTGC|CAATCGGATTACGGGTTTCCAGTGCAAAGG
GCGCGGTGATAACGCCCTCTGCAAGATGGT|CGCAAGTACCAATTTTCTATATGGCAATTT
AGCCCCATACCCCCTACGATGGGGGAACCC|CTATGTGTGCAAAGTTGTCTGGTTGTATGG
CAAGATGGTTTGTATGCGTACATGTCACGC|TGGCAATTTTCTATATGGCGTCTTCCAACC
CCCGAATCACCAATTTTCTATATGGCGTCT|GACCTTTCCGTCCGAAGCGAGGATAATTTT
AATTTTCTATATGGCGTCTTCCAACCTGCT|ATCACACCGACGTCCTAATTTTCTATATGG
GGGCCAATAAATCGGAGAGACCATGTGTGC|CCGATACATCCTATCGAGGAATTTTCTATA
CTGCTTAGCCCCATACCCCCTACGATGGGG|AAGGTCCTATGTGTGCAAAGTTGTCTGGTT
GCACAGATATCCTCGCAAATTTTCTATATG|TTCTATAACTTGTGGCCAATCGGATTACGG
CGCGGTAAAGCGCTCTAATTACGATCACAC|CTGTCTTCCAACCTGCTCCATTGATTATAA
ATGGCGTCTTCCAACCTGCTTTTAGCGTCG|GGAGGCTTTTAGTGGTTTTTCGGTTCGGAT
TTAGCGTCGCAAGTACCAATTTTCTATATG|GGTTCGGATCAGCGCCAACACGAGGTAAAG
AGACGCTGGAATTTTCTATATGGCGTCTTC|GCAGGGGGGTGCAATTCGGGCCAATAAATC
GGAACGTAGCGTGTGATCACGTTTAACTAA|CTAATTTTCTATATGGCGTCTTCCAACCTG
CTTTAATTTTCTATATGGCGTCTTCCAACC|ACGGTATAAATGCAATAATTTTCTATATGG
GTGCGGTCAGGGTGCATGTTCTCAGGCCAG|CCTCTGCAAGATGGTTTGTATGCGTACATG
TTTCTATATGGCAATTTTCTATATGGCGTC|CGAGGTAAAGCACCTGTATCGTAGCACGGG
GATTCTATAACTTGTGGCCAATCGGATTAC|CGTCTTCCAACCTGCTCTCAGGGACTAAGG
ACCTGCTTTTCTATATGGCGTCTTCCAACC|GCTGCGTCTTCCAACCTGCTGACGGAGGGA
GCTAATTTTCTATATGGCGTCTTCCAACCT|ACGAATAGACCCGAATCACCAATTTTCTAT
CTCTACGCCAAAGTTCAAATGTGACGGTAT|AAAGCCATTCTCTACTGGGACTAATTTTCT
GCGTCTTCCAACCTGCTCAGCAAAGCCATT|CACCAATTTTCTATATGGCGTCTTCCAACC
AGGCTTTTAGTGGTTTTTCGGTTCGGATCA|GCACAGATATCCTCGCAAATTTTCTATATG
CTCTACTGGGACTAATTTTCTATATGAATT|TGCTTCGGATATGTACAATCAGAATGCGCG
CCCTACGATGGGGGAACCCGCAGGGGGGTG|AAGTTGTCTGGTTGTATGGCCTATCGTAGC
AGGATAATTTTCTATATGGCGTCTTCCAAC|TTACGATCACACCGACGTCCTAATTTTCTA
GATCACGTTTAACTAATGGGCACTCTACGC|GGCGTCTTCCAACCTGCTCAGCAAAGCCAT
TGTTGACCTGGATGCGCGGTGATAACGCCC|CTGCTTTTAGCGTCGCAAGTACCAATTTTC
CAATACTAGTATGAGCGATGTACGCTCATT|TTCTATATGGCGTCTTCCAACCTGCTTTTG
CCTCTGCAAGATGGTTTGTATGCGTACATG|TCTATATGGCAATTTTCTATATGGCGTCTT
ATCACACCGACGTCCTAATTTTCTATATGG|ATTATAACTATAGATGCCCACCCCCAGGAG
CCTGCTGACGGAGGGAGACGAATAGACCCG|GTGCATGTTCTCAGGCCAGGACTAGGGACC
GTTTAACTAATGGGCACTCTACGCCAAAGT|TTCCAACCTGCTCAGCAAAGCCATTCTCTA
AGATTCCGAGGGGAGCAATCTGTCAGGAAC|TTTCTATATGGCGTCTTCCAACCTGCTAAT
TCCAACCTGCTGTTTCCTAGGCAGGCACAG|TCGGAGAGACCATGTGTGCAAAGATTCTAT
TCTATATGGCGTCTTCCAACCTGCTTAGCC|GATTACGGGTTTCCAGTGCAAAGGTCCTAT
CCTGCTTTTCTATATGGCGTCTTCCAACCT|CTGCGTCTTCCAACCTGCTGACGGAGGGAG
GGTTTCCAGTGCAAAGGTCCTATGTGTGCA|CCGGACATTTTACGTAGAGGTATCTACTAA
CGACACGGGCTTTGGCCTATACGTACAAAA|ATGAGGCCAAATAGATTCCGAGGGGAGCAA
TATAACTATAGATGCCCACCCCCAGGAGGC|CTTCCAACCTGCTGTTTCCTAGGCAGGCAC
GGGTGTCTCTATAGACGCTGGAATTTTCTA|ATGGGGGAACCCGCAGGGGGGTGCAATTCG
TAACTTGTGGCCAATCGGATTACGGGTTTC|CAACCTGCTCTCAGGGACTAAGGGCCGGAC
CTGCTTTTGTCTTTAATTTTCTATATGGCG|TTCAAATGTGACGGTATAAATGCAATAATT
CTGCTTCGGATATGTACAATCAGAATGCGC|GGCGTCTTCCAACCTGCTACGAAGTAGGTT
GTTCATGACCCGACACTAATGAATTTTCTA|ACGTAGCGTGTGATCACGTTTAACTAATGG
CCGCAGGGGGGTGCAATTCGGGCCAATAAA|GGCCTATCGTAGCATCATTCCGATACATCC
GTTTCCAGTGCAAAGGTCCTATGTGTGCAA|CGGACATTTTACGTAGAGGTATCTACTAAG
AGACCCGAATCACCAATTTTCTATATGGCG|AGGGACCTTTCCGTCCGAAGCGAGGATAAT
GTTTGTATGCGTACATGTCACGCTTCGCGG|TTTCTATATGGCGTCTTCCAACCTGCTGTC
CAACCTGCTGTTTCCTAGGCAGGCACAGAT|GGAGAGACCATGTGTGCAAAGATTCTATAA
GTATAAATGCAATAATTTTCTATATGGCGT|TTCTATATGAATTTTCTATATGGCGTCTTC
CCTGCTATGAGGCCAAATAGATTCCGAGGG|GGCGTCTTCCAACCTGCTTTTCTATATGGC
GCTCTAATTACGATCACACCGACGTCCTAA|CCTGCTCCATTGATTATAACTATAGATGCC
GTTGTTGACCTGGATGCGCGGTGATAACGC|ACCTGCTTTTAGCGTCGCAAGTACCAATTT
TTCAAATGTGACGGTATAAATGCAATAATT|ACTGGGACTAATTTTCTATATGAATTTTCT
AGGTAAAGCACCTGTATCGTAGCACGGGTG|CCTGCTTAGCCCCATACCCCCTACGATGGG
TCACGGTCAATACTAGTATGAGCGATGTAC|ATGAATTTTCTATATGGCGTCTTCCAACCT
CAAAGTTCAAATGTGACGGTATAAATGCAA|TCTCTACTGGGACTAATTTTCTATATGAAT
CGCAGATGATCACGGTCAATACTAGTATGA|CCGACACTAATGAATTTTCTATATGGCGTC
TCTCTATAGACGCTGGAATTTTCTATATGG|GGAACCCGCAGGGGGGTGCAATTCGGGCCA
TATATGGCGTCTTCCAACCTGCTTTTAGCG|CCAGGAGGCTTTTAGTGGTTTTTCGGTTCG
GTGCAAAGGTCCTATGTGTGCAAAGTTGTC|TTTACGTAGAGGTATCTACTAAGATCTCTA
CTTTTAGTGGTTTTTCGGTTCGGATCAGCG|CAGATATCCTCGCAAATTTTCTATATGGCG
GGGTGCATGTTCTCAGGCCAGGACTAGGGA|GATGGTTTGTATGCGTACATGTCACGCTTC
GTAGGTTGTTGACCTGGATGCGCGGTGATA|TCCAACCTGCTTTTAGCGTCGCAAGTACCA
CTGGGACTAATTTTCTATATGAATTTTCTA|CGGATATGTACAATCAGAATGCGCGCTCCC
TTTCGGTTCGGATCAGCGCCAACACGAGGT|CAAATTTTCTATATGGCGTCTTCCAACCTG
TCTTCCAACCTGCTGCGTCTTCCAACCTGC|AATCAAAGTCCGTTGTGCGGTCAGGGTGCA
TGCATGTTCTCAGGCCAGGACTAGGGACCT|GGTTTGTATGCGTACATGTCACGCTTCGCG
CTATATGGCGTCTTCCAACCTGCTGTTTCC|TCGGGCCAATAAATCGGAGAGACCATGTGT
GACCATGTGTGCAAAGATTCTATAACTTGT|GAATTTTCTATATGGCGTCTTCCAACCTGC
ATCGGAGAGACCATGTGTGCAAAGATTCTA|CTATCGAGGAATTTTCTATATGGCGTCTTC
ATGCGCGCTCCCCGAAGTCAATCAAAGTCC|TAGGTTGTTGACCTGGATGCGCGGTGATAA
ACCTGCTGTTTCCTAGGCAGGCACAGATAT|AGAGACCATGTGTGCAAAGATTCTATAACT
CCTGCTTTTAGCGTCGCAAGTACCAATTTT|GTTTTTCGGTTCGGATCAGCGCCAACACGA
AAATCGGAGAGACCATGTGTGCAAAGATTC|TCCTATCGAGGAATTTTCTATATGGCGTCT
ATGTCACGCTTCGCGGTAAAGCGCTCTAAT|CTTCCAACCTGCTGTCTTCCAACCTGCTCC
GTCTTCCAACCTGCTCAGCAAAGCCATTCT|CCAATTTTCTATATGGCGTCTTCCAACCTG
GTGCATGTTCTCAGGCCAGGACTAGGGACC|TGGTTTGTATGCGTACATGTCACGCTTCGC
AATTTTCTATATGGCGTCTTCCAACCTGCT|AATCGGATTACGGGTTTCCAGTGCAAAGGT
CAGATATCCTCGCAAATTTTCTATATGGCG|TATAACTTGTGGCCAATCGGATTACGGGTT
TATATGGCGTCTTCCAACCTGCTTAGCCCC|TTACGGGTTTCCAGTGCAAAGGTCCTATGT
CTAATTTTCTATATGGCGTCTTCCAACCTG|TGCCCACCCCCAGGAGGCTTTTAGTGGTTT
CGCGCTCCCCGAAGTCAATCAAAGTCCGTT|GTTGTTGACCTGGATGCGCGGTGATAACGC
AAGATGGTTTGTATGCGTACATGTCACGCT|GGCAATTTTCTATATGGCGTCTTCCAACCT
TTGGCCTATACGTACAAAAATGATGACCCG|TAGATTCCGAGGGGAGCAATCTGTCAGGAA
TAAAGCACCTGTATCGTAGCACGGGTGTCT|GCTTAGCCCCATACCCCCTACGATGGGGGA
CGGATCAGCGCCAACACGAGGTAAAGCACC|CTATATGGCGTCTTCCAACCTGCTTAGCCC
GTGTGCAAAGATTCTATAACTTGTGGCCAA|TCTATATGGCGTCTTCCAACCTGCTCTCAG
TTCTATATGGCGTCTTCCAACCTGCTAATT|TTCCAACCTGCTGACGGAGGGAGACGAATA
ATTCGGGCCAATAAATCGGAGAGACCATGT|CATTCCGATACATCCTATCGAGGAATTTTC
CAACCTGCTGCGTCTTCCAACCTGCTGACG|AAGTCCGTTGTGCGGTCAGGGTGCATGTTC
CAATTCGGGCCAATAAATCGGAGAGACCAT|ATCATTCCGATACATCCTATCGAGGAATTT
GGCACTCTACGCCAAAGTTCAAATGTGACG|CAGCAAAGCCATTCTCTACTGGGACTAATT
TAGTATGAGCGATGTACGCTCATTTCCCAT|ATGGCGTCTTCCAACCTGCTTTTGTCTTTA
AATTTTCTATATGGCGTCTTCCAACCTGCT|CGCGCTCCCCGAAGTCAATCAAAGTCCGTT
CCCCCTTCCGACGCGATTCGACATGGCGAC|ATTTTCTATATGGCGTCTTCCAACCTGCTA
GGTAAAGCGCTCTAATTACGATCACACCGA|TCTTCCAACCTGCTCCATTGATTATAACTA
AATAATTTTCTATATGGCGTCTTCCAACCT|ATTTTCTATATGGCGTCTTCCAACCTGCTG
ACGAAGTAGGTTGTTGACCTGGATGCGCGG|CGTCTTCCAACCTGCTTTTAGCGTCGCAAG
AATGCAATAATTTTCTATATGGCGTCTTCC|TATGAATTTTCTATATGGCGTCTTCCAACC
ACTAGTATGAGCGATGTACGCTCATTTCCC|ATATGGCGTCTTCCAACCTGCTTTTGTCTT
CCCGAAGTCAATCAAAGTCCGTTGTGCGGT|ACCTGGATGCGCGGTGATAACGCCCTCTGC
ACCTGCTGTCTTCCAACCTGCTCCATTGAT|CTATAGACGCTGGAATTTTCTATATGGCGT
AATTTTCTATATGGCGTCTTCCAACCTGCT|CCTGTATCGTAGCACGGGTGTCTCTATAGA
TTTTAGTGGTTTTTCGGTTCGGATCAGCGC|AGATATCCTCGCAAATTTTCTATATGGCGT
GCATGTTCTCAGGCCAGGACTAGGGACCTT|GTTTGTATGCGTACATGTCACGCTTCGCGG
ATTATAACTATAGATGCCCACCCCCAGGAG|GTCTTCCAACCTGCTGTTTCCTAGGCAGGC
ATAATTTTCTATATGGCGTCTTCCAACCTG|TTTTCTATATGGCGTCTTCCAACCTGCTGC
AGATGCCCACCCCCAGGAGGCTTTTAGTGG|TGCTGTTTCCTAGGCAGGCACAGATATCCT
GTGGCCAATCGGATTACGGGTTTCCAGTGC|GCTCTCAGGGACTAAGGGCCGGACATTTTA
CTGCTGCGTCTTCCAACCTGCTGACGGAGG|CCGTTGTGCGGTCAGGGTGCATGTTCTCAG
GCGTACATGTCACGCTTCGCGGTAAAGCGC|TGGCGTCTTCCAACCTGCTGTCTTCCAACC
GGGACCTTTCCGTCCGAAGCGAGGATAATT|CTTCGCGGTAAAGCGCTCTAATTACGATCA
TCCAACCTGCTTTTCTATATGGCGTCTTCC|ACCTGCTGCGTCTTCCAACCTGCTGACGGA
CGTCTTCCAACCTGCTTAGCCCCATACCCC|TTTCCAGTGCAAAGGTCCTATGTGTGCAAA
TCATTTCCCATCCCCCTTCCGACGCGATTC|TTTTGTCTTTAATTTTCTATATGGCGTCTT
GCTTAGCCCCATACCCCCTACGATGGGGGA|GGTCCTATGTGTGCAAAGTTGTCTGGTTGT
GCTTTTCTATATGGCGTCTTCCAACCTGCT|CGTCTTCCAACCTGCTGACGGAGGGAGACG
AGTTGTCTGGTTGTATGGCCTATCGTAGCA|ATCTCTACGCTGACTCTCCATCTGAGGGCT
CGACGCGATTCGACATGGCGACGACACGGG|TATGGCGTCTTCCAACCTGCTATGAGGCCA
GTCTTCCAACCTGCTTTTAGCGTCGCAAGT|CTTTTAGTGGTTTTTCGGTTCGGATCAGCG
GAAGTCAATCAAAGTCCGTTGTGCGGTCAG|TGGATGCGCGGTGATAACGCCCTCTGCAAG
CCAACCTGCTTAGCCCCATACCCCCTACGA|GTGCAAAGGTCCTATGTGTGCAAAGTTGTC
GCAAAGGTCCTATGTGTGCAAAGTTGTCTG|TACGTAGAGGTATCTACTAAGATCTCTACG
ATGGCGACGACACGGGCTTTGGCCTATACG|ACCTGCTATGAGGCCAAATAGATTCCGAGG
GTCCGAAGCGAGGATAATTTTCTATATGGC|AGCGCTCTAATTACGATCACACCGACGTCC
ATTTTCTATATGGCGTCTTCCAACCTGCTG|CTGTATCGTAGCACGGGTGTCTCTATAGAC
CCCGACACTAATGAATTTTCTATATGGCGT|TGTGATCACGTTTAACTAATGGGCACTCTA
GCGGTCAGGGTGCATGTTCTCAGGCCAGGA|TCTGCAAGATGGTTTGTATGCGTACATGTC
GAGGGGAGCAATCTGTCAGGAACGTAGCGT|ATGGCGTCTTCCAACCTGCTAATTTTCTAT
TACGATCACACCGACGTCCTAATTTTCTAT|ATTGATTATAACTATAGATGCCCACCCCCA
TGACGGAGGGAGACGAATAGACCCGAATCA|TGTTCTCAGGCCAGGACTAGGGACCTTTCC
TTCCAACCTGCTATGAGGCCAAATAGATTC|CTATATGGCGTCTTCCAACCTGCTTTTCTA
CCCATCCCCCTTCCGACGCGATTCGACATG|CTTTAATTTTCTATATGGCGTCTTCCAACC
CGCAAGTACCAATTTTCTATATGGCAATTT|ATCAGCGCCAACACGAGGTAAAGCACCTGT
AATTTTCTATATGGCGTCTTCCAACCTGCT|CCGAAGCGAGGATAATTTTCTATATGGCGT
TACGGGTTTCCAGTGCAAAGGTCCTATGTG|AGGGCCGGACATTTTACGTAGAGGTATCTA
GACTAATTTTCTATATGAATTTTCTATATG|TATGTACAATCAGAATGCGCGCTCCCCGAA
AACCTGCTTTTAGCGTCGCAAGTACCAATT|TGGTTTTTCGGTTCGGATCAGCGCCAACAC
TGCGCGCTCCCCGAAGTCAATCAAAGTCCG|AGGTTGTTGACCTGGATGCGCGGTGATAAC
GGCGTCTTCCAACCTGCTGTCTTCCAACCT|CACGGGTGTCTCTATAGACGCTGGAATTTT
CCTATGTGTGCAAAGTTGTCTGGTTGTATG|GGTATCTACTAAGATCTCTACGCTGACTCT
TCTTCCAACCTGCTAATTTTCTATATGGCG|GACGGAGGGAGACGAATAGACCCGAATCAC
CTTCCAACCTGCTTTTAGCGTCGCAAGTAC|TTTAGTGGTTTTTCGGTTCGGATCAGCGCC
CTGCTGACGGAGGGAGACGAATAGACCCGA|TGCATGTTCTCAGGCCAGGACTAGGGACCT
ATGGCGTCTTCCAACCTGCTGTTTCCTAGG|GCCAATAAATCGGAGAGACCATGTGTGCAA
TGGCGTCTTCCAACCTGCTTTTCTATATGG|GTCTTCCAACCTGCTGCGTCTTCCAACCTG
ACCCGCAGGGGGGTGCAATTCGGGCCAATA|ATGGCCTATCGTAGCATCATTCCGATACAT
TATGGCGTCTTCCAACCTGCTTCGGATATG|GGATAATTTTCTATATGGCGTCTTCCAACC
TTCCAACCTGCTGACGGAGGGAGACGAATA|GTCAGGGTGCATGTTCTCAGGCCAGGACTA
GCTCAGCAAAGCCATTCTCTACTGGGACTA|ATGGCGTCTTCCAACCTGCTTCGGATATGT
TATGGCGTCTTCCAACCTGCTGTCTTCCAA|TAGCACGGGTGTCTCTATAGACGCTGGAAT
CATGTTCTCAGGCCAGGACTAGGGACCTTT|TTTGTATGCGTACATGTCACGCTTCGCGGT
CCAACCTGCTGACGGAGGGAGACGAATAGA|CAGGGTGCATGTTCTCAGGCCAGGACTAGG
CGGGTTTCCAGTGCAAAGGTCCTATGTGTG|GGCCGGACATTTTACGTAGAGGTATCTACT
AATTTTCTATATGGCGTCTTCCAACCTGCT|CCCACCCCCAGGAGGCTTTTAGTGGTTTTT
GGGAACCCGCAGGGGGGTGCAATTCGGGCC|TTGTATGGCCTATCGTAGCATCATTCCGAT
TTAGTGGTTTTTCGGTTCGGATCAGCGCCA|ATATCCTCGCAAATTTTCTATATGGCGTCT
CTCCGCAGATGATCACGGTCAATACTAGTA|GACCCGACACTAATGAATTTTCTATATGGC
CCAAAGTTCAAATGTGACGGTATAAATGCA|TTCTCTACTGGGACTAATTTTCTATATGAA
AATTTTCTATATGAATTTTCTATATGGCGT|TACAATCAGAATGCGCGCTCCCCGAAGTCA
ATTTTCTATATGAATTTTCTATATGGCGTC|ACAATCAGAATGCGCGCTCCCCGAAGTCAA
GGGAGACGAATAGACCCGAATCACCAATTT|AGGCCAGGACTAGGGACCTTTCCGTCCGAA
CTATATGGCGTCTTCCAACCTGCTTAGCCC|ATTACGGGTTTCCAGTGCAAAGGTCCTATG
GATAATTTTCTATATGGCGTCTTCCAACCT|ACGATCACACCGACGTCCTAATTTTCTATA
TCAGGCCAGGACTAGGGACCTTTCCGTCCG|GCGTACATGTCACGCTTCGCGGTAAAGCGC
TCAAAGTCCGTTGTGCGGTCAGGGTGCATG|CGGTGATAACGCCCTCTGCAAGATGGTTTG
CTGCTATGAGGCCAAATAGATTCCGAGGGG|GCGTCTTCCAACCTGCTTTTCTATATGGCG
GGCGTCTTCCAACCTGCTACGAAGTAGGTT|TCCTAATTTTCTATATGGCGTCTTCCAACC
CGTCGCAAGTACCAATTTTCTATATGGCAA|CGGATCAGCGCCAACACGAGGTAAAGCACC
AATTTTCTATATGGCGTCTTCCAACCTGCT|TGCAATTCGGGCCAATAAATCGGAGAGACC
CTTCCAACCTGCTTTTCTATATGGCGTCTT|CAACCTGCTGCGTCTTCCAACCTGCTGACG
AGAATGCGCGCTCCCCGAAGTCAATCAAAG|AAGTAGGTTGTTGACCTGGATGCGCGGTGA
GTGTGCAAAGTTGTCTGGTTGTATGGCCTA|CTACTAAGATCTCTACGCTGACTCTCCATC
AATAGATTCCGAGGGGAGCAATCTGTCAGG|GCTTTTCTATATGGCGTCTTCCAACCTGCT
TCCTATGTGTGCAAAGTTGTCTGGTTGTAT|AGGTATCTACTAAGATCTCTACGCTGACTC
CGGTATAAATGCAATAATTTTCTATATGGC|TTTTCTATATGAATTTTCTATATGGCGTCT
TCTATATGGCGTCTTCCAACCTGCTATGAG|ATGCAATAATTTTCTATATGGCGTCTTCCA
GGCGTCTTCCAACCTGCTTTTAGCGTCGCA|AGGCTTTTAGTGGTTTTTCGGTTCGGATCA
GCAAAGATTCTATAACTTGTGGCCAATCGG|TATGGCGTCTTCCAACCTGCTCTCAGGGAC
ACTAGGGACCTTTCCGTCCGAAGCGAGGAT|CACGCTTCGCGGTAAAGCGCTCTAATTACG
GGCGTCTTCCAACCTGCTCAGCAAAGCCAT|TCACCAATTTTCTATATGGCGTCTTCCAAC
ATATGTACAATCAGAATGCGCGCTCCCCGA|CAACCTGCTACGAAGTAGGTTGTTGACCTG
GCAAGTACCAATTTTCTATATGGCAATTTT|TCAGCGCCAACACGAGGTAAAGCACCTGTA
AGCGCCAACACGAGGTAAAGCACCTGTATC|GGCGTCTTCCAACCTGCTTAGCCCCATACC
TCCAGTGCAAAGGTCCTATGTGTGCAAAGT|ACATTTTACGTAGAGGTATCTACTAAGATC
ACCTGCTATGAGGCCAAATAGATTCCGAGG|TGGCGTCTTCCAACCTGCTTTTCTATATGG
CAACACGAGGTAAAGCACCTGTATCGTAGC|CTTCCAACCTGCTTAGCCCCATACCCCCTA
AACCTGCTTAGCCCCATACCCCCTACGATG|GCAAAGGTCCTATGTGTGCAAAGTTGTCTG
TGCTGTTTCCTAGGCAGGCACAGATATCCT|GACCATGTGTGCAAAGATTCTATAACTTGT
ATCTGTCAGGAACGTAGCGTGTGATCACGT|CCAACCTGCTAATTTTCTATATGGCGTCTT
CTTCGCGGTAAAGCGCTCTAATTACGATCA|CTGCTGTCTTCCAACCTGCTCCATTGATTA
TATATGGCGTCTTCCAACCTGCTGTTTCCT|CGGGCCAATAAATCGGAGAGACCATGTGTG
GATGGTTTGTATGCGTACATGTCACGCTTC|CAATTTTCTATATGGCGTCTTCCAACCTGC
TGGAATTTTCTATATGGCGTCTTCCAACCT|GGGTGCAATTCGGGCCAATAAATCGGAGAG
AGATATCCTCGCAAATTTTCTATATGGCGT|ATAACTTGTGGCCAATCGGATTACGGGTTT
CCTGCTACGAAGTAGGTTGTTGACCTGGAT|ATATGGCGTCTTCCAACCTGCTTTTAGCGT
GTATCGTAGCACGGGTGTCTCTATAGACGC|ATACCCCCTACGATGGGGGAACCCGCAGGG
CAACCTGCTCCATTGATTATAACTATAGAT|AATTTTCTATATGGCGTCTTCCAACCTGCT
GCGTCTTCCAACCTGCTAATTTTCTATATG|GCTGACGGAGGGAGACGAATAGACCCGAAT
CACGGGTGTCTCTATAGACGCTGGAATTTT|ACGATGGGGGAACCCGCAGGGGGGTGCAAT
TCTATATGGCGTCTTCCAACCTGCTAATTT|TCCAACCTGCTGACGGAGGGAGACGAATAG
TCTATATGAATTTTCTATATGGCGTCTTCC|TCAGAATGCGCGCTCCCCGAAGTCAATCAA
GGTTGTTGACCTGGATGCGCGGTGATAACG|AACCTGCTTTTAGCGTCGCAAGTACCAATT
TATACGTACAAAAATGATGACCCGTTCATG|CCGAGGGGAGCAATCTGTCAGGAACGTAGC
CAATCAAAGTCCGTTGTGCGGTCAGGGTGC|GCGCGGTGATAACGCCCTCTGCAAGATGGT
TCTATATGGCGTCTTCCAACCTGCTGTTTC|TTCGGGCCAATAAATCGGAGAGACCATGTG
TATATGGCGTCTTCCAACCTGCTAATTTTC|CAACCTGCTGACGGAGGGAGACGAATAGAC
AATTTTCTATATGGCGTCTTCCAACCTGCT|AATAGACCCGAATCACCAATTTTCTATATG
TTTTAGCGTCGCAAGTACCAATTTTCTATA|TCGGTTCGGATCAGCGCCAACACGAGGTAA
ACGGGTTTCCAGTGCAAAGGTCCTATGTGT|GGGCCGGACATTTTACGTAGAGGTATCTAC
TACCCCCTACGATGGGGGAACCCGCAGGGG|TGCAAAGTTGTCTGGTTGTATGGCCTATCG
ATGCCCACCCCCAGGAGGCTTTTAGTGGTT|CTGTTTCCTAGGCAGGCACAGATATCCTCG
TAGACCCGAATCACCAATTTTCTATATGGC|TAGGGACCTTTCCGTCCGAAGCGAGGATAA
CTATATGGCGTCTTCCAACCTGCTTTTCTA|ATGGCGTCTTCCAACCTGCTGCGTCTTCCA
TTCCAACCTGCTGTCTTCCAACCTGCTCCA|TGTCTCTATAGACGCTGGAATTTTCTATAT
TGTGTGCAAAGATTCTATAACTTGTGGCCA|TTCTATATGGCGTCTTCCAACCTGCTCTCA
TCGGAGAGACCATGTGTGCAAAGATTCTAT|TATCGAGGAATTTTCTATATGGCGTCTTCC
TCTGCAAGATGGTTTGTATGCGTACATGTC|TATATGGCAATTTTCTATATGGCGTCTTCC
CGTACAAAAATGATGACCCGTTCATGACCC|GGGGAGCAATCTGTCAGGAACGTAGCGTGT
GGGCTTTGGCCTATACGTACAAAAATGATG|CCAAATAGATTCCGAGGGGAGCAATCTGTC
TGATAACGCCCTCTGCAAGATGGTTTGTAT|TACCAATTTTCTATATGGCAATTTTCTATA
TAATGGGCACTCTACGCCAAAGTTCAAATG|CTGCTCAGCAAAGCCATTCTCTACTGGGAC
GCCCTCTGCAAGATGGTTTGTATGCGTACA|TTTCTATATGGCAATTTTCTATATGGCGTC
CACGAGGTAAAGCACCTGTATCGTAGCACG|CCAACCTGCTTAGCCCCATACCCCCTACGA
CTTCCAACCTGCTGCGTCTTCCAACCTGCT|ATCAAAGTCCGTTGTGCGGTCAGGGTGCAT
ACCAATTTTCTATATGGCAATTTTCTATAT|CCAACACGAGGTAAAGCACCTGTATCGTAG
AGTGGTTTTTCGGTTCGGATCAGCGCCAAC|ATCCTCGCAAATTTTCTATATGGCGTCTTC
GACATGGCGACGACACGGGCTTTGGCCTAT|CCAACCTGCTATGAGGCCAAATAGATTCCG
ATGGCGTCTTCCAACCTGCTTTTGTCTTTA|CACTCTACGCCAAAGTTCAAATGTGACGGT
TGATCACGGTCAATACTAGTATGAGCGATG|CTAATGAATTTTCTATATGGCGTCTTCCAA
TTGTGGCCAATCGGATTACGGGTTTCCAGT|CTGCTCTCAGGGACTAAGGGCCGGACATTT
CGCCCTCTGCAAGATGGTTTGTATGCGTAC|TTTTCTATATGGCAATTTTCTATATGGCGT
TTTGGCCTATACGTACAAAAATGATGACCC|ATAGATTCCGAGGGGAGCAATCTGTCAGGA
TTCCAACCTGCTGCGTCTTCCAACCTGCTG|TCAAAGTCCGTTGTGCGGTCAGGGTGCATG
AAAGCGCTCTAATTACGATCACACCGACGT|TCCAACCTGCTCCATTGATTATAACTATAG
GTCACGCTTCGCGGTAAAGCGCTCTAATTA|TCCAACCTGCTGTCTTCCAACCTGCTCCAT
AGGTTGTTGACCTGGATGCGCGGTGATAAC|CAACCTGCTTTTAGCGTCGCAAGTACCAAT
CGCTGGAATTTTCTATATGGCGTCTTCCAA|GGGGGGTGCAATTCGGGCCAATAAATCGGA
TAGACGCTGGAATTTTCTATATGGCGTCTT|CGCAGGGGGGTGCAATTCGGGCCAATAAAT
GCCAATAAATCGGAGAGACCATGTGTGCAA|GATACATCCTATCGAGGAATTTTCTATATG
GCCAATCGGATTACGGGTTTCCAGTGCAAA|CTCAGGGACTAAGGGCCGGACATTTTACGT
AGGACTAGGGACCTTTCCGTCCGAAGCGAG|TGTCACGCTTCGCGGTAAAGCGCTCTAATT
TCAAATGTGACGGTATAAATGCAATAATTT|CTGGGACTAATTTTCTATATGAATTTTCTA
TCAGGAACGTAGCGTGTGATCACGTTTAAC|CTGCTAATTTTCTATATGGCGTCTTCCAAC
CAACCTGCTCAGCAAAGCCATTCTCTACTG|TTCTATATGGCGTCTTCCAACCTGCTTCGG
TTTTTCGGTTCGGATCAGCGCCAACACGAG|CGCAAATTTTCTATATGGCGTCTTCCAACC
TTTTCTATATGGCGTCTTCCAACCTGCTTA|TCGGATTACGGGTTTCCAGTGCAAAGGTCC
GGGGAACCCGCAGGGGGGTGCAATTCGGGC|GTTGTATGGCCTATCGTAGCATCATTCCGA
CAAAGTTGTCTGGTTGTATGGCCTATCGTA|AAGATCTCTACGCTGACTCTCCATCTGAGG
GCGTCGCAAGTACCAATTTTCTATATGGCA|TCGGATCAGCGCCAACACGAGGTAAAGCAC
ATAGACGCTGGAATTTTCTATATGGCGTCT|CCGCAGGGGGGTGCAATTCGGGCCAATAAA
CACCCCCAGGAGGCTTTTAGTGGTTTTTCG|TCCTAGGCAGGCACAGATATCCTCGCAAAT
ATGAGCGATGTACGCTCATTTCCCATCCCC|CGTCTTCCAACCTGCTTTTGTCTTTAATTT
CCAATCGGATTACGGGTTTCCAGTGCAAAG|TCAGGGACTAAGGGCCGGACATTTTACGTA
GACGTCCTAATTTTCTATATGGCGTCTTCC|TATAGATGCCCACCCCCAGGAGGCTTTTAG
TTACGGGTTTCCAGTGCAAAGGTCCTATGT|AAGGGCCGGACATTTTACGTAGAGGTATCT
TAGTGGTTTTTCGGTTCGGATCAGCGCCAA|TATCCTCGCAAATTTTCTATATGGCGTCTT
GCTACGAAGTAGGTTGTTGACCTGGATGCG|TGGCGTCTTCCAACCTGCTTTTAGCGTCGC
CGATGTACGCTCATTTCCCATCCCCCTTCC|TCCAACCTGCTTTTGTCTTTAATTTTCTAT
CGATCACACCGACGTCCTAATTTTCTATAT|TGATTATAACTATAGATGCCCACCCCCAGG
TATATGGCGTCTTCCAACCTGCTTTTGTCT|GGGCACTCTACGCCAAAGTTCAAATGTGAC
ATATGGCGTCTTCCAACCTGCTACGAAGTA|GACGTCCTAATTTTCTATATGGCGTCTTCC
CAGAATGCGCGCTCCCCGAAGTCAATCAAA|GAAGTAGGTTGTTGACCTGGATGCGCGGTG
CGGTAAAGCGCTCTAATTACGATCACACCG|GTCTTCCAACCTGCTCCATTGATTATAACT
TAGATGCCCACCCCCAGGAGGCTTTTAGTG|CTGCTGTTTCCTAGGCAGGCACAGATATCC
CTATATGGCGTCTTCCAACCTGCTATGAGG|TGCAATAATTTTCTATATGGCGTCTTCCAA
AACCTGCTATGAGGCCAAATAGATTCCGAG|ATGGCGTCTTCCAACCTGCTTTTCTATATG
GGATAATTTTCTATATGGCGTCTTCCAACC|TACGATCACACCGACGTCCTAATTTTCTAT
AGTATGAGCGATGTACGCTCATTTCCCATC|TGGCGTCTTCCAACCTGCTTTTGTCTTTAA
AAGCGCTCTAATTACGATCACACCGACGTC|CCAACCTGCTCCATTGATTATAACTATAGA
AACGTAGCGTGTGATCACGTTTAACTAATG|AATTTTCTATATGGCGTCTTCCAACCTGCT
CATGACCCGACACTAATGAATTTTCTATAT|TAGCGTGTGATCACGTTTAACTAATGGGCA
TCTTCCAACCTGCTTCGGATATGTACAATC|TTTCTATATGGCGTCTTCCAACCTGCTACG
GCCCACCCCCAGGAGGCTTTTAGTGGTTTT|GTTTCCTAGGCAGGCACAGATATCCTCGCA
AGGAACGTAGCGTGTGATCACGTTTAACTA|GCTAATTTTCTATATGGCGTCTTCCAACCT
GAACGTAGCGTGTGATCACGTTTAACTAAT|TAATTTTCTATATGGCGTCTTCCAACCTGC
TCTTCCAACCTGCTACGAAGTAGGTTGTTG|AATTTTCTATATGGCGTCTTCCAACCTGCT
GCAATTTTCTATATGGCGTCTTCCAACCTG|CACCTGTATCGTAGCACGGGTGTCTCTATA
GGACCTTTCCGTCCGAAGCGAGGATAATTT|TTCGCGGTAAAGCGCTCTAATTACGATCAC
GACGACACGGGCTTTGGCCTATACGTACAA|CTATGAGGCCAAATAGATTCCGAGGGGAGC
CCGTCCGAAGCGAGGATAATTTTCTATATG|AAAGCGCTCTAATTACGATCACACCGACGT
ATTTCCCATCCCCCTTCCGACGCGATTCGA|TTGTCTTTAATTTTCTATATGGCGTCTTCC
GACACTAATGAATTTTCTATATGGCGTCTT|GATCACGTTTAACTAATGGGCACTCTACGC
CTATGAGGCCAAATAGATTCCGAGGGGAGC|TCTTCCAACCTGCTTTTCTATATGGCGTCT
TACTAGTATGAGCGATGTACGCTCATTTCC|TATATGGCGTCTTCCAACCTGCTTTTGTCT
CTAATTACGATCACACCGACGTCCTAATTT|GCTCCATTGATTATAACTATAGATGCCCAC
GTACGCTCATTTCCCATCCCCCTTCCGACG|ACCTGCTTTTGTCTTTAATTTTCTATATGG
ACGGAGGGAGACGAATAGACCCGAATCACC|TTCTCAGGCCAGGACTAGGGACCTTTCCGT
CAATAAATCGGAGAGACCATGTGTGCAAAG|TACATCCTATCGAGGAATTTTCTATATGGC
TATAACTTGTGGCCAATCGGATTACGGGTT|TCCAACCTGCTCTCAGGGACTAAGGGCCGG
CCAACCTGCTCAGCAAAGCCATTCTCTACT|TTTCTATATGGCGTCTTCCAACCTGCTTCG
TCCGAAGCGAGGATAATTTTCTATATGGCG|GCGCTCTAATTACGATCACACCGACGTCCT
GCTCCGCAGATGATCACGGTCAATACTAGT|TGACCCGACACTAATGAATTTTCTATATGG
CGCTCCCCGAAGTCAATCAAAGTCCGTTGT|TGTTGACCTGGATGCGCGGTGATAACGCCC
ACGTCCTAATTTTCTATATGGCGTCTTCCA|ATAGATGCCCACCCCCAGGAGGCTTTTAGT
AACTTGTGGCCAATCGGATTACGGGTTTCC|AACCTGCTCTCAGGGACTAAGGGCCGGACA
CAAAGTCCGTTGTGCGGTCAGGGTGCATGT|GGTGATAACGCCCTCTGCAAGATGGTTTGT
ACGAATAGACCCGAATCACCAATTTTCTAT|AGGACTAGGGACCTTTCCGTCCGAAGCGAG
TGTCTGGTTGTATGGCCTATCGTAGCATCA|TCTACGCTGACTCTCCATCTGAGGGCTGAC
TGGGGGAACCCGCAGGGGGGTGCAATTCGG|TGGTTGTATGGCCTATCGTAGCATCATTCC
GTATGCGTACATGTCACGCTTCGCGGTAAA|TATATGGCGTCTTCCAACCTGCTGTCTTCC
CTTCCAACCTGCTTTTGTCTTTAATTTTCT|CGCCAAAGTTCAAATGTGACGGTATAAATG
GTGATAACGCCCTCTGCAAGATGGTTTGTA|GTACCAATTTTCTATATGGCAATTTTCTAT
TAGGTTGTTGACCTGGATGCGCGGTGATAA|CCAACCTGCTTTTAGCGTCGCAAGTACCAA
GGGACTAATTTTCTATATGAATTTTCTATA|GATATGTACAATCAGAATGCGCGCTCCCCG
ATTTTCTATATGGCGTCTTCCAACCTGCTA|TCACACCGACGTCCTAATTTTCTATATGGC
GAAGTAGGTTGTTGACCTGGATGCGCGGTG|TCTTCCAACCTGCTTTTAGCGTCGCAAGTA
TGAGCGATGTACGCTCATTTCCCATCCCCC|GTCTTCCAACCTGCTTTTGTCTTTAATTTT
ATTTTCTATATGGCAATTTTCTATATGGCG|CACGAGGTAAAGCACCTGTATCGTAGCACG
TCTATATGGCGTCTTCCAACCTGCTGCGTC|TCCCCGAAGTCAATCAAAGTCCGTTGTGCG
TCCAACCTGCTGCGTCTTCCAACCTGCTGA|CAAAGTCCGTTGTGCGGTCAGGGTGCATGT
AAGCGAGGATAATTTTCTATATGGCGTCTT|TCTAATTACGATCACACCGACGTCCTAATT
GCCAAAGTTCAAATGTGACGGTATAAATGC|ATTCTCTACTGGGACTAATTTTCTATATGA
TATAGATGCCCACCCCCAGGAGGCTTTTAG|ACCTGCTGTTTCCTAGGCAGGCACAGATAT
GACTAGGGACCTTTCCGTCCGAAGCGAGGA|TCACGCTTCGCGGTAAAGCGCTCTAATTAC
GTGCAAAGTTGTCTGGTTGTATGGCCTATC|ACTAAGATCTCTACGCTGACTCTCCATCTG
CCAACCTGCTTTTGTCTTTAATTTTCTATA|CAAAGTTCAAATGTGACGGTATAAATGCAA
CTAATTTTCTATATGGCGTCTTCCAACCTG|CGAATAGACCCGAATCACCAATTTTCTATA
GATTACGGGTTTCCAGTGCAAAGGTCCTAT|CTAAGGGCCGGACATTTTACGTAGAGGTAT
CTGCTGTCTTCCAACCTGCTCCATTGATTA|ATAGACGCTGGAATTTTCTATATGGCGTCT
TTTTCTATATGGCGTCTTCCAACCTGCTTT|CTAATGGGCACTCTACGCCAAAGTTCAAAT
AACCTGCTTCGGATATGTACAATCAGAATG|TATGGCGTCTTCCAACCTGCTACGAAGTAG
ATTCCGAGGGGAGCAATCTGTCAGGAACGT|TCTATATGGCGTCTTCCAACCTGCTAATTT
CAGGAGGCTTTTAGTGGTTTTTCGGTTCGG|GCAGGCACAGATATCCTCGCAAATTTTCTA
CGTCTTCCAACCTGCTTCGGATATGTACAA|ATTTTCTATATGGCGTCTTCCAACCTGCTA
ATGGCGTCTTCCAACCTGCTTCGGATATGT|GATAATTTTCTATATGGCGTCTTCCAACCT
GATAACGCCCTCTGCAAGATGGTTTGTATG|ACCAATTTTCTATATGGCAATTTTCTATAT
TATGCGTACATGTCACGCTTCGCGGTAAAG|ATATGGCGTCTTCCAACCTGCTGTCTTCCA
ACTAATGAATTTTCTATATGGCGTCTTCCA|CACGTTTAACTAATGGGCACTCTACGCCAA
CAACCTGCTTTTCTATATGGCGTCTTCCAA|CTGCTGCGTCTTCCAACCTGCTGACGGAGG
GGATCAGCGCCAACACGAGGTAAAGCACCT|TATATGGCGTCTTCCAACCTGCTTAGCCCC
TGACCCGTTCATGACCCGACACTAATGAAT|TCAGGAACGTAGCGTGTGATCACGTTTAAC
CTCAGCAAAGCCATTCTCTACTGGGACTAA|TGGCGTCTTCCAACCTGCTTCGGATATGTA
ACCCCCTACGATGGGGGAACCCGCAGGGGG|GCAAAGTTGTCTGGTTGTATGGCCTATCGT
CGAGGTAAAGCACCTGTATCGTAGCACGGG|AACCTGCTTAGCCCCATACCCCCTACGATG
AAGTTGTCTGGTTGTATGGCCTATCGTAGC|GATCTCTACGCTGACTCTCCATCTGAGGGC
CGTACATGTCACGCTTCGCGGTAAAGCGCT|GGCGTCTTCCAACCTGCTGTCTTCCAACCT
ACGCTCATTTCCCATCCCCCTTCCGACGCG|CTGCTTTTGTCTTTAATTTTCTATATGGCG
TCTAATTACGATCACACCGACGTCCTAATT|TGCTCCATTGATTATAACTATAGATGCCCA
CCAATTTTCTATATGGCAATTTTCTATATG|CAACACGAGGTAAAGCACCTGTATCGTAGC
TCAGGGTGCATGTTCTCAGGCCAGGACTAG|CAAGATGGTTTGTATGCGTACATGTCACGC
ATCGGATTACGGGTTTCCAGTGCAAAGGTC|GGGACTAAGGGCCGGACATTTTACGTAGAG
CTTCCAACCTGCTATGAGGCCAAATAGATT|TCTATATGGCGTCTTCCAACCTGCTTTTCT
CCAACCTGCTGTTTCCTAGGCAGGCACAGA|CGGAGAGACCATGTGTGCAAAGATTCTATA
CATTTCCCATCCCCCTTCCGACGCGATTCG|TTTGTCTTTAATTTTCTATATGGCGTCTTC
CACAGATATCCTCGCAAATTTTCTATATGG|TCTATAACTTGTGGCCAATCGGATTACGGG
CTTCCAACCTGCTGACGGAGGGAGACGAAT|GGTCAGGGTGCATGTTCTCAGGCCAGGACT
TGCGCGGTGATAACGCCCTCTGCAAGATGG|TCGCAAGTACCAATTTTCTATATGGCAATT
TCTCAGGCCAGGACTAGGGACCTTTCCGTC|ATGCGTACATGTCACGCTTCGCGGTAAAGC
TGGCGTCTTCCAACCTGCTACGAAGTAGGT|GTCCTAATTTTCTATATGGCGTCTTCCAAC
CAGGCTCCGCAGATGATCACGGTCAATACT|TCATGACCCGACACTAATGAATTTTCTATA
CCAACCTGCTTCGGATATGTACAATCAGAA|TATATGGCGTCTTCCAACCTGCTACGAAGT
GCCAAATAGATTCCGAGGGGAGCAATCTGT|ACCTGCTTTTCTATATGGCGTCTTCCAACC
GTAAAGCACCTGTATCGTAGCACGGGTGTC|TGCTTAGCCCCATACCCCCTACGATGGGGG
CAAATAGATTCCGAGGGGAGCAATCTGTCA|CTGCTTTTCTATATGGCGTCTTCCAACCTG
GCTTTTAGTGGTTTTTCGGTTCGGATCAGC|ACAGATATCCTCGCAAATTTTCTATATGGC
GCAAGATGGTTTGTATGCGTACATGTCACG|ATGGCAATTTTCTATATGGCGTCTTCCAAC
CGGATATGTACAATCAGAATGCGCGCTCCC|TTCCAACCTGCTACGAAGTAGGTTGTTGAC
ACTGGGACTAATTTTCTATATGAATTTTCT|TCGGATATGTACAATCAGAATGCGCGCTCC
GCGTCTTCCAACCTGCTTCGGATATGTACA|AATTTTCTATATGGCGTCTTCCAACCTGCT
TTTCCTAGGCAGGCACAGATATCCTCGCAA|TGTGTGCAAAGATTCTATAACTTGTGGCCA
CGCAAATTTTCTATATGGCGTCTTCCAACC|GGCCAATCGGATTACGGGTTTCCAGTGCAA
TAACTATAGATGCCCACCCCCAGGAGGCTT|TCCAACCTGCTGTTTCCTAGGCAGGCACAG
GCTGTCTTCCAACCTGCTCCATTGATTATA|AGACGCTGGAATTTTCTATATGGCGTCTTC
ATGGCGTCTTCCAACCTGCTGTCTTCCAAC|AGCACGGGTGTCTCTATAGACGCTGGAATT
TTTTCTATATGGCGTCTTCCAACCTGCTTC|GAAGCGAGGATAATTTTCTATATGGCGTCT
TTTTCGGTTCGGATCAGCGCCAACACGAGG|GCAAATTTTCTATATGGCGTCTTCCAACCT
GCGTCTTCCAACCTGCTTAGCCCCATACCC|GTTTCCAGTGCAAAGGTCCTATGTGTGCAA
ATGAATTTTCTATATGGCGTCTTCCAACCT|ATGCGCGCTCCCCGAAGTCAATCAAAGTCC
TCAATCAAAGTCCGTTGTGCGGTCAGGGTG|TGCGCGGTGATAACGCCCTCTGCAAGATGG
TTCTATATGAATTTTCTATATGGCGTCTTC|ATCAGAATGCGCGCTCCCCGAAGTCAATCA
GCGGTAAAGCGCTCTAATTACGATCACACC|TGTCTTCCAACCTGCTCCATTGATTATAAC
TTTTCTATATGGCGTCTTCCAACCTGCTAA|TCTTCCAACCTGCTGACGGAGGGAGACGAA
CGTCTTCCAACCTGCTGCGTCTTCCAACCT|TCAATCAAAGTCCGTTGTGCGGTCAGGGTG
AGACCATGTGTGCAAAGATTCTATAACTTG|GGAATTTTCTATATGGCGTCTTCCAACCTG
TGCGGTCAGGGTGCATGTTCTCAGGCCAGG|CTCTGCAAGATGGTTTGTATGCGTACATGT
GCAGGGGGGTGCAATTCGGGCCAATAAATC|CCTATCGTAGCATCATTCCGATACATCCTA
TTTTCTATATGGCGTCTTCCAACCTGCTGT|CAATTCGGGCCAATAAATCGGAGAGACCAT
GTCCGTTGTGCGGTCAGGGTGCATGTTCTC|ATAACGCCCTCTGCAAGATGGTTTGTATGC
AGCAAAGCCATTCTCTACTGGGACTAATTT|CGTCTTCCAACCTGCTTCGGATATGTACAA
CAATCAGAATGCGCGCTCCCCGAAGTCAAT|CTACGAAGTAGGTTGTTGACCTGGATGCGC
GTCTTCCAACCTGCTTTTGTCTTTAATTTT|TACGCCAAAGTTCAAATGTGACGGTATAAA
TATGTGTGCAAAGTTGTCTGGTTGTATGGC|TATCTACTAAGATCTCTACGCTGACTCTCC
ATGTACAATCAGAATGCGCGCTCCCCGAAG|ACCTGCTACGAAGTAGGTTGTTGACCTGGA
TGCTAATTTTCTATATGGCGTCTTCCAACC|GACGAATAGACCCGAATCACCAATTTTCTA
GAGAGACCATGTGTGCAAAGATTCTATAAC|CGAGGAATTTTCTATATGGCGTCTTCCAAC
TGGCGTCTTCCAACCTGCTCAGCAAAGCCA|ATCACCAATTTTCTATATGGCGTCTTCCAA
ATTTTCTATATGGCGTCTTCCAACCTGCTT|CGAAGCGAGGATAATTTTCTATATGGCGTC
AAATAGATTCCGAGGGGAGCAATCTGTCAG|TGCTTTTCTATATGGCGTCTTCCAACCTGC
GTACATGTCACGCTTCGCGGTAAAGCGCTC|GCGTCTTCCAACCTGCTGTCTTCCAACCTG
GGCAGGCACAGATATCCTCGCAAATTTTCT|AAAGATTCTATAACTTGTGGCCAATCGGAT
TACGAAGTAGGTTGTTGACCTGGATGCGCG|GCGTCTTCCAACCTGCTTTTAGCGTCGCAA
CCAGTGCAAAGGTCCTATGTGTGCAAAGTT|CATTTTACGTAGAGGTATCTACTAAGATCT
CGCGATTCGACATGGCGACGACACGGGCTT|GGCGTCTTCCAACCTGCTATGAGGCCAAAT
ACGCCCTCTGCAAGATGGTTTGTATGCGTA|ATTTTCTATATGGCAATTTTCTATATGGCG
ACCTGGATGCGCGGTGATAACGCCCTCTGC|TTTAGCGTCGCAAGTACCAATTTTCTATAT
TTCCGACGCGATTCGACATGGCGACGACAC|CTATATGGCGTCTTCCAACCTGCTATGAGG
GTACAAAAATGATGACCCGTTCATGACCCG|GGGAGCAATCTGTCAGGAACGTAGCGTGTG
GCACTCTACGCCAAAGTTCAAATGTGACGG|AGCAAAGCCATTCTCTACTGGGACTAATTT
TATATGGCGTCTTCCAACCTGCTACGAAGT|CGACGTCCTAATTTTCTATATGGCGTCTTC
CTGTCTTCCAACCTGCTCCATTGATTATAA|GACGCTGGAATTTTCTATATGGCGTCTTCC
GCGTCTTCCAACCTGCTACGAAGTAGGTTG|CCTAATTTTCTATATGGCGTCTTCCAACCT
TTCGGGCCAATAAATCGGAGAGACCATGTG|ATTCCGATACATCCTATCGAGGAATTTTCT
GCGAGGATAATTTTCTATATGGCGTCTTCC|TAATTACGATCACACCGACGTCCTAATTTT
TGGCAATTTTCTATATGGCGTCTTCCAACC|AGCACCTGTATCGTAGCACGGGTGTCTCTA
GGGGGGTGCAATTCGGGCCAATAAATCGGA|ATCGTAGCATCATTCCGATACATCCTATCG
GCTCCCCGAAGTCAATCAAAGTCCGTTGTG|GTTGACCTGGATGCGCGGTGATAACGCCCT
TCGGGCCAATAAATCGGAGAGACCATGTGT|TTCCGATACATCCTATCGAGGAATTTTCTA
ACCATGTGTGCAAAGATTCTATAACTTGTG|AATTTTCTATATGGCGTCTTCCAACCTGCT
TTCCAACCTGCTGTTTCCTAGGCAGGCACA|ATCGGAGAGACCATGTGTGCAAAGATTCTA
TCCAACCTGCTACGAAGTAGGTTGTTGACC|TTTCTATATGGCGTCTTCCAACCTGCTTTT
ACGTTTAACTAATGGGCACTCTACGCCAAA|TCTTCCAACCTGCTCAGCAAAGCCATTCTC
AGGCACAGATATCCTCGCAAATTTTCTATA|GATTCTATAACTTGTGGCCAATCGGATTAC
CAACCTGCTGTCTTCCAACCTGCTCCATTG|CTCTATAGACGCTGGAATTTTCTATATGGC
ATAGATTCCGAGGGGAGCAATCTGTCAGGA|CTTTTCTATATGGCGTCTTCCAACCTGCTA
TGTGCAAAGTTGTCTGGTTGTATGGCCTAT|TACTAAGATCTCTACGCTGACTCTCCATCT
TTCTATATGGCAATTTTCTATATGGCGTCT|GAGGTAAAGCACCTGTATCGTAGCACGGGT
GTCAGGAACGTAGCGTGTGATCACGTTTAA|CCTGCTAATTTTCTATATGGCGTCTTCCAA
ATGGGCACTCTACGCCAAAGTTCAAATGTG|GCTCAGCAAAGCCATTCTCTACTGGGACTA
TGGCGTCTTCCAACCTGCTGTCTTCCAACC|GCACGGGTGTCTCTATAGACGCTGGAATTT
CTCTAATTACGATCACACCGACGTCCTAAT|CTGCTCCATTGATTATAACTATAGATGCCC
GACGCGATTCGACATGGCGACGACACGGGC|ATGGCGTCTTCCAACCTGCTATGAGGCCAA
CGTCCTAATTTTCTATATGGCGTCTTCCAA|TAGATGCCCACCCCCAGGAGGCTTTTAGTG
GACCTTTCCGTCCGAAGCGAGGATAATTTT|TCGCGGTAAAGCGCTCTAATTACGATCACA
CTGGAATTTTCTATATGGCGTCTTCCAACC|GGGGTGCAATTCGGGCCAATAAATCGGAGA
AAAGTTGTCTGGTTGTATGGCCTATCGTAG|AGATCTCTACGCTGACTCTCCATCTGAGGG
CCCCGAAGTCAATCAAAGTCCGTTGTGCGG|GACCTGGATGCGCGGTGATAACGCCCTCTG
GGTGATAACGCCCTCTGCAAGATGGTTTGT|AGTACCAATTTTCTATATGGCAATTTTCTA
TTCCAGTGCAAAGGTCCTATGTGTGCAAAG|GACATTTTACGTAGAGGTATCTACTAAGAT
TTTAATTTTCTATATGGCGTCTTCCAACCT|CGGTATAAATGCAATAATTTTCTATATGGC
ACGGTCAATACTAGTATGAGCGATGTACGC|GAATTTTCTATATGGCGTCTTCCAACCTGC
TACGCTCATTTCCCATCCCCCTTCCGACGC|CCTGCTTTTGTCTTTAATTTTCTATATGGC
AAGTAGGTTGTTGACCTGGATGCGCGGTGA|CTTCCAACCTGCTTTTAGCGTCGCAAGTAC
CATACCCCCTACGATGGGGGAACCCGCAGG|TGTGCAAAGTTGTCTGGTTGTATGGCCTAT
ATATGGCGTCTTCCAACCTGCTTCGGATAT|AGGATAATTTTCTATATGGCGTCTTCCAAC
TTTGTCTTTAATTTTCTATATGGCGTCTTC|ATGTGACGGTATAAATGCAATAATTTTCTA
GCGCTCTAATTACGATCACACCGACGTCCT|AACCTGCTCCATTGATTATAACTATAGATG
TGAATTTTCTATATGGCGTCTTCCAACCTG|TTAACTAATGGGCACTCTACGCCAAAGTTC
TTAACTAATGGGCACTCTACGCCAAAGTTC|CCAACCTGCTCAGCAAAGCCATTCTCTACT
TCTATAGACGCTGGAATTTTCTATATGGCG|AACCCGCAGGGGGGTGCAATTCGGGCCAAT
CCCCTACGATGGGGGAACCCGCAGGGGGGT|AAAGTTGTCTGGTTGTATGGCCTATCGTAG
AACCTGCTGTCTTCCAACCTGCTCCATTGA|TCTATAGACGCTGGAATTTTCTATATGGCG
TTCTATATGGCGTCTTCCAACCTGCTTAGC|GGATTACGGGTTTCCAGTGCAAAGGTCCTA
CGACGTCCTAATTTTCTATATGGCGTCTTC|CTATAGATGCCCACCCCCAGGAGGCTTTTA
CCTGCTTCGGATATGTACAATCAGAATGCG|TGGCGTCTTCCAACCTGCTACGAAGTAGGT
AATTTTCTATATGGCGTCTTCCAACCTGCT|TATAAATGCAATAATTTTCTATATGGCGTC
CCAACCTGCTACGAAGTAGGTTGTTGACCT|TTCTATATGGCGTCTTCCAACCTGCTTTTA
GCGCTCCCCGAAGTCAATCAAAGTCCGTTG|TTGTTGACCTGGATGCGCGGTGATAACGCC
ACCTGTATCGTAGCACGGGTGTCTCTATAG|CCCCATACCCCCTACGATGGGGGAACCCGC
GATCACGGTCAATACTAGTATGAGCGATGT|TAATGAATTTTCTATATGGCGTCTTCCAAC
ATTTTCTATATGGCGTCTTCCAACCTGCTT|ATCGGATTACGGGTTTCCAGTGCAAAGGTC
CTATGTGTGCAAAGTTGTCTGGTTGTATGG|GTATCTACTAAGATCTCTACGCTGACTCTC
GGCGTCTTCCAACCTGCTTAGCCCCATACC|GGTTTCCAGTGCAAAGGTCCTATGTGTGCA
TAATTTTCTATATGGCGTCTTCCAACCTGC|GTATAAATGCAATAATTTTCTATATGGCGT
ATGGCGTCTTCCAACCTGCTATGAGGCCAA|ATAATTTTCTATATGGCGTCTTCCAACCTG
CTGCTCAGCAAAGCCATTCTCTACTGGGAC|ATATGGCGTCTTCCAACCTGCTTCGGATAT
ATATGGCGTCTTCCAACCTGCTGTTTCCTA|GGGCCAATAAATCGGAGAGACCATGTGTGC
TAAAGCGCTCTAATTACGATCACACCGACG|TTCCAACCTGCTCCATTGATTATAACTATA
CTACTGGGACTAATTTTCTATATGAATTTT|CTTCGGATATGTACAATCAGAATGCGCGCT
CAAAGGTCCTATGTGTGCAAAGTTGTCTGG|ACGTAGAGGTATCTACTAAGATCTCTACGC
CTTTTGTCTTTAATTTTCTATATGGCGTCT|AAATGTGACGGTATAAATGCAATAATTTTC
GGCTTTTAGTGGTTTTTCGGTTCGGATCAG|CACAGATATCCTCGCAAATTTTCTATATGG
TGGCGTCTTCCAACCTGCTATGAGGCCAAA|TAATTTTCTATATGGCGTCTTCCAACCTGC
ATGTGTGCAAAGTTGTCTGGTTGTATGGCC|ATCTACTAAGATCTCTACGCTGACTCTCCA
ATGTACGCTCATTTCCCATCCCCCTTCCGA|CAACCTGCTTTTGTCTTTAATTTTCTATAT
TGCCCACCCCCAGGAGGCTTTTAGTGGTTT|TGTTTCCTAGGCAGGCACAGATATCCTCGC
TCCTAGGCAGGCACAGATATCCTCGCAAAT|TGTGCAAAGATTCTATAACTTGTGGCCAAT
TCCAACCTGCTGACGGAGGGAGACGAATAG|TCAGGGTGCATGTTCTCAGGCCAGGACTAG
CGGATTACGGGTTTCCAGTGCAAAGGTCCT|GACTAAGGGCCGGACATTTTACGTAGAGGT
TCCGAGGGGAGCAATCTGTCAGGAACGTAG|TATATGGCGTCTTCCAACCTGCTAATTTTC
CTATATGGCAATTTTCTATATGGCGTCTTC|GGTAAAGCACCTGTATCGTAGCACGGGTGT
TCTTTAATTTTCTATATGGCGTCTTCCAAC|GACGGTATAAATGCAATAATTTTCTATATG
CGGTTCGGATCAGCGCCAACACGAGGTAAA|ATTTTCTATATGGCGTCTTCCAACCTGCTT
TAGCCCCATACCCCCTACGATGGGGGAACC|CCTATGTGTGCAAAGTTGTCTGGTTGTATG
GTAGCACGGGTGTCTCTATAGACGCTGGAA|CCCTACGATGGGGGAACCCGCAGGGGGGTG
TCACACCGACGTCCTAATTTTCTATATGGC|TTATAACTATAGATGCCCACCCCCAGGAGG
TATGAGCGATGTACGCTCATTTCCCATCCC|GCGTCTTCCAACCTGCTTTTGTCTTTAATT
ACGCGATTCGACATGGCGACGACACGGGCT|TGGCGTCTTCCAACCTGCTATGAGGCCAAA
GGGGTGCAATTCGGGCCAATAAATCGGAGA|CGTAGCATCATTCCGATACATCCTATCGAG
CAAATGTGACGGTATAAATGCAATAATTTT|TGGGACTAATTTTCTATATGAATTTTCTAT
ATTCTCTACTGGGACTAATTTTCTATATGA|ACCTGCTTCGGATATGTACAATCAGAATGC
TGCTACGAAGTAGGTTGTTGACCTGGATGC|ATGGCGTCTTCCAACCTGCTTTTAGCGTCG
TCTTCCAACCTGCTCAGCAAAGCCATTCTC|CAATTTTCTATATGGCGTCTTCCAACCTGC
ATTCTATAACTTGTGGCCAATCGGATTACG|GTCTTCCAACCTGCTCTCAGGGACTAAGGG
CGCCAACACGAGGTAAAGCACCTGTATCGT|CGTCTTCCAACCTGCTTAGCCCCATACCCC
TCCGTCCGAAGCGAGGATAATTTTCTATAT|TAAAGCGCTCTAATTACGATCACACCGACG
GTCTTCCAACCTGCTGTTTCCTAGGCAGGC|TAAATCGGAGAGACCATGTGTGCAAAGATT
TGTTTCCTAGGCAGGCACAGATATCCTCGC|CATGTGTGCAAAGATTCTATAACTTGTGGC
AATCAAAGTCCGTTGTGCGGTCAGGGTGCA|CGCGGTGATAACGCCCTCTGCAAGATGGTT
TCTACGCCAAAGTTCAAATGTGACGGTATA|AAGCCATTCTCTACTGGGACTAATTTTCTA
AAGTCAATCAAAGTCCGTTGTGCGGTCAGG|GGATGCGCGGTGATAACGCCCTCTGCAAGA
CGTTGTGCGGTCAGGGTGCATGTTCTCAGG|ACGCCCTCTGCAAGATGGTTTGTATGCGTA
CACTCTACGCCAAAGTTCAAATGTGACGGT|GCAAAGCCATTCTCTACTGGGACTAATTTT
GTACCAATTTTCTATATGGCAATTTTCTAT|CGCCAACACGAGGTAAAGCACCTGTATCGT
TCGCAAGTACCAATTTTCTATATGGCAATT|GATCAGCGCCAACACGAGGTAAAGCACCTG
AATGTGACGGTATAAATGCAATAATTTTCT|GGACTAATTTTCTATATGAATTTTCTATAT
TTCTATATGGCGTCTTCCAACCTGCTGTCT|TATCGTAGCACGGGTGTCTCTATAGACGCT
TGTGCGGTCAGGGTGCATGTTCTCAGGCCA|CCCTCTGCAAGATGGTTTGTATGCGTACAT
TTCCAACCTGCTTCGGATATGTACAATCAG|TCTATATGGCGTCTTCCAACCTGCTACGAA
TCACGTTTAACTAATGGGCACTCTACGCCA|CGTCTTCCAACCTGCTCAGCAAAGCCATTC
TTAATTTTCTATATGGCGTCTTCCAACCTG|GGTATAAATGCAATAATTTTCTATATGGCG
GCGTCTTCCAACCTGCTATGAGGCCAAATA|ATTTTCTATATGGCGTCTTCCAACCTGCTT
CAACCTGCTACGAAGTAGGTTGTTGACCTG|TCTATATGGCGTCTTCCAACCTGCTTTTAG
AACCTGCTCCATTGATTATAACTATAGATG|ATTTTCTATATGGCGTCTTCCAACCTGCTG
TTCTATATGGCGTCTTCCAACCTGCTGTTT|ATTCGGGCCAATAAATCGGAGAGACCATGT
GGAGCAATCTGTCAGGAACGTAGCGTGTGA|CGTCTTCCAACCTGCTAATTTTCTATATGG
TTGACCTGGATGCGCGGTGATAACGCCCTC|GCTTTTAGCGTCGCAAGTACCAATTTTCTA
GTCAATACTAGTATGAGCGATGTACGCTCA|TTTTCTATATGGCGTCTTCCAACCTGCTTT
GCTTTTGTCTTTAATTTTCTATATGGCGTC|CAAATGTGACGGTATAAATGCAATAATTTT
TATCCTCGCAAATTTTCTATATGGCGTCTT|ACTTGTGGCCAATCGGATTACGGGTTTCCA
TGGCGTCTTCCAACCTGCTGTTTCCTAGGC|CCAATAAATCGGAGAGACCATGTGTGCAAA
CTTTCCGTCCGAAGCGAGGATAATTTTCTA|CGGTAAAGCGCTCTAATTACGATCACACCG
TAGCGTGTGATCACGTTTAACTAATGGGCA|TTCTATATGGCGTCTTCCAACCTGCTCAGC
CAACCTGCTAATTTTCTATATGGCGTCTTC|AGGGAGACGAATAGACCCGAATCACCAATT
AGCAATCTGTCAGGAACGTAGCGTGTGATC|TCTTCCAACCTGCTAATTTTCTATATGGCG
GTCTTCCAACCTGCTTTTCTATATGGCGTC|TCCAACCTGCTGCGTCTTCCAACCTGCTGA
GGTGCAATTCGGGCCAATAAATCGGAGAGA|TAGCATCATTCCGATACATCCTATCGAGGA
TATGGCGTCTTCCAACCTGCTACGAAGTAG|ACGTCCTAATTTTCTATATGGCGTCTTCCA
ATACCCCCTACGATGGGGGAACCCGCAGGG|GTGCAAAGTTGTCTGGTTGTATGGCCTATC
TAAATCGGAGAGACCATGTGTGCAAAGATT|ATCCTATCGAGGAATTTTCTATATGGCGTC
TGCGTACATGTCACGCTTCGCGGTAAAGCG|ATGGCGTCTTCCAACCTGCTGTCTTCCAAC
GAGGTAAAGCACCTGTATCGTAGCACGGGT|ACCTGCTTAGCCCCATACCCCCTACGATGG
TACAATCAGAATGCGCGCTCCCCGAAGTCA|TGCTACGAAGTAGGTTGTTGACCTGGATGC
GGTTCGGATCAGCGCCAACACGAGGTAAAG|TTTTCTATATGGCGTCTTCCAACCTGCTTA
TAGCACGGGTGTCTCTATAGACGCTGGAAT|CCTACGATGGGGGAACCCGCAGGGGGGTGC
CAGATGATCACGGTCAATACTAGTATGAGC|GACACTAATGAATTTTCTATATGGCGTCTT
GAGCGATGTACGCTCATTTCCCATCCCCCT|TCTTCCAACCTGCTTTTGTCTTTAATTTTC
CTATAACTTGTGGCCAATCGGATTACGGGT|TTCCAACCTGCTCTCAGGGACTAAGGGCCG
CCACCCCCAGGAGGCTTTTAGTGGTTTTTC|TTCCTAGGCAGGCACAGATATCCTCGCAAA
TCCCCCTTCCGACGCGATTCGACATGGCGA|AATTTTCTATATGGCGTCTTCCAACCTGCT
TAACGCCCTCTGCAAGATGGTTTGTATGCG|CAATTTTCTATATGGCAATTTTCTATATGG
AACTAATGGGCACTCTACGCCAAAGTTCAA|AACCTGCTCAGCAAAGCCATTCTCTACTGG
CTTTGGCCTATACGTACAAAAATGATGACC|AATAGATTCCGAGGGGAGCAATCTGTCAGG
CACCGACGTCCTAATTTTCTATATGGCGTC|TAACTATAGATGCCCACCCCCAGGAGGCTT
CCTGCTCAGCAAAGCCATTCTCTACTGGGA|TATATGGCGTCTTCCAACCTGCTTCGGATA
CGGGTGTCTCTATAGACGCTGGAATTTTCT|GATGGGGGAACCCGCAGGGGGGTGCAATTC
CGCCAAAGTTCAAATGTGACGGTATAAATG|CATTCTCTACTGGGACTAATTTTCTATATG
GTCTTCCAACCTGCTGCGTCTTCCAACCTG|CAATCAAAGTCCGTTGTGCGGTCAGGGTGC
ATCCTCGCAAATTTTCTATATGGCGTCTTC|CTTGTGGCCAATCGGATTACGGGTTTCCAG
ACCGACGTCCTAATTTTCTATATGGCGTCT|AACTATAGATGCCCACCCCCAGGAGGCTTT
TGCAAGATGGTTTGTATGCGTACATGTCAC|TATGGCAATTTTCTATATGGCGTCTTCCAA
ATTTTCTATATGGCGTCTTCCAACCTGCTT|ACTAATGGGCACTCTACGCCAAAGTTCAAA
ATAACGCCCTCTGCAAGATGGTTTGTATGC|CCAATTTTCTATATGGCAATTTTCTATATG
TCGCGGTAAAGCGCTCTAATTACGATCACA|GCTGTCTTCCAACCTGCTCCATTGATTATA
CTTCCAACCTGCTTCGGATATGTACAATCA|TTCTATATGGCGTCTTCCAACCTGCTACGA
GCACGGGTGTCTCTATAGACGCTGGAATTT|TACGATGGGGGAACCCGCAGGGGGGTGCAA
CCTTTCCGTCCGAAGCGAGGATAATTTTCT|GCGGTAAAGCGCTCTAATTACGATCACACC
AACCTGCTGACGGAGGGAGACGAATAGACC|GGGTGCATGTTCTCAGGCCAGGACTAGGGA
AACCTGCTCAGCAAAGCCATTCTCTACTGG|TCTATATGGCGTCTTCCAACCTGCTTCGGA
ATTACGGGTTTCCAGTGCAAAGGTCCTATG|TAAGGGCCGGACATTTTACGTAGAGGTATC
ATATGGCGTCTTCCAACCTGCTAATTTTCT|AACCTGCTGACGGAGGGAGACGAATAGACC
TTTCCAGTGCAAAGGTCCTATGTGTGCAAA|GGACATTTTACGTAGAGGTATCTACTAAGA
TCCAACCTGCTTTTGTCTTTAATTTTCTAT|CCAAAGTTCAAATGTGACGGTATAAATGCA
AATAGACCCGAATCACCAATTTTCTATATG|ACTAGGGACCTTTCCGTCCGAAGCGAGGAT
ATTTTCTATATGGCGTCTTCCAACCTGCTT|TCTATATGGCGTCTTCCAACCTGCTGCGTC
CCAACCTGCTTTTCTATATGGCGTCTTCCA|CCTGCTGCGTCTTCCAACCTGCTGACGGAG
GCTGACGGAGGGAGACGAATAGACCCGAAT|CATGTTCTCAGGCCAGGACTAGGGACCTTT
AGGGGGGTGCAATTCGGGCCAATAAATCGG|TATCGTAGCATCATTCCGATACATCCTATC
TTTTCTATATGGCGTCTTCCAACCTGCTAC|CACACCGACGTCCTAATTTTCTATATGGCG
ATGGCGTCTTCCAACCTGCTGCGTCTTCCA|GAAGTCAATCAAAGTCCGTTGTGCGGTCAG
GTCTTCCAACCTGCTTAGCCCCATACCCCC|TTCCAGTGCAAAGGTCCTATGTGTGCAAAG
GCTGGAATTTTCTATATGGCGTCTTCCAAC|GGGGGTGCAATTCGGGCCAATAAATCGGAG
CGAAGTAGGTTGTTGACCTGGATGCGCGGT|GTCTTCCAACCTGCTTTTAGCGTCGCAAGT
CGTCCGAAGCGAGGATAATTTTCTATATGG|AAGCGCTCTAATTACGATCACACCGACGTC
GGCCAAATAGATTCCGAGGGGAGCAATCTG|AACCTGCTTTTCTATATGGCGTCTTCCAAC
ATCGTAGCACGGGTGTCTCTATAGACGCTG|ACCCCCTACGATGGGGGAACCCGCAGGGGG
AATTTTCTATATGGCAATTTTCTATATGGC|ACACGAGGTAAAGCACCTGTATCGTAGCAC
TATGGCGTCTTCCAACCTGCTATGAGGCCA|AATAATTTTCTATATGGCGTCTTCCAACCT
AGGGTGCATGTTCTCAGGCCAGGACTAGGG|AGATGGTTTGTATGCGTACATGTCACGCTT
CATCCCCCTTCCGACGCGATTCGACATGGC|TTAATTTTCTATATGGCGTCTTCCAACCTG
GCCCCATACCCCCTACGATGGGGGAACCCG|TATGTGTGCAAAGTTGTCTGGTTGTATGGC
CGTCTTCCAACCTGCTACGAAGTAGGTTGT|CTAATTTTCTATATGGCGTCTTCCAACCTG
GACGGAGGGAGACGAATAGACCCGAATCAC|GTTCTCAGGCCAGGACTAGGGACCTTTCCG
ATATGGCGTCTTCCAACCTGCTTTTGTCTT|GGCACTCTACGCCAAAGTTCAAATGTGACG
ATAACTTGTGGCCAATCGGATTACGGGTTT|CCAACCTGCTCTCAGGGACTAAGGGCCGGA
CGATGGGGGAACCCGCAGGGGGGTGCAATT|GTCTGGTTGTATGGCCTATCGTAGCATCAT
TCCCATCCCCCTTCCGACGCGATTCGACAT|TCTTTAATTTTCTATATGGCGTCTTCCAAC
GCTCCATTGATTATAACTATAGATGCCCAC|CTATATGGCGTCTTCCAACCTGCTGTTTCC
AACGCCCTCTGCAAGATGGTTTGTATGCGT|AATTTTCTATATGGCAATTTTCTATATGGC
TGTATCGTAGCACGGGTGTCTCTATAGACG|CATACCCCCTACGATGGGGGAACCCGCAGG
AGTCAATCAAAGTCCGTTGTGCGGTCAGGG|GATGCGCGGTGATAACGCCCTCTGCAAGAT
CGTCTTCCAACCTGCTTTTGTCTTTAATTT|CTACGCCAAAGTTCAAATGTGACGGTATAA
TTCGGATATGTACAATCAGAATGCGCGCTC|TCTTCCAACCTGCTACGAAGTAGGTTGTTG
CTGACGGAGGGAGACGAATAGACCCGAATC|ATGTTCTCAGGCCAGGACTAGGGACCTTTC
GGTATAAATGCAATAATTTTCTATATGGCG|TTTCTATATGAATTTTCTATATGGCGTCTT
TGCTTCGGATATGTACAATCAGAATGCGCG|GCGTCTTCCAACCTGCTACGAAGTAGGTTG
CAATTTTCTATATGGCGTCTTCCAACCTGC|TCCGAAGCGAGGATAATTTTCTATATGGCG
AAAGTTCAAATGTGACGGTATAAATGCAAT|CTCTACTGGGACTAATTTTCTATATGAATT
GGAGGCTTTTAGTGGTTTTTCGGTTCGGAT|AGGCACAGATATCCTCGCAAATTTTCTATA
GCAATAATTTTCTATATGGCGTCTTCCAAC|GAATTTTCTATATGGCGTCTTCCAACCTGC
GCAATCTGTCAGGAACGTAGCGTGTGATCA|CTTCCAACCTGCTAATTTTCTATATGGCGT
GATGGGGGAACCCGCAGGGGGGTGCAATTC|TCTGGTTGTATGGCCTATCGTAGCATCATT
ATGACCCGACACTAATGAATTTTCTATATG|AGCGTGTGATCACGTTTAACTAATGGGCAC
ATGACCCGTTCATGACCCGACACTAATGAA|GTCAGGAACGTAGCGTGTGATCACGTTTAA
TCTTCCAACCTGCTATGAGGCCAAATAGAT|TTCTATATGGCGTCTTCCAACCTGCTTTTC
GGAGACGAATAGACCCGAATCACCAATTTT|GGCCAGGACTAGGGACCTTTCCGTCCGAAG
GGTAAAGCACCTGTATCGTAGCACGGGTGT|CTGCTTAGCCCCATACCCCCTACGATGGGG
GATTATAACTATAGATGCCCACCCCCAGGA|CGTCTTCCAACCTGCTGTTTCCTAGGCAGG
GGTGCATGTTCTCAGGCCAGGACTAGGGAC|ATGGTTTGTATGCGTACATGTCACGCTTCG
TCCAACCTGCTCCATTGATTATAACTATAG|GGAATTTTCTATATGGCGTCTTCCAACCTG
GATGCCCACCCCCAGGAGGCTTTTAGTGGT|GCTGTTTCCTAGGCAGGCACAGATATCCTC
GACACGGGCTTTGGCCTATACGTACAAAAA|TGAGGCCAAATAGATTCCGAGGGGAGCAAT
AGCGCTCTAATTACGATCACACCGACGTCC|CAACCTGCTCCATTGATTATAACTATAGAT
TCACGCTTCGCGGTAAAGCGCTCTAATTAC|CCAACCTGCTGTCTTCCAACCTGCTCCATT
CGTGTGATCACGTTTAACTAATGGGCACTC|TATATGGCGTCTTCCAACCTGCTCAGCAAA
TCCGACGCGATTCGACATGGCGACGACACG|TATATGGCGTCTTCCAACCTGCTATGAGGC
ACCTGCTGCGTCTTCCAACCTGCTGACGGA|GTCCGTTGTGCGGTCAGGGTGCATGTTCTC
AGTGCAAAGGTCCTATGTGTGCAAAGTTGT|TTTTACGTAGAGGTATCTACTAAGATCTCT
TGTACGCTCATTTCCCATCCCCCTTCCGAC|AACCTGCTTTTGTCTTTAATTTTCTATATG
CAGGACTAGGGACCTTTCCGTCCGAAGCGA|ATGTCACGCTTCGCGGTAAAGCGCTCTAAT
CAAAGCCATTCTCTACTGGGACTAATTTTC|TCTTCCAACCTGCTTCGGATATGTACAATC
GCTCATTTCCCATCCCCCTTCCGACGCGAT|GCTTTTGTCTTTAATTTTCTATATGGCGTC
AACCTGCTGTTTCCTAGGCAGGCACAGATA|GAGAGACCATGTGTGCAAAGATTCTATAAC
CTGCTTTTCTATATGGCGTCTTCCAACCTG|TGCGTCTTCCAACCTGCTGACGGAGGGAGA
TATGAGGCCAAATAGATTCCGAGGGGAGCA|CTTCCAACCTGCTTTTCTATATGGCGTCTT
TCTATATGGCAATTTTCTATATGGCGTCTT|AGGTAAAGCACCTGTATCGTAGCACGGGTG
TGTCTTTAATTTTCTATATGGCGTCTTCCA|GTGACGGTATAAATGCAATAATTTTCTATA
ACTATAGATGCCCACCCCCAGGAGGCTTTT|CAACCTGCTGTTTCCTAGGCAGGCACAGAT
CCCTCTGCAAGATGGTTTGTATGCGTACAT|TTCTATATGGCAATTTTCTATATGGCGTCT
ATCACGTTTAACTAATGGGCACTCTACGCC|GCGTCTTCCAACCTGCTCAGCAAAGCCATT
TAAATGCAATAATTTTCTATATGGCGTCTT|TATATGAATTTTCTATATGGCGTCTTCCAA
AGGGAGACGAATAGACCCGAATCACCAATT|CAGGCCAGGACTAGGGACCTTTCCGTCCGA
GATATGTACAATCAGAATGCGCGCTCCCCG|CCAACCTGCTACGAAGTAGGTTGTTGACCT
CGAGGATAATTTTCTATATGGCGTCTTCCA|AATTACGATCACACCGACGTCCTAATTTTC
GGACTAATTTTCTATATGAATTTTCTATAT|ATATGTACAATCAGAATGCGCGCTCCCCGA
TTCTATATGGCGTCTTCCAACCTGCTGCGT|CTCCCCGAAGTCAATCAAAGTCCGTTGTGC
CGGGCCAATAAATCGGAGAGACCATGTGTG|TCCGATACATCCTATCGAGGAATTTTCTAT
TCCATTGATTATAACTATAGATGCCCACCC|ATATGGCGTCTTCCAACCTGCTGTTTCCTA
GTCTTCCAACCTGCTCCATTGATTATAACT|CGCTGGAATTTTCTATATGGCGTCTTCCAA
CTTCCGACGCGATTCGACATGGCGACGACA|TCTATATGGCGTCTTCCAACCTGCTATGAG
GAATTTTCTATATGGCGTCTTCCAACCTGC|GTGCAATTCGGGCCAATAAATCGGAGAGAC
AAATGATGACCCGTTCATGACCCGACACTA|AATCTGTCAGGAACGTAGCGTGTGATCACG
CTAGGGACCTTTCCGTCCGAAGCGAGGATA|ACGCTTCGCGGTAAAGCGCTCTAATTACGA
AATCGGATTACGGGTTTCCAGTGCAAAGGT|AGGGACTAAGGGCCGGACATTTTACGTAGA
TCGGTTCGGATCAGCGCCAACACGAGGTAA|AATTTTCTATATGGCGTCTTCCAACCTGCT
CTTGTGGCCAATCGGATTACGGGTTTCCAG|CCTGCTCTCAGGGACTAAGGGCCGGACATT
ATATGGCGTCTTCCAACCTGCTTAGCCCCA|TACGGGTTTCCAGTGCAAAGGTCCTATGTG
CGTCTTCCAACCTGCTGACGGAGGGAGACG|TGCGGTCAGGGTGCATGTTCTCAGGCCAGG
CCTAGGCAGGCACAGATATCCTCGCAAATT|GTGCAAAGATTCTATAACTTGTGGCCAATC
ACCCGTTCATGACCCGACACTAATGAATTT|AGGAACGTAGCGTGTGATCACGTTTAACTA
CCCCTTCCGACGCGATTCGACATGGCGACG|TTTTCTATATGGCGTCTTCCAACCTGCTAT
CAAAAATGATGACCCGTTCATGACCCGACA|AGCAATCTGTCAGGAACGTAGCGTGTGATC
CTATATGGCGTCTTCCAACCTGCTACGAAG|CCGACGTCCTAATTTTCTATATGGCGTCTT
CTAGGCAGGCACAGATATCCTCGCAAATTT|TGCAAAGATTCTATAACTTGTGGCCAATCG
TCGTAGCACGGGTGTCTCTATAGACGCTGG|CCCCCTACGATGGGGGAACCCGCAGGGGGG
CTTCCAACCTGCTACGAAGTAGGTTGTTGA|ATTTTCTATATGGCGTCTTCCAACCTGCTT
CGACATGGCGACGACACGGGCTTTGGCCTA|TCCAACCTGCTATGAGGCCAAATAGATTCC
CCCAGGAGGCTTTTAGTGGTTTTTCGGTTC|AGGCAGGCACAGATATCCTCGCAAATTTTC
GCGACGACACGGGCTTTGGCCTATACGTAC|TGCTATGAGGCCAAATAGATTCCGAGGGGA
CCCCATACCCCCTACGATGGGGGAACCCGC|ATGTGTGCAAAGTTGTCTGGTTGTATGGCC
TGGCGTCTTCCAACCTGCTTCGGATATGTA|ATAATTTTCTATATGGCGTCTTCCAACCTG
TCTGGTTGTATGGCCTATCGTAGCATCATT|TACGCTGACTCTCCATCTGAGGGCTGACTT
GGGGGTGCAATTCGGGCCAATAAATCGGAG|TCGTAGCATCATTCCGATACATCCTATCGA
TCGGATATGTACAATCAGAATGCGCGCTCC|CTTCCAACCTGCTACGAAGTAGGTTGTTGA
AATACTAGTATGAGCGATGTACGCTCATTT|TCTATATGGCGTCTTCCAACCTGCTTTTGT
TTACGATCACACCGACGTCCTAATTTTCTA|CATTGATTATAACTATAGATGCCCACCCCC
GCAAAGCCATTCTCTACTGGGACTAATTTT|GTCTTCCAACCTGCTTCGGATATGTACAAT
GCAAAGTTGTCTGGTTGTATGGCCTATCGT|TAAGATCTCTACGCTGACTCTCCATCTGAG
GCGATTCGACATGGCGACGACACGGGCTTT|GCGTCTTCCAACCTGCTATGAGGCCAAATA
TATGGCGTCTTCCAACCTGCTTAGCCCCAT|ACGGGTTTCCAGTGCAAAGGTCCTATGTGT
GTCTTCCAACCTGCTGTCTTCCAACCTGCT|GGGTGTCTCTATAGACGCTGGAATTTTCTA
TCCAACCTGCTATGAGGCCAAATAGATTCC|TATATGGCGTCTTCCAACCTGCTTTTCTAT
GTGGTTTTTCGGTTCGGATCAGCGCCAACA|TCCTCGCAAATTTTCTATATGGCGTCTTCC
GTCTGGTTGTATGGCCTATCGTAGCATCAT|CTACGCTGACTCTCCATCTGAGGGCTGACT
TCGGATCAGCGCCAACACGAGGTAAAGCAC|TCTATATGGCGTCTTCCAACCTGCTTAGCC
TTTCTATATGGCGTCTTCCAACCTGCTGCG|GCTCCCCGAAGTCAATCAAAGTCCGTTGTG
ATATGGCGTCTTCCAACCTGCTTTTCTATA|GGCGTCTTCCAACCTGCTGCGTCTTCCAAC
TCACCAATTTTCTATATGGCGTCTTCCAAC|TCCGTCCGAAGCGAGGATAATTTTCTATAT
GCAGATGATCACGGTCAATACTAGTATGAG|CGACACTAATGAATTTTCTATATGGCGTCT
ATAACTATAGATGCCCACCCCCAGGAGGCT|TTCCAACCTGCTGTTTCCTAGGCAGGCACA
TCTTCCAACCTGCTTTTAGCGTCGCAAGTA|TTTTAGTGGTTTTTCGGTTCGGATCAGCGC
AAGCCATTCTCTACTGGGACTAATTTTCTA|TTCCAACCTGCTTCGGATATGTACAATCAG
ATAATTTTCTATATGGCGTCTTCCAACCTG|CGATCACACCGACGTCCTAATTTTCTATAT
CGCTTCGCGGTAAAGCGCTCTAATTACGAT|ACCTGCTGTCTTCCAACCTGCTCCATTGAT
TTTCTATATGGCGTCTTCCAACCTGCTTAG|CGGATTACGGGTTTCCAGTGCAAAGGTCCT
TTATAACTATAGATGCCCACCCCCAGGAGG|TCTTCCAACCTGCTGTTTCCTAGGCAGGCA
CCTCGCAAATTTTCTATATGGCGTCTTCCA|TGTGGCCAATCGGATTACGGGTTTCCAGTG
ACCTGCTTAGCCCCATACCCCCTACGATGG|CAAAGGTCCTATGTGTGCAAAGTTGTCTGG
TCTTCCAACCTGCTTAGCCCCATACCCCCT|TCCAGTGCAAAGGTCCTATGTGTGCAAAGT
GAATCACCAATTTTCTATATGGCGTCTTCC|CTTTCCGTCCGAAGCGAGGATAATTTTCTA
CTATATGAATTTTCTATATGGCGTCTTCCA|CAGAATGCGCGCTCCCCGAAGTCAATCAAA
CAGCGCCAACACGAGGTAAAGCACCTGTAT|TGGCGTCTTCCAACCTGCTTAGCCCCATAC
TCTATATGGCGTCTTCCAACCTGCTTTTAG|CCCCAGGAGGCTTTTAGTGGTTTTTCGGTT
TTTAACTAATGGGCACTCTACGCCAAAGTT|TCCAACCTGCTCAGCAAAGCCATTCTCTAC
CTATATGGCGTCTTCCAACCTGCTCAGCAA|CCCGAATCACCAATTTTCTATATGGCGTCT
TCCGCAGATGATCACGGTCAATACTAGTAT|ACCCGACACTAATGAATTTTCTATATGGCG
CATGTGTGCAAAGATTCTATAACTTGTGGC|TTTTCTATATGGCGTCTTCCAACCTGCTCT
GTAGCGTGTGATCACGTTTAACTAATGGGC|TTTCTATATGGCGTCTTCCAACCTGCTCAG
CTGCGTCTTCCAACCTGCTGACGGAGGGAG|TTGTGCGGTCAGGGTGCATGTTCTCAGGCC
GTCTTCCAACCTGCTTCGGATATGTACAAT|TTTTCTATATGGCGTCTTCCAACCTGCTAC
GAATTTTCTATATGGCGTCTTCCAACCTGC|GCGCGCTCCCCGAAGTCAATCAAAGTCCGT
TGTGGCCAATCGGATTACGGGTTTCCAGTG|TGCTCTCAGGGACTAAGGGCCGGACATTTT
TGCTTAGCCCCATACCCCCTACGATGGGGG|AGGTCCTATGTGTGCAAAGTTGTCTGGTTG
ACGCCAAAGTTCAAATGTGACGGTATAAAT|CCATTCTCTACTGGGACTAATTTTCTATAT
CGTCTTCCAACCTGCTCAGCAAAGCCATTC|ACCAATTTTCTATATGGCGTCTTCCAACCT
ACCTGCTCAGCAAAGCCATTCTCTACTGGG|CTATATGGCGTCTTCCAACCTGCTTCGGAT
TTTGTATGCGTACATGTCACGCTTCGCGGT|TTCTATATGGCGTCTTCCAACCTGCTGTCT
GGCCAATAAATCGGAGAGACCATGTGTGCA|CGATACATCCTATCGAGGAATTTTCTATAT
GAATAGACCCGAATCACCAATTTTCTATAT|GACTAGGGACCTTTCCGTCCGAAGCGAGGA
TCCAACCTGCTCAGCAAAGCCATTCTCTAC|TTTTCTATATGGCGTCTTCCAACCTGCTTC
CCCATACCCCCTACGATGGGGGAACCCGCA|TGTGTGCAAAGTTGTCTGGTTGTATGGCCT
TGCTCAGCAAAGCCATTCTCTACTGGGACT|TATGGCGTCTTCCAACCTGCTTCGGATATG
TGTTCTCAGGCCAGGACTAGGGACCTTTCC|TGTATGCGTACATGTCACGCTTCGCGGTAA
CGTTCATGACCCGACACTAATGAATTTTCT|AACGTAGCGTGTGATCACGTTTAACTAATG
CCAACCTGCTGTCTTCCAACCTGCTCCATT|TCTCTATAGACGCTGGAATTTTCTATATGG
TATGAATTTTCTATATGGCGTCTTCCAACC|AATGCGCGCTCCCCGAAGTCAATCAAAGTC
CATTCTCTACTGGGACTAATTTTCTATATG|AACCTGCTTCGGATATGTACAATCAGAATG
TTTCTATATGGCGTCTTCCAACCTGCTCAG|AGACCCGAATCACCAATTTTCTATATGGCG
TACTGGGACTAATTTTCTATATGAATTTTC|TTCGGATATGTACAATCAGAATGCGCGCTC
GCAATTCGGGCCAATAAATCGGAGAGACCA|CATCATTCCGATACATCCTATCGAGGAATT
AAGTTCAAATGTGACGGTATAAATGCAATA|TCTACTGGGACTAATTTTCTATATGAATTT
AGGTCCTATGTGTGCAAAGTTGTCTGGTTG|TAGAGGTATCTACTAAGATCTCTACGCTGA
GTCTTCCAACCTGCTAATTTTCTATATGGC|TGACGGAGGGAGACGAATAGACCCGAATCA
TGCAAAGATTCTATAACTTGTGGCCAATCG|ATATGGCGTCTTCCAACCTGCTCTCAGGGA
TGTGCAAAGATTCTATAACTTGTGGCCAAT|CTATATGGCGTCTTCCAACCTGCTCTCAGG
TGATCACGTTTAACTAATGGGCACTCTACG|TGGCGTCTTCCAACCTGCTCAGCAAAGCCA
ATCACCAATTTTCTATATGGCGTCTTCCAA|TTCCGTCCGAAGCGAGGATAATTTTCTATA
TACGATGGGGGAACCCGCAGGGGGGTGCAA|TTGTCTGGTTGTATGGCCTATCGTAGCATC
GATCACACCGACGTCCTAATTTTCTATATG|GATTATAACTATAGATGCCCACCCCCAGGA
TGCTTTTCTATATGGCGTCTTCCAACCTGC|GCGTCTTCCAACCTGCTGACGGAGGGAGAC
ACGCTTCGCGGTAAAGCGCTCTAATTACGA|AACCTGCTGTCTTCCAACCTGCTCCATTGA
ATCAGAATGCGCGCTCCCCGAAGTCAATCA|ACGAAGTAGGTTGTTGACCTGGATGCGCGG
AAGTCCGTTGTGCGGTCAGGGTGCATGTTC|TGATAACGCCCTCTGCAAGATGGTTTGTAT
TGGCGTCTTCCAACCTGCTGCGTCTTCCAA|AAGTCAATCAAAGTCCGTTGTGCGGTCAGG
CAACCTGCTTAGCCCCATACCCCCTACGAT|TGCAAAGGTCCTATGTGTGCAAAGTTGTCT
TATCGTAGCACGGGTGTCTCTATAGACGCT|TACCCCCTACGATGGGGGAACCCGCAGGGG
TCGCAAATTTTCTATATGGCGTCTTCCAAC|TGGCCAATCGGATTACGGGTTTCCAGTGCA
GAGGCTTTTAGTGGTTTTTCGGTTCGGATC|GGCACAGATATCCTCGCAAATTTTCTATAT
ATGAGGCCAAATAGATTCCGAGGGGAGCAA|TTCCAACCTGCTTTTCTATATGGCGTCTTC
GACCCGAATCACCAATTTTCTATATGGCGT|GGGACCTTTCCGTCCGAAGCGAGGATAATT
TTTTCTATATGGCAATTTTCTATATGGCGT|ACGAGGTAAAGCACCTGTATCGTAGCACGG
CACGGTCAATACTAGTATGAGCGATGTACG|TGAATTTTCTATATGGCGTCTTCCAACCTG
TCCAACCTGCTTAGCCCCATACCCCCTACG|AGTGCAAAGGTCCTATGTGTGCAAAGTTGT
CGGTCAGGGTGCATGTTCTCAGGCCAGGAC|CTGCAAGATGGTTTGTATGCGTACATGTCA
TCGACATGGCGACGACACGGGCTTTGGCCT|TTCCAACCTGCTATGAGGCCAAATAGATTC
GACCCGACACTAATGAATTTTCTATATGGC|CGTGTGATCACGTTTAACTAATGGGCACTC
ACCTGCTTTTAGCGTCGCAAGTACCAATTT|GGTTTTTCGGTTCGGATCAGCGCCAACACG
TGTACAATCAGAATGCGCGCTCCCCGAAGT|CCTGCTACGAAGTAGGTTGTTGACCTGGAT
CGCGGTGATAACGCCCTCTGCAAGATGGTT|GCAAGTACCAATTTTCTATATGGCAATTTT
GATTCGACATGGCGACGACACGGGCTTTGG|GTCTTCCAACCTGCTATGAGGCCAAATAGA
TTTAGTGGTTTTTCGGTTCGGATCAGCGCC|GATATCCTCGCAAATTTTCTATATGGCGTC
CCGAAGTCAATCAAAGTCCGTTGTGCGGTC|CCTGGATGCGCGGTGATAACGCCCTCTGCA
GGCGTCTTCCAACCTGCTTTTCTATATGGC|TCTTCCAACCTGCTGCGTCTTCCAACCTGC
GTTGACCTGGATGCGCGGTGATAACGCCCT|TGCTTTTAGCGTCGCAAGTACCAATTTTCT
ATGTGTGCAAAGATTCTATAACTTGTGGCC|TTTCTATATGGCGTCTTCCAACCTGCTCTC
ATTACGATCACACCGACGTCCTAATTTTCT|CCATTGATTATAACTATAGATGCCCACCCC
TACAAAAATGATGACCCGTTCATGACCCGA|GGAGCAATCTGTCAGGAACGTAGCGTGTGA
ACTTGTGGCCAATCGGATTACGGGTTTCCA|ACCTGCTCTCAGGGACTAAGGGCCGGACAT
TTTTCTATATGGCGTCTTCCAACCTGCTAT|TAAATGCAATAATTTTCTATATGGCGTCTT
GCGTCTTCCAACCTGCTTTTCTATATGGCG|CTTCCAACCTGCTGCGTCTTCCAACCTGCT
CTCCATTGATTATAACTATAGATGCCCACC|TATATGGCGTCTTCCAACCTGCTGTTTCCT
CCAGGACTAGGGACCTTTCCGTCCGAAGCG|CATGTCACGCTTCGCGGTAAAGCGCTCTAA
AGATGATCACGGTCAATACTAGTATGAGCG|ACACTAATGAATTTTCTATATGGCGTCTTC
GGCACAGATATCCTCGCAAATTTTCTATAT|ATTCTATAACTTGTGGCCAATCGGATTACG
CCCTTCCGACGCGATTCGACATGGCGACGA|TTTCTATATGGCGTCTTCCAACCTGCTATG
GTAAAGCGCTCTAATTACGATCACACCGAC|CTTCCAACCTGCTCCATTGATTATAACTAT
ATATCCTCGCAAATTTTCTATATGGCGTCT|AACTTGTGGCCAATCGGATTACGGGTTTCC
AACCTGCTTTTCTATATGGCGTCTTCCAAC|TGCTGCGTCTTCCAACCTGCTGACGGAGGG
AGCACCTGTATCGTAGCACGGGTGTCTCTA|TAGCCCCATACCCCCTACGATGGGGGAACC
AATCAGAATGCGCGCTCCCCGAAGTCAATC|TACGAAGTAGGTTGTTGACCTGGATGCGCG
CCTGCTTAGCCCCATACCCCCTACGATGGG|AAAGGTCCTATGTGTGCAAAGTTGTCTGGT
AGTTCAAATGTGACGGTATAAATGCAATAA|CTACTGGGACTAATTTTCTATATGAATTTT
TGGCCTATACGTACAAAAATGATGACCCGT|AGATTCCGAGGGGAGCAATCTGTCAGGAAC
CTGTCAGGAACGTAGCGTGTGATCACGTTT|AACCTGCTAATTTTCTATATGGCGTCTTCC
AAATGTGACGGTATAAATGCAATAATTTTC|GGGACTAATTTTCTATATGAATTTTCTATA
CGGGCTTTGGCCTATACGTACAAAAATGAT|GCCAAATAGATTCCGAGGGGAGCAATCTGT
AGGCAGGCACAGATATCCTCGCAAATTTTC|CAAAGATTCTATAACTTGTGGCCAATCGGA
GCCATTCTCTACTGGGACTAATTTTCTATA|CCAACCTGCTTCGGATATGTACAATCAGAA
GCGTCTTCCAACCTGCTGCGTCTTCCAACC|GTCAATCAAAGTCCGTTGTGCGGTCAGGGT
AGCACGGGTGTCTCTATAGACGCTGGAATT|CTACGATGGGGGAACCCGCAGGGGGGTGCA
TAATTTTCTATATGGCGTCTTCCAACCTGC|GCCCACCCCCAGGAGGCTTTTAGTGGTTTT
ATCCCCCTTCCGACGCGATTCGACATGGCG|TAATTTTCTATATGGCGTCTTCCAACCTGC
AAGATTCTATAACTTGTGGCCAATCGGATT|GGCGTCTTCCAACCTGCTCTCAGGGACTAA
GTCTTTAATTTTCTATATGGCGTCTTCCAA|TGACGGTATAAATGCAATAATTTTCTATAT
ATTGATTATAACTATAGATGCCCACCCCCA|TGGCGTCTTCCAACCTGCTGTTTCCTAGGC
TGGCCAATCGGATTACGGGTTTCCAGTGCA|CTCTCAGGGACTAAGGGCCGGACATTTTAC
CCGACGTCCTAATTTTCTATATGGCGTCTT|ACTATAGATGCCCACCCCCAGGAGGCTTTT
CAACCTGCTTTTAGCGTCGCAAGTACCAAT|GTGGTTTTTCGGTTCGGATCAGCGCCAACA
CCTATACGTACAAAAATGATGACCCGTTCA|TTCCGAGGGGAGCAATCTGTCAGGAACGTA
GTTCGGATCAGCGCCAACACGAGGTAAAGC|TTTCTATATGGCGTCTTCCAACCTGCTTAG
CCAACCTGCTATGAGGCCAAATAGATTCCG|ATATGGCGTCTTCCAACCTGCTTTTCTATA
AGGCCAGGACTAGGGACCTTTCCGTCCGAA|GTACATGTCACGCTTCGCGGTAAAGCGCTC
GCAAATTTTCTATATGGCGTCTTCCAACCT|GCCAATCGGATTACGGGTTTCCAGTGCAAA
TCTTCCAACCTGCTTTTGTCTTTAATTTTC|ACGCCAAAGTTCAAATGTGACGGTATAAAT
TCTTCCAACCTGCTGACGGAGGGAGACGAA|CGGTCAGGGTGCATGTTCTCAGGCCAGGAC
TAATTTTCTATATGGCGTCTTCCAACCTGC|GATCACACCGACGTCCTAATTTTCTATATG
CCGAGGGGAGCAATCTGTCAGGAACGTAGC|ATATGGCGTCTTCCAACCTGCTAATTTTCT
CATGGCGACGACACGGGCTTTGGCCTATAC|AACCTGCTATGAGGCCAAATAGATTCCGAG
CTTTTAGCGTCGCAAGTACCAATTTTCTAT|TTCGGTTCGGATCAGCGCCAACACGAGGTA
ATATGGCGTCTTCCAACCTGCTATGAGGCC|CAATAATTTTCTATATGGCGTCTTCCAACC
GCCAACACGAGGTAAAGCACCTGTATCGTA|GTCTTCCAACCTGCTTAGCCCCATACCCCC
CAATCTGTCAGGAACGTAGCGTGTGATCAC|TTCCAACCTGCTAATTTTCTATATGGCGTC
TTGATTATAACTATAGATGCCCACCCCCAG|GGCGTCTTCCAACCTGCTGTTTCCTAGGCA
TATATGGCGTCTTCCAACCTGCTCAGCAAA|CCGAATCACCAATTTTCTATATGGCGTCTT
CTATATGGCGTCTTCCAACCTGCTGTCTTC|TCGTAGCACGGGTGTCTCTATAGACGCTGG
ACAAAAATGATGACCCGTTCATGACCCGAC|GAGCAATCTGTCAGGAACGTAGCGTGTGAT
TGTCTTCCAACCTGCTCCATTGATTATAAC|ACGCTGGAATTTTCTATATGGCGTCTTCCA
TATGGCGTCTTCCAACCTGCTTTTAGCGTC|AGGAGGCTTTTAGTGGTTTTTCGGTTCGGA
AAAGCACCTGTATCGTAGCACGGGTGTCTC|CTTAGCCCCATACCCCCTACGATGGGGGAA
GAGCAATCTGTCAGGAACGTAGCGTGTGAT|GTCTTCCAACCTGCTAATTTTCTATATGGC
GAGACCATGTGTGCAAAGATTCTATAACTT|AGGAATTTTCTATATGGCGTCTTCCAACCT
GGCGTCTTCCAACCTGCTATGAGGCCAAAT|AATTTTCTATATGGCGTCTTCCAACCTGCT
ATTCGACATGGCGACGACACGGGCTTTGGC|TCTTCCAACCTGCTATGAGGCCAAATAGAT
CTATATGGCGTCTTCCAACCTGCTTCGGAT|CGAGGATAATTTTCTATATGGCGTCTTCCA
TTCCAACCTGCTCCATTGATTATAACTATA|TGGAATTTTCTATATGGCGTCTTCCAACCT
GGATATGTACAATCAGAATGCGCGCTCCCC|TCCAACCTGCTACGAAGTAGGTTGTTGACC
TATATGAATTTTCTATATGGCGTCTTCCAA|AGAATGCGCGCTCCCCGAAGTCAATCAAAG
AACACGAGGTAAAGCACCTGTATCGTAGCA|TTCCAACCTGCTTAGCCCCATACCCCCTAC
ACCTGCTACGAAGTAGGTTGTTGACCTGGA|TATATGGCGTCTTCCAACCTGCTTTTAGCG
TAGGGACCTTTCCGTCCGAAGCGAGGATAA|CGCTTCGCGGTAAAGCGCTCTAATTACGAT
GTGTCTCTATAGACGCTGGAATTTTCTATA|GGGGGAACCCGCAGGGGGGTGCAATTCGGG
CTTCCAACCTGCTTAGCCCCATACCCCCTA|CCAGTGCAAAGGTCCTATGTGTGCAAAGTT
CACGCTTCGCGGTAAAGCGCTCTAATTACG|CAACCTGCTGTCTTCCAACCTGCTCCATTG
ACCCCCAGGAGGCTTTTAGTGGTTTTTCGG|CCTAGGCAGGCACAGATATCCTCGCAAATT
TGCTCCATTGATTATAACTATAGATGCCCA|TCTATATGGCGTCTTCCAACCTGCTGTTTC
TTCCAACCTGCTTAGCCCCATACCCCCTAC|CAGTGCAAAGGTCCTATGTGTGCAAAGTTG
TGCTGCGTCTTCCAACCTGCTGACGGAGGG|CGTTGTGCGGTCAGGGTGCATGTTCTCAGG
CCAACCTGCTTTTAGCGTCGCAAGTACCAA|AGTGGTTTTTCGGTTCGGATCAGCGCCAAC
AGTACCAATTTTCTATATGGCAATTTTCTA|GCGCCAACACGAGGTAAAGCACCTGTATCG
AATGCGCGCTCCCCGAAGTCAATCAAAGTC|GTAGGTTGTTGACCTGGATGCGCGGTGATA
GCGTCTTCCAACCTGCTTTTAGCGTCGCAA|GGCTTTTAGTGGTTTTTCGGTTCGGATCAG
CGACGACACGGGCTTTGGCCTATACGTACA|GCTATGAGGCCAAATAGATTCCGAGGGGAG
ACCCGACACTAATGAATTTTCTATATGGCG|GTGTGATCACGTTTAACTAATGGGCACTCT
CATTGATTATAACTATAGATGCCCACCCCC|ATGGCGTCTTCCAACCTGCTGTTTCCTAGG
CCGACGCGATTCGACATGGCGACGACACGG|ATATGGCGTCTTCCAACCTGCTATGAGGCC
GATGACCCGTTCATGACCCGACACTAATGA|TGTCAGGAACGTAGCGTGTGATCACGTTTA
AATGGGCACTCTACGCCAAAGTTCAAATGT|TGCTCAGCAAAGCCATTCTCTACTGGGACT
GCGATGTACGCTCATTTCCCATCCCCCTTC|TTCCAACCTGCTTTTGTCTTTAATTTTCTA
GCTTCGCGGTAAAGCGCTCTAATTACGATC|CCTGCTGTCTTCCAACCTGCTCCATTGATT
GTTTTTCGGTTCGGATCAGCGCCAACACGA|TCGCAAATTTTCTATATGGCGTCTTCCAAC
TCTATATGGCGTCTTCCAACCTGCTTCGGA|GCGAGGATAATTTTCTATATGGCGTCTTCC
TTCTCAGGCCAGGACTAGGGACCTTTCCGT|TATGCGTACATGTCACGCTTCGCGGTAAAG
GGATGCGCGGTGATAACGCCCTCTGCAAGA|GCGTCGCAAGTACCAATTTTCTATATGGCA
CTCCCCGAAGTCAATCAAAGTCCGTTGTGC|TTGACCTGGATGCGCGGTGATAACGCCCTC
ACGGGCTTTGGCCTATACGTACAAAAATGA|GGCCAAATAGATTCCGAGGGGAGCAATCTG
CCAACCTGCTGCGTCTTCCAACCTGCTGAC|AAAGTCCGTTGTGCGGTCAGGGTGCATGTT
TGTCAGGAACGTAGCGTGTGATCACGTTTA|ACCTGCTAATTTTCTATATGGCGTCTTCCA
ATGCAATAATTTTCTATATGGCGTCTTCCA|ATGAATTTTCTATATGGCGTCTTCCAACCT
TTGTGCGGTCAGGGTGCATGTTCTCAGGCC|GCCCTCTGCAAGATGGTTTGTATGCGTACA
ACAGATATCCTCGCAAATTTTCTATATGGC|CTATAACTTGTGGCCAATCGGATTACGGGT
ATGCGCGGTGATAACGCCCTCTGCAAGATG|GTCGCAAGTACCAATTTTCTATATGGCAAT
TGTCTCTATAGACGCTGGAATTTTCTATAT|GGGGAACCCGCAGGGGGGTGCAATTCGGGC
CTATAGACGCTGGAATTTTCTATATGGCGT|ACCCGCAGGGGGGTGCAATTCGGGCCAATA
CTTCCAACCTGCTGTCTTCCAACCTGCTCC|GTGTCTCTATAGACGCTGGAATTTTCTATA
CTCAGGCCAGGACTAGGGACCTTTCCGTCC|TGCGTACATGTCACGCTTCGCGGTAAAGCG
TATGGCAATTTTCTATATGGCGTCTTCCAA|AAAGCACCTGTATCGTAGCACGGGTGTCTC
ATAGACCCGAATCACCAATTTTCTATATGG|CTAGGGACCTTTCCGTCCGAAGCGAGGATA
GAGGGAGACGAATAGACCCGAATCACCAAT|TCAGGCCAGGACTAGGGACCTTTCCGTCCG
AATCTGTCAGGAACGTAGCGTGTGATCACG|TCCAACCTGCTAATTTTCTATATGGCGTCT
TTCCCATCCCCCTTCCGACGCGATTCGACA|GTCTTTAATTTTCTATATGGCGTCTTCCAA
CAATCGGATTACGGGTTTCCAGTGCAAAGG|CAGGGACTAAGGGCCGGACATTTTACGTAG
TGCTATGAGGCCAAATAGATTCCGAGGGGA|CGTCTTCCAACCTGCTTTTCTATATGGCGT
TGGTTTGTATGCGTACATGTCACGCTTCGC|ATTTTCTATATGGCGTCTTCCAACCTGCTG
CCTGCTTTTGTCTTTAATTTTCTATATGGC|GTTCAAATGTGACGGTATAAATGCAATAAT
CCTGCTGTTTCCTAGGCAGGCACAGATATC|GAGACCATGTGTGCAAAGATTCTATAACTT
CCCACCCCCAGGAGGCTTTTAGTGGTTTTT|TTTCCTAGGCAGGCACAGATATCCTCGCAA
ATGGCGTCTTCCAACCTGCTTAGCCCCATA|CGGGTTTCCAGTGCAAAGGTCCTATGTGTG
CGGTGATAACGCCCTCTGCAAGATGGTTTG|AAGTACCAATTTTCTATATGGCAATTTTCT
TATATGGCAATTTTCTATATGGCGTCTTCC|GTAAAGCACCTGTATCGTAGCACGGGTGTC
GGGCACTCTACGCCAAAGTTCAAATGTGAC|TCAGCAAAGCCATTCTCTACTGGGACTAAT
CTGTATCGTAGCACGGGTGTCTCTATAGAC|CCATACCCCCTACGATGGGGGAACCCGCAG
TTGTCTGGTTGTATGGCCTATCGTAGCATC|CTCTACGCTGACTCTCCATCTGAGGGCTGA
TGGATGCGCGGTGATAACGCCCTCTGCAAG|AGCGTCGCAAGTACCAATTTTCTATATGGC
CTAGTATGAGCGATGTACGCTCATTTCCCA|TATGGCGTCTTCCAACCTGCTTTTGTCTTT
TGGCGACGACACGGGCTTTGGCCTATACGT|CCTGCTATGAGGCCAAATAGATTCCGAGGG
AATTTTCTATATGGCGTCTTCCAACCTGCT|TTCTATATGGCGTCTTCCAACCTGCTGCGT
TATATGGCGTCTTCCAACCTGCTGTCTTCC|CGTAGCACGGGTGTCTCTATAGACGCTGGA
TGACCTGGATGCGCGGTGATAACGCCCTCT|CTTTTAGCGTCGCAAGTACCAATTTTCTAT
CGAAGTCAATCAAAGTCCGTTGTGCGGTCA|CTGGATGCGCGGTGATAACGCCCTCTGCAA
CCAACCTGCTAATTTTCTATATGGCGTCTT|GAGGGAGACGAATAGACCCGAATCACCAAT
CCATCCCCCTTCCGACGCGATTCGACATGG|TTTAATTTTCTATATGGCGTCTTCCAACCT
ATGGCGTCTTCCAACCTGCTACGAAGTAGG|CGTCCTAATTTTCTATATGGCGTCTTCCAA
GGCGTCTTCCAACCTGCTTTTGTCTTTAAT|CTCTACGCCAAAGTTCAAATGTGACGGTAT
TCCTAATTTTCTATATGGCGTCTTCCAACC|GATGCCCACCCCCAGGAGGCTTTTAGTGGT
CCAATTTTCTATATGGCGTCTTCCAACCTG|GTCCGAAGCGAGGATAATTTTCTATATGGC
CAATTTTCTATATGGCGTCTTCCAACCTGC|ACCTGTATCGTAGCACGGGTGTCTCTATAG
GGCGTCTTCCAACCTGCTAATTTTCTATAT|TGCTGACGGAGGGAGACGAATAGACCCGAA
ACGACACGGGCTTTGGCCTATACGTACAAA|TATGAGGCCAAATAGATTCCGAGGGGAGCA
CTGGATGCGCGGTGATAACGCCCTCTGCAA|TAGCGTCGCAAGTACCAATTTTCTATATGG
GGGGAGCAATCTGTCAGGAACGTAGCGTGT|GGCGTCTTCCAACCTGCTAATTTTCTATAT
TTCCGTCCGAAGCGAGGATAATTTTCTATA|GTAAAGCGCTCTAATTACGATCACACCGAC
CATGTCACGCTTCGCGGTAAAGCGCTCTAA|TCTTCCAACCTGCTGTCTTCCAACCTGCTC
TATGGCGTCTTCCAACCTGCTGCGTCTTCC|CGAAGTCAATCAAAGTCCGTTGTGCGGTCA
ATGGTTTGTATGCGTACATGTCACGCTTCG|AATTTTCTATATGGCGTCTTCCAACCTGCT
CTATAGATGCCCACCCCCAGGAGGCTTTTA|AACCTGCTGTTTCCTAGGCAGGCACAGATA
CCGAAGCGAGGATAATTTTCTATATGGCGT|CGCTCTAATTACGATCACACCGACGTCCTA
CTACGATGGGGGAACCCGCAGGGGGGTGCA|GTTGTCTGGTTGTATGGCCTATCGTAGCAT
TTCGGTTCGGATCAGCGCCAACACGAGGTA|AAATTTTCTATATGGCGTCTTCCAACCTGC
TCCTCGCAAATTTTCTATATGGCGTCTTCC|TTGTGGCCAATCGGATTACGGGTTTCCAGT
ATAGATGCCCACCCCCAGGAGGCTTTTAGT|CCTGCTGTTTCCTAGGCAGGCACAGATATC
CTAATGGGCACTCTACGCCAAAGTTCAAAT|CCTGCTCAGCAAAGCCATTCTCTACTGGGA
CCCCCTACGATGGGGGAACCCGCAGGGGGG|CAAAGTTGTCTGGTTGTATGGCCTATCGTA
TGATGACCCGTTCATGACCCGACACTAATG|CTGTCAGGAACGTAGCGTGTGATCACGTTT
AGCGAGGATAATTTTCTATATGGCGTCTTC|CTAATTACGATCACACCGACGTCCTAATTT
CCCCCAGGAGGCTTTTAGTGGTTTTTCGGT|CTAGGCAGGCACAGATATCCTCGCAAATTT
CTGCAAGATGGTTTGTATGCGTACATGTCA|ATATGGCAATTTTCTATATGGCGTCTTCCA
ACCTGCTTTTGTCTTTAATTTTCTATATGG|AGTTCAAATGTGACGGTATAAATGCAATAA
TCTACTGGGACTAATTTTCTATATGAATTT|GCTTCGGATATGTACAATCAGAATGCGCGC
TCCAACCTGCTGTCTTCCAACCTGCTCCAT|GTCTCTATAGACGCTGGAATTTTCTATATG
ACGCTGGAATTTTCTATATGGCGTCTTCCA|AGGGGGGTGCAATTCGGGCCAATAAATCGG
GGCGTCTTCCAACCTGCTGCGTCTTCCAAC|AGTCAATCAAAGTCCGTTGTGCGGTCAGGG
ACGGTATAAATGCAATAATTTTCTATATGG|ATTTTCTATATGAATTTTCTATATGGCGTC
TTCTATAACTTGTGGCCAATCGGATTACGG|TCTTCCAACCTGCTCTCAGGGACTAAGGGC
GATTCCGAGGGGAGCAATCTGTCAGGAACG|TTCTATATGGCGTCTTCCAACCTGCTAATT
AAGGTCCTATGTGTGCAAAGTTGTCTGGTT|GTAGAGGTATCTACTAAGATCTCTACGCTG
CACTAATGAATTTTCTATATGGCGTCTTCC|TCACGTTTAACTAATGGGCACTCTACGCCA
TAGGCAGGCACAGATATCCTCGCAAATTTT|GCAAAGATTCTATAACTTGTGGCCAATCGG
GACCTGGATGCGCGGTGATAACGCCCTCTG|TTTTAGCGTCGCAAGTACCAATTTTCTATA
AGGAGGCTTTTAGTGGTTTTTCGGTTCGGA|CAGGCACAGATATCCTCGCAAATTTTCTAT
CTGCTCCATTGATTATAACTATAGATGCCC|TTCTATATGGCGTCTTCCAACCTGCTGTTT
AAGTACCAATTTTCTATATGGCAATTTTCT|AGCGCCAACACGAGGTAAAGCACCTGTATC
CGATTCGACATGGCGACGACACGGGCTTTG|CGTCTTCCAACCTGCTATGAGGCCAAATAG
GATATCCTCGCAAATTTTCTATATGGCGTC|TAACTTGTGGCCAATCGGATTACGGGTTTC
TGGCGTCTTCCAACCTGCTAATTTTCTATA|CTGCTGACGGAGGGAGACGAATAGACCCGA
GATGTACGCTCATTTCCCATCCCCCTTCCG|CCAACCTGCTTTTGTCTTTAATTTTCTATA
TTGTATGCGTACATGTCACGCTTCGCGGTA|TCTATATGGCGTCTTCCAACCTGCTGTCTT
AATTTTCTATATGGCGTCTTCCAACCTGCT|AACTAATGGGCACTCTACGCCAAAGTTCAA
ACCTGCTAATTTTCTATATGGCGTCTTCCA|GGAGACGAATAGACCCGAATCACCAATTTT
ATGCGTACATGTCACGCTTCGCGGTAAAGC|TATGGCGTCTTCCAACCTGCTGTCTTCCAA
ACAATCAGAATGCGCGCTCCCCGAAGTCAA|GCTACGAAGTAGGTTGTTGACCTGGATGCG
GCAGGCACAGATATCCTCGCAAATTTTCTA|AAGATTCTATAACTTGTGGCCAATCGGATT
TGACCCGACACTAATGAATTTTCTATATGG|GCGTGTGATCACGTTTAACTAATGGGCACT
ACTCTACGCCAAAGTTCAAATGTGACGGTA|CAAAGCCATTCTCTACTGGGACTAATTTTC
CCGCAGATGATCACGGTCAATACTAGTATG|CCCGACACTAATGAATTTTCTATATGGCGT
GGAGGGAGACGAATAGACCCGAATCACCAA|CTCAGGCCAGGACTAGGGACCTTTCCGTCC
TCTATATGGCGTCTTCCAACCTGCTACGAA|ACCGACGTCCTAATTTTCTATATGGCGTCT
AGCGTCGCAAGTACCAATTTTCTATATGGC|TTCGGATCAGCGCCAACACGAGGTAAAGCA
TATGGCGTCTTCCAACCTGCTGTTTCCTAG|GGCCAATAAATCGGAGAGACCATGTGTGCA
GTCGCAAGTACCAATTTTCTATATGGCAAT|GGATCAGCGCCAACACGAGGTAAAGCACCT
TTTTCTATATGGCGTCTTCCAACCTGCTTT|CTATATGGCGTCTTCCAACCTGCTGCGTCT
AGCGATGTACGCTCATTTCCCATCCCCCTT|CTTCCAACCTGCTTTTGTCTTTAATTTTCT
TGCTGACGGAGGGAGACGAATAGACCCGAA|GCATGTTCTCAGGCCAGGACTAGGGACCTT
TATATGGCGTCTTCCAACCTGCTTCGGATA|GAGGATAATTTTCTATATGGCGTCTTCCAA
CTTAGCCCCATACCCCCTACGATGGGGGAA|GTCCTATGTGTGCAAAGTTGTCTGGTTGTA
TTCTCTACTGGGACTAATTTTCTATATGAA|CCTGCTTCGGATATGTACAATCAGAATGCG
TTTCTATATGGCGTCTTCCAACCTGCTATG|AAATGCAATAATTTTCTATATGGCGTCTTC
TTCTATATGGCGTCTTCCAACCTGCTTTTA|CCCCCAGGAGGCTTTTAGTGGTTTTTCGGT
TTCCAACCTGCTCAGCAAAGCCATTCTCTA|ATTTTCTATATGGCGTCTTCCAACCTGCTT
GGGAGCAATCTGTCAGGAACGTAGCGTGTG|GCGTCTTCCAACCTGCTAATTTTCTATATG
CCATGTGTGCAAAGATTCTATAACTTGTGG|ATTTTCTATATGGCGTCTTCCAACCTGCTC
CCTGTATCGTAGCACGGGTGTCTCTATAGA|CCCATACCCCCTACGATGGGGGAACCCGCA
CAGCAAAGCCATTCTCTACTGGGACTAATT|GCGTCTTCCAACCTGCTTCGGATATGTACA
GCGTCTTCCAACCTGCTGACGGAGGGAGAC|GTGCGGTCAGGGTGCATGTTCTCAGGCCAG
TTTTCTATATGGCGTCTTCCAACCTGCTGT|TGTATCGTAGCACGGGTGTCTCTATAGACG
TATGGCGTCTTCCAACCTGCTCAGCAAAGC|GAATCACCAATTTTCTATATGGCGTCTTCC
AACCCGCAGGGGGGTGCAATTCGGGCCAAT|TATGGCCTATCGTAGCATCATTCCGATACA
AGGCTCCGCAGATGATCACGGTCAATACTA|CATGACCCGACACTAATGAATTTTCTATAT
CAGGGTGCATGTTCTCAGGCCAGGACTAGG|AAGATGGTTTGTATGCGTACATGTCACGCT
TCTGTCAGGAACGTAGCGTGTGATCACGTT|CAACCTGCTAATTTTCTATATGGCGTCTTC
ATGGCAATTTTCTATATGGCGTCTTCCAAC|AAGCACCTGTATCGTAGCACGGGTGTCTCT
CCGTTGTGCGGTCAGGGTGCATGTTCTCAG|AACGCCCTCTGCAAGATGGTTTGTATGCGT
GGATTACGGGTTTCCAGTGCAAAGGTCCTA|ACTAAGGGCCGGACATTTTACGTAGAGGTA
AGACGAATAGACCCGAATCACCAATTTTCT|CCAGGACTAGGGACCTTTCCGTCCGAAGCG
AGATGGTTTGTATGCGTACATGTCACGCTT|GCAATTTTCTATATGGCGTCTTCCAACCTG
AAAATGATGACCCGTTCATGACCCGACACT|CAATCTGTCAGGAACGTAGCGTGTGATCAC
GAACCCGCAGGGGGGTGCAATTCGGGCCAA|GTATGGCCTATCGTAGCATCATTCCGATAC
ATATGGCGTCTTCCAACCTGCTGCGTCTTC|CCGAAGTCAATCAAAGTCCGTTGTGCGGTC
ATGGCGTCTTCCAACCTGCTAATTTTCTAT|CCTGCTGACGGAGGGAGACGAATAGACCCG
GTTCTCAGGCCAGGACTAGGGACCTTTCCG|GTATGCGTACATGTCACGCTTCGCGGTAAA
AATCGGAGAGACCATGTGTGCAAAGATTCT|CCTATCGAGGAATTTTCTATATGGCGTCTT
TTCCAACCTGCTTTTGTCTTTAATTTTCTA|GCCAAAGTTCAAATGTGACGGTATAAATGC
GTCCTATGTGTGCAAAGTTGTCTGGTTGTA|GAGGTATCTACTAAGATCTCTACGCTGACT
CGTCTTCCAACCTGCTGTTTCCTAGGCAGG|ATAAATCGGAGAGACCATGTGTGCAAAGAT
GGTGTCTCTATAGACGCTGGAATTTTCTAT|TGGGGGAACCCGCAGGGGGGTGCAATTCGG
TCTTCCAACCTGCTTTTCTATATGGCGTCT|CCAACCTGCTGCGTCTTCCAACCTGCTGAC
GTCTTCCAACCTGCTATGAGGCCAAATAGA|TTTCTATATGGCGTCTTCCAACCTGCTTTT
GCTATGAGGCCAAATAGATTCCGAGGGGAG|GTCTTCCAACCTGCTTTTCTATATGGCGTC
CGGAGGGAGACGAATAGACCCGAATCACCA|TCTCAGGCCAGGACTAGGGACCTTTCCGTC
CCAACACGAGGTAAAGCACCTGTATCGTAG|TCTTCCAACCTGCTTAGCCCCATACCCCCT
TATATGGCGTCTTCCAACCTGCTATGAGGC|GCAATAATTTTCTATATGGCGTCTTCCAAC
GAATGCGCGCTCCCCGAAGTCAATCAAAGT|AGTAGGTTGTTGACCTGGATGCGCGGTGAT
ATGTTCTCAGGCCAGGACTAGGGACCTTTC|TTGTATGCGTACATGTCACGCTTCGCGGTA
TAATTTTCTATATGGCGTCTTCCAACCTGC|TTTCTATATGGCGTCTTCCAACCTGCTGCG
TCTTCCAACCTGCTCCATTGATTATAACTA|GCTGGAATTTTCTATATGGCGTCTTCCAAC
ATACTAGTATGAGCGATGTACGCTCATTTC|CTATATGGCGTCTTCCAACCTGCTTTTGTC
GGTTTGTATGCGTACATGTCACGCTTCGCG|TTTTCTATATGGCGTCTTCCAACCTGCTGT
ACCTGCTCCATTGATTATAACTATAGATGC|TTTTCTATATGGCGTCTTCCAACCTGCTGT
ATGGCGTCTTCCAACCTGCTCAGCAAAGCC|AATCACCAATTTTCTATATGGCGTCTTCCA
ACGAGGTAAAGCACCTGTATCGTAGCACGG|CAACCTGCTTAGCCCCATACCCCCTACGAT
ATGGGGGAACCCGCAGGGGGGTGCAATTCG|CTGGTTGTATGGCCTATCGTAGCATCATTC
GATGATCACGGTCAATACTAGTATGAGCGA|CACTAATGAATTTTCTATATGGCGTCTTCC
CACACCGACGTCCTAATTTTCTATATGGCG|TATAACTATAGATGCCCACCCCCAGGAGGC
TGATTATAACTATAGATGCCCACCCCCAGG|GCGTCTTCCAACCTGCTGTTTCCTAGGCAG
ACACTAATGAATTTTCTATATGGCGTCTTC|ATCACGTTTAACTAATGGGCACTCTACGCC
ATGATCACGGTCAATACTAGTATGAGCGAT|ACTAATGAATTTTCTATATGGCGTCTTCCA
CAGGCACAGATATCCTCGCAAATTTTCTAT|AGATTCTATAACTTGTGGCCAATCGGATTA
TTCTATATGGCGTCTTCCAACCTGCTACGA|CACCGACGTCCTAATTTTCTATATGGCGTC
TGTGTGCAAAGTTGTCTGGTTGTATGGCCT|TCTACTAAGATCTCTACGCTGACTCTCCAT
GGTCAATACTAGTATGAGCGATGTACGCTC|ATTTTCTATATGGCGTCTTCCAACCTGCTT
TCGGATTACGGGTTTCCAGTGCAAAGGTCC|GGACTAAGGGCCGGACATTTTACGTAGAGG
TTGTTGACCTGGATGCGCGGTGATAACGCC|CCTGCTTTTAGCGTCGCAAGTACCAATTTT
GGCCTATACGTACAAAAATGATGACCCGTT|GATTCCGAGGGGAGCAATCTGTCAGGAACG
ATCACGGTCAATACTAGTATGAGCGATGTA|AATGAATTTTCTATATGGCGTCTTCCAACC
CCTGCTGTCTTCCAACCTGCTCCATTGATT|TATAGACGCTGGAATTTTCTATATGGCGTC
GCACCTGTATCGTAGCACGGGTGTCTCTAT|AGCCCCATACCCCCTACGATGGGGGAACCC
TCCAACCTGCTAATTTTCTATATGGCGTCT|GGAGGGAGACGAATAGACCCGAATCACCAA
TATGGCGTCTTCCAACCTGCTTTTGTCTTT|GCACTCTACGCCAAAGTTCAAATGTGACGG
TTTCTATATGGCGTCTTCCAACCTGCTTTT|ACCCCCAGGAGGCTTTTAGTGGTTTTTCGG
CGTCTTCCAACCTGCTGTCTTCCAACCTGC|CGGGTGTCTCTATAGACGCTGGAATTTTCT
TACGCCAAAGTTCAAATGTGACGGTATAAA|GCCATTCTCTACTGGGACTAATTTTCTATA
GACGGTATAAATGCAATAATTTTCTATATG|AATTTTCTATATGAATTTTCTATATGGCGT
CAAGTACCAATTTTCTATATGGCAATTTTC|CAGCGCCAACACGAGGTAAAGCACCTGTAT
ACTAATGGGCACTCTACGCCAAAGTTCAAA|ACCTGCTCAGCAAAGCCATTCTCTACTGGG
ACGATGGGGGAACCCGCAGGGGGGTGCAAT|TGTCTGGTTGTATGGCCTATCGTAGCATCA
TTTCCGTCCGAAGCGAGGATAATTTTCTAT|GGTAAAGCGCTCTAATTACGATCACACCGA
CCATTGATTATAACTATAGATGCCCACCCC|TATGGCGTCTTCCAACCTGCTGTTTCCTAG
CAGGAACGTAGCGTGTGATCACGTTTAACT|TGCTAATTTTCTATATGGCGTCTTCCAACC
TTTCCCATCCCCCTTCCGACGCGATTCGAC|TGTCTTTAATTTTCTATATGGCGTCTTCCA
TGTCACGCTTCGCGGTAAAGCGCTCTAATT|TTCCAACCTGCTGTCTTCCAACCTGCTCCA
TTTTCTATATGAATTTTCTATATGGCGTCT|CAATCAGAATGCGCGCTCCCCGAAGTCAAT
CGAAGCGAGGATAATTTTCTATATGGCGTC|GCTCTAATTACGATCACACCGACGTCCTAA
TATATGGCGTCTTCCAACCTGCTGCGTCTT|CCCGAAGTCAATCAAAGTCCGTTGTGCGGT
TGCAAAGGTCCTATGTGTGCAAAGTTGTCT|TTACGTAGAGGTATCTACTAAGATCTCTAC
CTTTTCTATATGGCGTCTTCCAACCTGCTA|GTCTTCCAACCTGCTGACGGAGGGAGACGA
TCAGCGCCAACACGAGGTAAAGCACCTGTA|ATGGCGTCTTCCAACCTGCTTAGCCCCATA
CGTCTTCCAACCTGCTTTTCTATATGGCGT|TTCCAACCTGCTGCGTCTTCCAACCTGCTG
TTTCTATATGGCGTCTTCCAACCTGCTGTT|AATTCGGGCCAATAAATCGGAGAGACCATG
TTCCAACCTGCTAATTTTCTATATGGCGTC|CGGAGGGAGACGAATAGACCCGAATCACCA
TAATTTTCTATATGGCGTCTTCCAACCTGC|GAATAGACCCGAATCACCAATTTTCTATAT
TCTATATGGCGTCTTCCAACCTGCTTTTGT|ATGGGCACTCTACGCCAAAGTTCAAATGTG
AAAGATTCTATAACTTGTGGCCAATCGGAT|TGGCGTCTTCCAACCTGCTCTCAGGGACTA
TGGTTTTTCGGTTCGGATCAGCGCCAACAC|CCTCGCAAATTTTCTATATGGCGTCTTCCA
TGGCGTCTTCCAACCTGCTTTTGTCTTTAA|ACTCTACGCCAAAGTTCAAATGTGACGGTA
AAAGTCCGTTGTGCGGTCAGGGTGCATGTT|GTGATAACGCCCTCTGCAAGATGGTTTGTA
CGCTCATTTCCCATCCCCCTTCCGACGCGA|TGCTTTTGTCTTTAATTTTCTATATGGCGT
ACACGAGGTAAAGCACCTGTATCGTAGCAC|TCCAACCTGCTTAGCCCCATACCCCCTACG
AACTATAGATGCCCACCCCCAGGAGGCTTT|CCAACCTGCTGTTTCCTAGGCAGGCACAGA
GGACTAGGGACCTTTCCGTCCGAAGCGAGG|GTCACGCTTCGCGGTAAAGCGCTCTAATTA
TATGGCGTCTTCCAACCTGCTAATTTTCTA|ACCTGCTGACGGAGGGAGACGAATAGACCC
TTCTATATGGCGTCTTCCAACCTGCTTTTG|AATGGGCACTCTACGCCAAAGTTCAAATGT
CGTCTTCCAACCTGCTAATTTTCTATATGG|CTGACGGAGGGAGACGAATAGACCCGAATC
ACGTACAAAAATGATGACCCGTTCATGACC|AGGGGAGCAATCTGTCAGGAACGTAGCGTG
CCCGCAGGGGGGTGCAATTCGGGCCAATAA|TGGCCTATCGTAGCATCATTCCGATACATC
TTCCAACCTGCTACGAAGTAGGTTGTTGAC|TTTTCTATATGGCGTCTTCCAACCTGCTTT
GCTTTGGCCTATACGTACAAAAATGATGAC|AAATAGATTCCGAGGGGAGCAATCTGTCAG
ACACGGGCTTTGGCCTATACGTACAAAAAT|GAGGCCAAATAGATTCCGAGGGGAGCAATC
ATAAATCGGAGAGACCATGTGTGCAAAGAT|CATCCTATCGAGGAATTTTCTATATGGCGT
AACCTGCTGCGTCTTCCAACCTGCTGACGG|AGTCCGTTGTGCGGTCAGGGTGCATGTTCT
CTATATGGCGTCTTCCAACCTGCTAATTTT|CCAACCTGCTGACGGAGGGAGACGAATAGA
GGCTTTGGCCTATACGTACAAAAATGATGA|CAAATAGATTCCGAGGGGAGCAATCTGTCA
CACGGGCTTTGGCCTATACGTACAAAAATG|AGGCCAAATAGATTCCGAGGGGAGCAATCT
TGAATTTTCTATATGGCGTCTTCCAACCTG|TGCGCGCTCCCCGAAGTCAATCAAAGTCCG
TGTATGCGTACATGTCACGCTTCGCGGTAA|CTATATGGCGTCTTCCAACCTGCTGTCTTC
AATCACCAATTTTCTATATGGCGTCTTCCA|TTTCCGTCCGAAGCGAGGATAATTTTCTAT
CGTTTAACTAATGGGCACTCTACGCCAAAG|CTTCCAACCTGCTCAGCAAAGCCATTCTCT
CGCAGGGGGGTGCAATTCGGGCCAATAAAT|GCCTATCGTAGCATCATTCCGATACATCCT
TACCAATTTTCTATATGGCAATTTTCTATA|GCCAACACGAGGTAAAGCACCTGTATCGTA
TTCTATATGGCGTCTTCCAACCTGCTTTTC|ATATGGCGTCTTCCAACCTGCTGCGTCTTC
TTCCAACCTGCTTTTCTATATGGCGTCTTC|AACCTGCTGCGTCTTCCAACCTGCTGACGG
ATGTGACGGTATAAATGCAATAATTTTCTA|GACTAATTTTCTATATGAATTTTCTATATG
CAATAATTTTCTATATGGCGTCTTCCAACC|AATTTTCTATATGGCGTCTTCCAACCTGCT
GCGTCTTCCAACCTGCTGTCTTCCAACCTG|ACGGGTGTCTCTATAGACGCTGGAATTTTC
TATGGCGTCTTCCAACCTGCTTTTCTATAT|GCGTCTTCCAACCTGCTGCGTCTTCCAACC
